2003,Brian Scalabrine,PF,24,68,169,0.40236686390532544,14,39,0.358974358974359,54,130,0.4153846153846154,30,36,0.8333333333333334,40,101,141,46,16,18,46,77,180,2003_Brian Scalabrine
2003,Brian Shaw,PG,36,101,261,0.38697318007662834,38,109,0.3486238532110092,63,152,0.4144736842105263,10,15,0.6666666666666666,20,99,119,103,32,13,54,62,250,2003_Brian Shaw
2003,Bruce Bowen,SF,31,223,479,0.46555323590814196,101,229,0.4410480349344978,122,250,0.488,36,89,0.4044943820224719,59,180,239,113,66,42,72,195,583,2003_Bruce Bowen
2003,Jahidi White,C,26,25,53,0.4716981132075472,0,0,NaN,25,53,0.4716981132075472,17,25,0.68,37,36,73,2,1,12,9,33,67,2003_Jahidi White
2003,Kenny Thomas,PF,25,520,1118,0.46511627906976744,0,0,NaN,520,1118,0.46511627906976744,294,394,0.7461928934010152,370,688,1058,224,124,56,232,338,1334,2003_Kenny Thomas
2003,Loren Woods,C,24,29,76,0.3815789473684211,1,3,0.3333333333333333,28,73,0.3835616438356164,21,27,0.7777777777777778,27,68,95,19,10,13,23,37,80,2003_Loren Woods
2003,Predrag Savovic,SG,26,29,93,0.3118279569892473,4,26,0.15384615384615385,25,67,0.373134328358209,21,29,0.7241379310344828,9,16,25,22,14,1,21,33,83,2003_Predrag Savovic
2003,Raef LaFrentz,C,26,266,514,0.5175097276264592,47,116,0.4051724137931034,219,398,0.550251256281407,60,88,0.6818181818181818,125,205,330,54,35,91,46,264,639,2003_Raef LaFrentz
2003,Ricky Davis,SG,23,602,1470,0.4095238095238095,74,204,0.3627450980392157,528,1266,0.41706161137440756,348,465,0.7483870967741936,97,293,390,436,125,36,277,180,1626,2003_Ricky Davis
2003,Ryan Bowen,SG,27,97,197,0.49238578680203043,2,7,0.2857142857142857,95,190,0.5,27,41,0.6585365853658537,78,79,157,54,65,29,43,82,223,2003_Ryan Bowen
2003,Wesley Person,SG,31,274,601,0.4559068219633943,100,231,0.4329004329004329,174,370,0.4702702702702703,79,97,0.8144329896907216,24,168,192,112,42,19,56,64,727,2003_Wesley Person
2004,Adrian Griffin,SG,29,5,18,0.2777777777777778,1,2,0.5,4,16,0.25,0,4,0.0,1,18,19,10,7,2,3,17,11,2004_Adrian Griffin
2004,Andrei Kirilenko,PF,22,412,931,0.44253490870032225,68,201,0.3383084577114428,344,730,0.4712328767123288,392,496,0.7903225806451613,226,403,629,244,150,215,215,174,1284,2004_Andrei Kirilenko
2004,Andrew DeClercq,C,30,93,195,0.47692307692307695,0,0,NaN,93,195,0.47692307692307695,44,54,0.8148148148148148,131,186,317,44,47,32,54,217,230,2004_Andrew DeClercq
2004,Ansu Sesay,SF,27,81,178,0.4550561797752809,6,21,0.2857142857142857,75,157,0.47770700636942676,32,46,0.6956521739130435,43,49,92,19,19,20,23,66,200,2004_Ansu Sesay
2004,Bruce Bowen,SF,32,211,502,0.4203187250996016,77,212,0.3632075471698113,134,290,0.46206896551724136,66,114,0.5789473684210527,45,208,253,113,84,33,90,166,565,2004_Bruce Bowen
2004,Chris Bosh,C,19,327,712,0.4592696629213483,5,14,0.35714285714285715,322,698,0.46131805157593125,202,288,0.7013888888888888,191,366,557,78,59,106,107,215,861,2004_Chris Bosh
2004,Chris Crawford,PF,28,211,471,0.44798301486199577,44,113,0.3893805309734513,167,358,0.4664804469273743,103,119,0.865546218487395,58,117,175,45,37,20,55,131,569,2004_Chris Crawford
2004,Desmond Ferguson,SF,26,5,12,0.4166666666666667,3,8,0.375,2,4,0.5,0,2,0.0,0,4,4,1,0,0,1,0,13,2004_Desmond Ferguson
2004,Joel Przybilla,C,24,36,100,0.36,0,0,NaN,36,100,0.36,26,62,0.41935483870967744,64,158,222,14,10,34,36,106,98,2004_Joel Przybilla
2004,Lee Nailon,SF_PF_PF-SF,28,294,654,0.44954128440366975,0,6,0.0,294,648,0.4537037037037037,94,116,0.8103448275862069,128,158,286,76,30,16,90,186,682,2004_Lee Nailon
2004,Loren Woods,C,25,44,96,0.4583333333333333,0,0,NaN,44,96,0.4583333333333333,33,55,0.6,65,69,134,10,11,19,26,52,121,2004_Loren Woods
2004,Quincy Lewis,SF,26,7,20,0.35,2,5,0.4,5,15,0.3333333333333333,0,0,NaN,1,6,7,2,2,2,3,10,16,2004_Quincy Lewis
2004,Raef LaFrentz,C,27,57,124,0.4596774193548387,8,40,0.2,49,84,0.5833333333333334,10,13,0.7692307692307693,30,49,79,24,8,13,11,47,132,2004_Raef LaFrentz
2004,Reggie Evans,PF,23,67,165,0.40606060606060607,0,3,0.0,67,162,0.41358024691358025,83,148,0.5608108108108109,156,252,408,33,54,10,65,176,217,2004_Reggie Evans
2004,Ricky Davis,SF_SG_SF-SG,24,892,1900,0.4694736842105263,104,280,0.37142857142857144,788,1620,0.48641975308641977,392,546,0.717948717948718,154,562,716,518,192,44,378,342,2280,2004_Ricky Davis
2004,Rodney White,SF,23,215,468,0.4594017094017094,33,87,0.3793103448275862,182,381,0.4776902887139108,78,104,0.75,44,121,165,60,32,20,78,105,541,2004_Rodney White
2004,Scot Pollard,C,28,47,114,0.41228070175438597,0,0,NaN,47,114,0.41228070175438597,12,21,0.5714285714285714,67,97,164,10,23,26,22,110,106,2004_Scot Pollard
2004,Theo Ratliff,C,30,532,1098,0.48451730418943534,0,0,NaN,532,1098,0.48451730418943534,280,434,0.6451612903225806,390,838,1228,142,108,614,240,600,1344,2004_Theo Ratliff
2004,Wesley Person,SG,32,252,628,0.4012738853503185,110,276,0.39855072463768115,142,352,0.4034090909090909,62,78,0.7948717948717948,32,202,234,132,38,18,76,76,676,2004_Wesley Person
2005,Andrew DeClercq,C,31,4,9,0.4444444444444444,0,0,NaN,4,9,0.4444444444444444,1,3,0.3333333333333333,7,3,10,0,2,0,1,14,9,2005_Andrew DeClercq
2005,Bruce Bowen,SF,33,251,598,0.4197324414715719,102,253,0.4031620553359684,149,345,0.4318840579710145,71,112,0.6339285714285714,50,235,285,126,55,39,57,175,675,2005_Bruce Bowen
2005,Didier Ilunga-Mbenga,C,24,6,14,0.42857142857142855,0,0,NaN,6,14,0.42857142857142855,3,4,0.75,3,5,8,0,0,5,5,13,15,2005_Didier Ilunga-Mbenga
2005,George Lynch,SF,34,68,189,0.35978835978835977,11,37,0.2972972972972973,57,152,0.375,17,23,0.7391304347826086,55,119,174,88,32,12,57,83,164,2005_George Lynch
2005,Loren Woods,C,26,71,164,0.4329268292682927,0,1,0.0,71,163,0.43558282208588955,34,59,0.576271186440678,81,139,220,17,8,39,37,78,176,2005_Loren Woods
2005,Lucious Harris,SG,34,118,299,0.39464882943143814,21,65,0.3230769230769231,97,234,0.41452991452991456,56,69,0.8115942028985508,39,82,121,49,27,6,29,68,313,2005_Lucious Harris
2005,Maciej Lampe,C,19,98,264,0.3712121212121212,4,8,0.5,94,256,0.3671875,30,44,0.6818181818181818,48,130,178,22,10,14,34,102,230,2005_Maciej Lampe
2005,Mike Bibby,PG,26,560,1264,0.4430379746835443,131,364,0.3598901098901099,429,900,0.4766666666666667,320,413,0.774818401937046,77,255,332,541,124,30,203,191,1571,2005_Mike Bibby
2005,Raef LaFrentz,PF,28,341,688,0.4956395348837209,82,225,0.36444444444444446,259,463,0.5593952483801296,120,148,0.8108108108108109,154,399,553,98,42,99,70,262,884,2005_Raef LaFrentz
2005,Ricky Davis,SG,25,481,1041,0.4620557156580211,61,180,0.3388888888888889,420,861,0.4878048780487805,286,351,0.8148148148148148,66,183,249,246,89,27,205,174,1309,2005_Ricky Davis
2005,Wesley Person,SF,33,214,452,0.47345132743362833,82,178,0.4606741573033708,132,274,0.48175182481751827,18,26,0.6923076923076923,6,160,166,78,38,8,34,60,528,2005_Wesley Person
2006,Beno Udrih,PG,23,106,233,0.45493562231759654,24,70,0.34285714285714286,82,163,0.5030674846625767,39,50,0.78,18,34,52,92,14,2,53,55,275,2006_Beno Udrih
2006,Bruce Bowen,SF,34,232,536,0.43283582089552236,104,245,0.42448979591836733,128,291,0.43986254295532645,51,84,0.6071428571428571,35,285,320,126,79,30,67,191,619,2006_Bruce Bowen
2006,Chris Webber,PF,32,617,1422,0.4338959212376934,21,77,0.2727272727272727,596,1345,0.44312267657992566,263,348,0.7557471264367817,184,557,741,256,103,62,182,219,1518,2006_Chris Webber
2006,Damon Stoudamire,PG,32,114,287,0.397212543554007,36,104,0.34615384615384615,78,183,0.4262295081967213,53,62,0.8548387096774194,23,72,95,128,19,1,55,49,317,2006_Damon Stoudamire
2006,David Wesley,SG,35,226,561,0.4028520499108734,99,271,0.36531365313653136,127,290,0.4379310344827586,151,187,0.8074866310160428,24,154,178,204,59,6,120,212,702,2006_David Wesley
2006,Grant Hill,SF,33,119,243,0.4897119341563786,2,8,0.25,117,235,0.4978723404255319,78,102,0.7647058823529411,15,65,80,48,24,6,35,50,318,2006_Grant Hill
2006,Ira Newble,SG,31,17,57,0.2982456140350877,3,13,0.23076923076923078,14,44,0.3181818181818182,11,16,0.6875,21,35,56,9,5,10,12,47,48,2006_Ira Newble
2006,J.R. Smith,SG,20,144,366,0.39344262295081966,52,140,0.37142857142857144,92,226,0.40707964601769914,83,101,0.8217821782178217,19,91,110,58,37,4,54,90,423,2006_J.R. Smith
2006,Juan Dixon,SG,27,357,821,0.4348355663824604,65,170,0.38235294117647056,292,651,0.4485407066052227,156,194,0.8041237113402062,30,147,177,149,58,6,113,157,935,2006_Juan Dixon
2006,Loren Woods,C,27,28,59,0.4745762711864407,0,1,0.0,28,58,0.4827586206896552,6,14,0.42857142857142855,44,66,110,4,9,23,16,49,62,2006_Loren Woods
2006,Nick Van,PG,34,136,343,0.3965014577259475,55,154,0.35714285714285715,81,189,0.42857142857142855,28,41,0.6829268292682927,6,85,91,123,16,3,57,60,355,2006_Nick Van
2006,Raef LaFrentz,PF,29,238,552,0.4311594202898551,112,286,0.3916083916083916,126,266,0.47368421052631576,51,75,0.68,80,326,406,115,29,72,65,273,639,2006_Raef LaFrentz
2006,Raymond Felton,PG,21,345,883,0.39071347678369195,97,271,0.35793357933579334,248,612,0.40522875816993464,161,222,0.7252252252252253,77,188,265,446,102,8,182,181,948,2006_Raymond Felton
2006,Ricky Davis,SF_SG_SG-SF,26,1168,2608,0.44785276073619634,146,484,0.30165289256198347,1022,2124,0.4811676082862524,550,690,0.7971014492753623,130,572,702,788,182,34,426,380,3032,2006_Ricky Davis
2006,Sean May,PF,21,70,171,0.4093567251461988,0,5,0.0,70,166,0.42168674698795183,49,64,0.765625,42,67,109,22,17,12,33,58,189,2006_Sean May
2006,Smush Parker,PG,24,348,779,0.4467265725288832,120,328,0.36585365853658536,228,451,0.5055432372505543,125,180,0.6944444444444444,37,234,271,302,140,16,147,213,941,2006_Smush Parker
2007,Allan Ray,SG,22,100,259,0.3861003861003861,48,116,0.41379310344827586,52,143,0.36363636363636365,42,55,0.7636363636363637,18,51,69,43,20,3,42,85,290,2007_Allan Ray
2007,Anderson Varejao,C,24,191,401,0.4763092269326683,0,9,0.0,191,392,0.4872448979591837,165,268,0.6156716417910447,191,354,545,75,76,52,67,269,547,2007_Anderson Varejao
2007,Andrew Bogut,C,22,348,629,0.5532591414944356,1,5,0.2,347,624,0.5560897435897436,112,194,0.5773195876288659,168,416,584,198,49,35,150,216,809,2007_Andrew Bogut
2007,Anthony Roberson,PG,23,44,104,0.4230769230769231,21,55,0.38181818181818183,23,49,0.46938775510204084,2,3,0.6666666666666666,2,19,21,10,12,0,13,27,111,2007_Anthony Roberson
2007,Bonzi Wells,SF,30,85,207,0.4106280193236715,1,7,0.14285714285714285,84,200,0.42,46,82,0.5609756097560976,26,94,120,31,24,13,57,62,217,2007_Bonzi Wells
2007,Bruce Bowen,SF,35,189,467,0.40471092077087795,89,232,0.38362068965517243,100,235,0.425531914893617,43,73,0.589041095890411,23,200,223,117,62,25,65,175,510,2007_Bruce Bowen
2007,Calvin Booth,C,30,31,66,0.4696969696969697,1,2,0.5,30,64,0.46875,6,10,0.6,27,54,81,18,4,29,9,71,69,2007_Calvin Booth
2007,Chris McCray,SG,22,0,3,0.0,0,0,NaN,0,3,0.0,0,0,NaN,0,0,0,0,0,0,2,1,0,2007_Chris McCray
2007,J.J. Redick,PG,22,80,195,0.41025641025641024,38,98,0.3877551020408163,42,97,0.4329896907216495,54,60,0.9,10,42,52,36,12,0,21,52,252,2007_J.J. Redick
2007,Mickael Gelabale,SF,23,122,264,0.4621212121212121,11,47,0.23404255319148937,111,217,0.511520737327189,66,82,0.8048780487804879,59,114,173,56,24,22,49,108,321,2007_Mickael Gelabale
2007,Rajon Rondo,PG,20,188,450,0.4177777777777778,6,29,0.20689655172413793,182,421,0.4323040380047506,119,184,0.6467391304347826,74,218,292,297,128,8,137,181,501,2007_Rajon Rondo
2007,Ricky Davis,SF,27,506,1089,0.46464646464646464,123,310,0.3967741935483871,383,779,0.49165596919127086,239,285,0.8385964912280702,54,261,315,385,80,23,210,189,1374,2007_Ricky Davis
2007,Tony Battie,PF,30,176,360,0.4888888888888889,0,1,0.0,176,359,0.49025069637883006,52,77,0.6753246753246753,92,252,344,35,29,30,61,185,404,2007_Tony Battie
2007,Wally Szczerbiak,SF,29,161,388,0.41494845360824745,44,106,0.41509433962264153,117,282,0.4148936170212766,113,126,0.8968253968253969,16,82,98,55,18,3,54,65,479,2007_Wally Szczerbiak
2008,Bonzi Wells,SG,31,504,1138,0.4428822495606327,24,100,0.24,480,1038,0.4624277456647399,292,454,0.6431718061674009,168,494,662,194,150,64,206,314,1324,2008_Bonzi Wells
2008,Bruce Bowen,SF,36,174,428,0.40654205607476634,90,215,0.4186046511627907,84,213,0.39436619718309857,45,69,0.6521739130434783,33,201,234,91,54,22,46,177,483,2008_Bruce Bowen
2008,Devin Harris,PG,24,642,1386,0.46320346320346323,112,334,0.33532934131736525,530,1052,0.5038022813688213,496,602,0.8239202657807309,56,290,346,738,180,20,322,380,1892,2008_Devin Harris
2008,Earl Boykins,PG,31,61,172,0.3546511627906977,14,44,0.3181818181818182,47,128,0.3671875,49,59,0.8305084745762712,9,25,34,96,13,0,41,21,185,2008_Earl Boykins
2008,J.J. Redick,SG,23,48,108,0.4444444444444444,17,43,0.3953488372093023,31,65,0.47692307692307695,27,34,0.7941176470588235,1,22,23,16,4,0,15,29,140,2008_J.J. Redick
2008,Josh Childress,SF,24,327,573,0.5706806282722513,22,60,0.36666666666666664,305,513,0.594541910331384,222,275,0.8072727272727273,174,199,373,117,71,43,98,129,898,2008_Josh Childress
2008,Loren Woods,C,29,3,5,0.6,0,0,NaN,3,5,0.6,0,0,NaN,0,1,1,2,0,0,0,2,6,2008_Loren Woods
2008,Maceo Baston,PF,32,17,25,0.68,0,0,NaN,17,25,0.68,7,10,0.7,9,17,26,3,2,4,4,20,41,2008_Maceo Baston
2008,Morris Almond,SG,22,4,15,0.26666666666666666,1,4,0.25,3,11,0.2727272727272727,4,6,0.6666666666666666,0,2,2,3,1,0,2,5,13,2008_Morris Almond
2008,Rajon Rondo,PG,21,351,713,0.49228611500701264,5,19,0.2631578947368421,346,694,0.49855907780979825,107,175,0.6114285714285714,78,244,322,393,129,13,147,187,814,2008_Rajon Rondo
2008,Ricky Davis,SF,28,420,971,0.4325437693099897,135,333,0.40540540540540543,285,638,0.44670846394984326,155,197,0.7868020304568528,55,298,353,276,87,14,191,187,1130,2008_Ricky Davis
2009,Boris Diaw,PF,26,896,1768,0.5067873303167421,150,362,0.4143646408839779,746,1406,0.5305832147937412,202,294,0.6870748299319728,236,628,864,666,122,106,430,404,2144,2009_Boris Diaw
2009,Bruce Bowen,SF,37,79,187,0.42245989304812837,42,98,0.42857142857142855,37,89,0.4157303370786517,14,26,0.5384615384615384,16,129,145,40,36,13,25,123,214,2009_Bruce Bowen
2009,Cuttino Mobley,SG,33,63,146,0.4315068493150685,12,35,0.34285714285714286,51,111,0.4594594594594595,13,18,0.7222222222222222,9,20,29,12,15,2,18,21,151,2009_Cuttino Mobley
2009,Hassan Adams,SG,24,4,13,0.3076923076923077,0,0,NaN,4,13,0.3076923076923077,3,6,0.5,1,6,7,1,1,1,4,4,11,2009_Hassan Adams
2009,J.J. Redick,SG,24,117,299,0.391304347826087,67,179,0.3743016759776536,50,120,0.4166666666666667,81,93,0.8709677419354839,8,101,109,73,21,1,54,72,382,2009_J.J. Redick
2009,Juwan Howard,SF-PF_SF_PF,35,150,294,0.5102040816326531,0,0,NaN,150,294,0.5102040816326531,46,68,0.6764705882352942,60,92,152,52,14,12,52,142,346,2009_Juwan Howard
2009,Marcus Camby,C,34,254,496,0.5120967741935484,1,4,0.25,253,492,0.5142276422764228,132,182,0.7252747252747253,161,529,690,127,51,132,93,129,641,2009_Marcus Camby
2009,Morris Almond,SG,23,33,81,0.4074074074074074,5,17,0.29411764705882354,28,64,0.4375,21,26,0.8076923076923077,9,27,36,7,4,4,16,31,92,2009_Morris Almond
2009,Rafer Alston,PG,32,632,1640,0.3853658536585366,224,662,0.338368580060423,408,978,0.4171779141104294,312,416,0.75,66,388,454,812,216,20,280,270,1800,2009_Rafer Alston
2009,Rajon Rondo,PG,22,383,759,0.5046113306982872,15,48,0.3125,368,711,0.5175808720112518,172,268,0.6417910447761194,100,316,416,659,149,11,209,193,953,2009_Rajon Rondo
2009,Richard Hamilton,SG,30,466,1043,0.4467881112176414,70,190,0.3684210526315789,396,853,0.4642438452520516,223,263,0.8479087452471483,44,163,207,297,40,4,133,176,1225,2009_Richard Hamilton
2009,Ricky Davis,SG,29,83,245,0.33877551020408164,35,111,0.3153153153153153,48,134,0.3582089552238806,31,36,0.8611111111111112,9,51,60,82,19,5,39,63,232,2009_Ricky Davis
2009,Rudy Fernandez,SG,23,268,630,0.4253968253968254,159,398,0.39949748743718594,109,232,0.4698275862068966,120,143,0.8391608391608392,47,160,207,159,69,12,86,111,815,2009_Rudy Fernandez
2009,Speedy Claxton,PG,30,2,7,0.2857142857142857,0,0,NaN,2,7,0.2857142857142857,1,2,0.5,0,0,0,3,0,0,0,1,5,2009_Speedy Claxton
2009,Tony Battie,PF,32,158,323,0.4891640866873065,2,9,0.2222222222222222,156,314,0.4968152866242038,54,82,0.6585365853658537,92,186,278,31,26,25,46,112,372,2009_Tony Battie
2009,Yao Ming,C,28,566,1032,0.5484496124031008,1,1,1.0,565,1031,0.5480116391852571,381,440,0.865909090909091,204,557,761,137,30,150,234,257,1514,2009_Yao Ming
2010,Caron Butler,SF_SG_SF-SG,29,900,2102,0.42816365366317793,84,290,0.2896551724137931,816,1812,0.4503311258278146,528,630,0.8380952380952381,208,714,922,312,232,48,320,386,2412,2010_Caron Butler
2010,DeMarre Carroll,SF,23,88,222,0.3963963963963964,0,6,0.0,88,216,0.4074074074074074,33,53,0.6226415094339622,53,97,150,33,28,9,24,107,209,2010_DeMarre Carroll
2010,Drew Gooden,C_PF_C-PF,28,576,1204,0.47840531561461797,2,16,0.125,574,1188,0.4831649831649832,372,432,0.8611111111111112,414,670,1084,94,82,116,216,388,1526,2010_Drew Gooden
2010,Henry Walker,SF_SG_SG-SF,22,240,464,0.5172413793103449,100,232,0.43103448275862066,140,232,0.603448275862069,78,98,0.7959183673469388,30,146,176,80,46,6,56,166,658,2010_Henry Walker
2010,Jamaal Tinsley,PG,31,52,140,0.37142857142857144,7,39,0.1794871794871795,45,101,0.44554455445544555,22,27,0.8148148148148148,11,55,66,108,33,5,63,67,133,2010_Jamaal Tinsley
2010,Joey Graham,SF,27,105,202,0.5198019801980198,2,13,0.15384615384615385,103,189,0.544973544973545,54,73,0.7397260273972602,39,84,123,22,23,7,43,104,266,2010_Joey Graham
2010,Kareem Rush,SG,29,4,11,0.36363636363636365,1,3,0.3333333333333333,3,8,0.375,0,0,NaN,1,5,6,4,2,3,3,8,9,2010_Kareem Rush
2010,Matt Carroll,SG,29,18,50,0.36,4,19,0.21052631578947367,14,31,0.45161290322580644,6,6,1.0,4,8,12,6,5,0,7,13,46,2010_Matt Carroll
2010,Patty Mills,PG,21,10,24,0.4166666666666667,2,4,0.5,8,20,0.4,4,7,0.5714285714285714,1,1,2,5,0,0,4,6,26,2010_Patty Mills
2010,Reggie Williams,SF,23,140,283,0.49469964664310956,33,92,0.358695652173913,107,191,0.5602094240837696,52,62,0.8387096774193549,18,92,110,66,23,6,29,49,365,2010_Reggie Williams
2010,Ricky Davis,SF,30,62,143,0.43356643356643354,16,42,0.38095238095238093,46,101,0.45544554455445546,18,31,0.5806451612903226,10,47,57,39,11,3,29,39,158,2010_Ricky Davis
2010,Ronnie Price,PG,26,98,242,0.4049586776859504,18,63,0.2857142857142857,80,179,0.44692737430167595,41,59,0.6949152542372882,28,46,74,123,40,13,56,109,255,2010_Ronnie Price
2011,Christian Eyenga,SF,21,130,306,0.42483660130718953,25,91,0.27472527472527475,105,215,0.4883720930232558,18,28,0.6428571428571429,27,96,123,35,34,28,47,78,303,2011_Christian Eyenga
2011,DeMarre Carroll,PF,24,8,24,0.3333333333333333,0,0,NaN,8,24,0.3333333333333333,4,4,1.0,4,12,16,8,2,2,0,10,20,2011_DeMarre Carroll
2011,Derrick Rose,PG,22,711,1597,0.4452097683155917,128,385,0.33246753246753247,583,1212,0.48102310231023104,476,555,0.8576576576576577,81,249,330,623,85,51,278,136,2026,2011_Derrick Rose
2011,Drew Gooden,PF,29,156,362,0.430939226519337,3,20,0.15,153,342,0.4473684210526316,81,102,0.7941176470588235,73,165,238,47,21,18,46,98,396,2011_Drew Gooden
2011,Jared Jeffries,PF,29,60,172,0.3488372093023256,4,18,0.2222222222222222,56,154,0.36363636363636365,24,58,0.41379310344827586,124,108,232,72,62,34,42,150,148,2011_Jared Jeffries
2011,Jason Kidd,PG,37,215,596,0.36073825503355705,133,391,0.340153452685422,82,205,0.4,67,77,0.8701298701298701,35,316,351,655,134,29,179,119,630,2011_Jason Kidd
2011,Joel Anthony,C,28,53,99,0.5353535353535354,0,0,NaN,53,99,0.5353535353535354,47,73,0.6438356164383562,104,162,266,24,10,93,36,194,153,2011_Joel Anthony
2011,Joey Graham,SF,28,82,179,0.4581005586592179,9,30,0.3,73,149,0.4899328859060403,29,36,0.8055555555555556,8,76,84,18,6,7,28,73,202,2011_Joey Graham
2011,Manny Harris,SG,21,108,289,0.3737024221453287,34,92,0.3695652173913043,74,197,0.3756345177664975,71,93,0.7634408602150538,36,104,140,85,31,7,63,65,321,2011_Manny Harris
2011,Patty Mills,PG,22,135,328,0.4115853658536585,47,133,0.3533834586466165,88,195,0.4512820512820513,36,47,0.7659574468085106,19,32,51,109,27,1,62,63,353,2011_Patty Mills
2011,Reggie Williams,SF,24,268,572,0.46853146853146854,102,241,0.42323651452282157,166,331,0.5015105740181269,100,134,0.746268656716418,45,171,216,121,28,3,57,124,738,2011_Reggie Williams
2012,Cartier Martin,SF,27,59,134,0.44029850746268656,29,75,0.38666666666666666,30,59,0.5084745762711864,11,19,0.5789473684210527,12,46,58,10,11,2,13,35,158,2012_Cartier Martin
2012,Cory Higgins,PG,22,52,160,0.325,4,20,0.2,48,140,0.34285714285714286,42,60,0.7,7,28,35,36,5,6,39,40,150,2012_Cory Higgins
2012,Cory Joseph,PG,20,22,70,0.3142857142857143,3,15,0.2,19,55,0.34545454545454546,11,17,0.6470588235294118,5,20,25,34,7,3,12,16,58,2012_Cory Joseph
2012,Damien Wilkins,SF,32,76,193,0.39378238341968913,7,23,0.30434782608695654,69,170,0.40588235294117647,34,54,0.6296296296296297,22,78,100,44,29,13,30,85,193,2012_Damien Wilkins
2012,Dante Cunningham,PF,24,144,279,0.5161290322580645,0,2,0.0,144,277,0.51985559566787,45,69,0.6521739130434783,91,155,246,37,42,34,29,98,333,2012_Dante Cunningham
2012,DeMarre Carroll,SF-PF_SF_PF,25,86,210,0.4095238095238095,14,38,0.3684210526315789,72,172,0.4186046511627907,28,32,0.875,56,50,106,36,24,2,22,74,214,2012_DeMarre Carroll
2012,Gilbert Arenas,PG,30,26,64,0.40625,13,39,0.3333333333333333,13,25,0.52,7,10,0.7,2,16,18,18,11,1,12,35,72,2012_Gilbert Arenas
2012,Jeremy Pargo,PG,25,50,150,0.3333333333333333,10,38,0.2631578947368421,40,112,0.35714285714285715,16,27,0.5925925925925926,12,25,37,55,15,0,46,46,126,2012_Jeremy Pargo
2012,Kelenna Azubuike,SG,28,3,8,0.375,1,3,0.3333333333333333,2,5,0.4,0,0,NaN,0,0,0,0,1,0,4,1,7,2012_Kelenna Azubuike
2012,Patty Mills,PG,23,63,130,0.4846153846153846,24,56,0.42857142857142855,39,74,0.527027027027027,15,15,1.0,4,24,28,39,10,1,26,14,165,2012_Patty Mills
2012,Reggie Williams,SF,25,106,255,0.41568627450980394,33,107,0.308411214953271,73,148,0.49324324324324326,29,40,0.725,27,66,93,60,20,3,33,34,274,2012_Reggie Williams
2012,Ryan Gomes,SF,29,31,95,0.3263157894736842,4,29,0.13793103448275862,27,66,0.4090909090909091,8,11,0.7272727272727273,14,47,61,12,16,0,15,34,74,2012_Ryan Gomes
2012,Shaun Livingston,SG,26,127,271,0.46863468634686345,2,3,0.6666666666666666,125,268,0.4664179104477612,62,79,0.7848101265822784,39,84,123,122,27,20,66,79,318,2012_Shaun Livingston
2012,Wesley Johnson,SF,24,158,397,0.3979848866498741,53,169,0.3136094674556213,105,228,0.4605263157894737,24,34,0.7058823529411765,24,153,177,59,35,48,60,115,393,2012_Wesley Johnson
2013,Aaron Brooks,PG,28,286,632,0.4525316455696203,100,268,0.373134328358209,186,364,0.510989010989011,80,104,0.7692307692307693,26,134,160,228,60,20,134,188,752,2013_Aaron Brooks
2013,Andrew Nicholson,PF,23,256,486,0.5267489711934157,0,0,NaN,256,486,0.5267489711934157,75,94,0.7978723404255319,69,189,258,44,24,32,79,133,587,2013_Andrew Nicholson
2013,Cory Joseph,PG,21,51,110,0.4636363636363636,6,21,0.2857142857142857,45,89,0.5056179775280899,18,21,0.8571428571428571,12,40,52,53,15,4,21,25,126,2013_Cory Joseph
2013,DeMarre Carroll,SF,26,149,324,0.45987654320987653,20,70,0.2857142857142857,129,254,0.5078740157480315,75,98,0.7653061224489796,87,101,188,61,58,24,34,119,393,2013_DeMarre Carroll
2013,Derrick Williams,PF,21,338,786,0.4300254452926209,65,196,0.33163265306122447,273,590,0.46271186440677964,192,272,0.7058823529411765,96,334,430,46,44,37,101,127,933,2013_Derrick Williams
2013,Draymond Green,SF,22,84,257,0.32684824902723736,14,67,0.208955223880597,70,190,0.3684210526315789,45,55,0.8181818181818182,58,202,260,53,42,25,51,159,227,2013_Draymond Green
2013,Ed Davis,C_PF_C-PF,23,520,964,0.5394190871369294,0,0,NaN,520,964,0.5394190871369294,206,334,0.6167664670658682,304,616,920,126,76,170,126,382,1246,2013_Ed Davis
2013,Gerald Wallace,SF,30,182,458,0.39737991266375544,46,163,0.2822085889570552,136,295,0.4610169491525424,121,190,0.6368421052631579,69,250,319,181,97,46,110,118,531,2013_Gerald Wallace
2013,Jason Richardson,SG,32,135,336,0.4017857142857143,57,167,0.3413173652694611,78,169,0.46153846153846156,20,33,0.6060606060606061,19,108,127,51,40,15,26,57,347,2013_Jason Richardson
2013,Josh Akognon,PG,26,2,4,0.5,1,2,0.5,1,2,0.5,0,0,NaN,0,1,1,1,0,0,0,3,5,2013_Josh Akognon
2013,Kim English,SG,24,42,112,0.375,14,50,0.28,28,62,0.45161290322580644,21,29,0.7241379310344828,8,29,37,26,16,3,19,46,119,2013_Kim English
2013,Kirk Hinrich,PG,32,159,422,0.3767772511848341,71,182,0.3901098901098901,88,240,0.36666666666666664,70,98,0.7142857142857143,16,142,158,314,63,25,99,192,459,2013_Kirk Hinrich
2013,Mario Chalmers,PG,26,227,529,0.42911153119092627,123,301,0.40863787375415284,104,228,0.45614035087719296,89,112,0.7946428571428571,19,152,171,273,118,12,119,196,666,2013_Mario Chalmers
2013,Patty Mills,PG,24,113,241,0.46887966804979253,52,130,0.4,61,111,0.5495495495495496,16,19,0.8421052631578947,9,41,50,62,26,4,39,55,294,2013_Patty Mills
2013,Reggie Williams,SF,26,57,132,0.4318181818181818,22,72,0.3055555555555556,35,60,0.5833333333333334,10,21,0.47619047619047616,8,43,51,39,12,1,19,19,146,2013_Reggie Williams
2014,Alonzo Gee,SF,26,98,236,0.4152542372881356,19,58,0.3275862068965517,79,178,0.4438202247191011,43,61,0.7049180327868853,35,114,149,47,39,15,44,96,258,2014_Alonzo Gee
2014,Charlie Villanueva,PF,29,35,92,0.3804347826086957,14,56,0.25,21,36,0.5833333333333334,8,14,0.5714285714285714,6,28,34,6,4,5,7,16,92,2014_Charlie Villanueva
2014,Cory Joseph,SG,22,126,265,0.47547169811320755,12,38,0.3157894736842105,114,227,0.5022026431718062,79,96,0.8229166666666666,32,75,107,114,35,14,43,84,343,2014_Cory Joseph
2014,DeMarre Carroll,SF,27,302,642,0.470404984423676,97,268,0.3619402985074627,205,374,0.5481283422459893,109,141,0.7730496453900709,107,296,403,134,108,21,79,188,810,2014_DeMarre Carroll
2014,Dewayne Dedmon,C,24,76,166,0.4578313253012048,0,0,NaN,76,166,0.4578313253012048,42,64,0.65625,76,178,254,10,14,44,36,132,194,2014_Dewayne Dedmon
2014,Gerald Green,SG,28,448,1006,0.44532803180914515,204,510,0.4,244,496,0.49193548387096775,195,230,0.8478260869565217,48,227,275,122,70,42,145,220,1295,2014_Gerald Green
2014,Kevin Durant,SF,25,849,1688,0.5029620853080569,192,491,0.3910386965376782,657,1197,0.5488721804511278,703,805,0.8732919254658386,58,540,598,445,103,59,285,174,2593,2014_Kevin Durant
2014,Mustafa Shakur,PG,29,0,3,0.0,0,1,0.0,0,2,0.0,1,2,0.5,0,0,0,4,0,0,2,2,1,2014_Mustafa Shakur
2014,Nikola Vucevic,C,23,353,696,0.507183908045977,0,0,NaN,353,696,0.507183908045977,105,137,0.7664233576642335,185,441,626,104,60,47,112,169,811,2014_Nikola Vucevic
2014,Patty Mills,PG,25,309,666,0.46396396396396394,135,318,0.42452830188679247,174,348,0.5,73,82,0.8902439024390244,34,135,169,149,68,9,63,114,826,2014_Patty Mills
2014,Ray McCallum,PG,22,113,300,0.37666666666666665,22,59,0.3728813559322034,91,241,0.3775933609958506,32,43,0.7441860465116279,18,61,79,120,22,9,39,69,280,2014_Ray McCallum
2014,Reggie Williams,SF,27,5,9,0.5555555555555556,1,3,0.3333333333333333,4,6,0.6666666666666666,0,0,NaN,0,0,0,1,1,0,2,1,11,2014_Reggie Williams
2014,Tim Hardaway,SG,21,294,687,0.4279475982532751,130,358,0.36312849162011174,164,329,0.49848024316109424,106,128,0.828125,19,102,121,66,44,7,47,144,824,2014_Tim Hardaway
2014,Tyler Zeller,C,24,156,290,0.5379310344827586,0,1,0.0,156,289,0.5397923875432526,87,121,0.71900826446281,103,179,282,36,18,38,60,137,399,2014_Tyler Zeller
2015,Andrei Kirilenko,SF,33,0,5,0.0,0,0,NaN,0,5,0.0,3,4,0.75,2,6,8,1,1,0,1,1,3,2015_Andrei Kirilenko
2015,Brandon Jennings,PG,25,218,543,0.4014732965009208,76,211,0.36018957345971564,142,332,0.42771084337349397,120,143,0.8391608391608392,21,83,104,272,44,4,90,64,632,2015_Brandon Jennings
2015,Cory Joseph,PG,23,207,411,0.5036496350364964,16,44,0.36363636363636365,191,367,0.5204359673024523,105,143,0.7342657342657343,44,148,192,188,46,17,67,105,535,2015_Cory Joseph
2015,DeMarre Carroll,SF,28,318,653,0.4869831546707504,120,304,0.39473684210526316,198,349,0.5673352435530086,127,181,0.7016574585635359,99,273,372,118,94,17,75,154,883,2015_DeMarre Carroll
2015,Deron Williams,PG,30,298,771,0.3865110246433204,87,237,0.3670886075949367,211,534,0.3951310861423221,201,241,0.8340248962655602,29,208,237,448,64,17,154,157,884,2015_Deron Williams
2015,Francisco Garcia,SF,33,17,63,0.2698412698412698,10,45,0.2222222222222222,7,18,0.3888888888888889,1,4,0.25,3,14,17,15,9,5,10,20,45,2015_Francisco Garcia
2015,Hassan Whiteside,C,25,243,387,0.627906976744186,0,0,NaN,243,387,0.627906976744186,78,156,0.5,145,337,482,6,27,123,58,129,564,2015_Hassan Whiteside
2015,J.J. Redick,SG,30,447,938,0.47654584221748403,200,458,0.4366812227074236,247,480,0.5145833333333333,183,203,0.9014778325123153,22,145,167,137,39,8,95,134,1277,2015_J.J. Redick
2015,Jabari Brown,SG,22,70,170,0.4117647058823529,23,62,0.3709677419354839,47,108,0.4351851851851852,64,85,0.7529411764705882,3,33,36,40,12,2,32,33,227,2015_Jabari Brown
2015,Joffrey Lauvergne,C,23,36,89,0.4044943820224719,3,16,0.1875,33,73,0.4520547945205479,18,28,0.6428571428571429,27,50,77,13,8,10,22,43,93,2015_Joffrey Lauvergne
2015,Jusuf Nurkic,C,20,171,383,0.4464751958224543,0,2,0.0,171,381,0.44881889763779526,84,132,0.6363636363636364,125,257,382,50,52,68,86,207,426,2015_Jusuf Nurkic
2015,Patty Mills,PG,26,128,336,0.38095238095238093,62,182,0.34065934065934067,66,154,0.42857142857142855,33,40,0.825,21,54,75,87,28,2,35,58,351,2015_Patty Mills
2015,Randy Foye,SG,31,148,402,0.3681592039800995,94,263,0.3574144486692015,54,139,0.38848920863309355,45,55,0.8181818181818182,9,76,85,119,34,11,60,97,435,2015_Randy Foye
2015,Reggie Evans,PF,34,58,137,0.4233576642335766,0,2,0.0,58,135,0.42962962962962964,60,97,0.6185567010309279,97,202,299,32,22,5,45,91,176,2015_Reggie Evans
2015,Reggie Williams,SF,28,15,39,0.38461538461538464,3,19,0.15789473684210525,12,20,0.6,4,4,1.0,5,12,17,10,1,0,2,12,37,2015_Reggie Williams
2015,Tyler Johnson,SG,22,70,167,0.41916167664670656,18,48,0.375,52,119,0.4369747899159664,32,47,0.6808510638297872,14,67,81,42,33,9,30,42,190,2015_Tyler Johnson
2016,Brian Roberts,PG,30,148,330,0.4484848484848485,30,84,0.35714285714285715,118,246,0.4796747967479675,84,94,0.8936170212765957,12,70,82,108,20,4,46,70,410,2016_Brian Roberts
2016,Chandler Parsons,SF,27,320,651,0.4915514592933948,104,251,0.41434262948207173,216,400,0.54,93,136,0.6838235294117647,29,256,285,169,46,21,95,114,837,2016_Chandler Parsons
2016,Cory Joseph,SG,24,257,585,0.4393162393162393,30,110,0.2727272727272727,227,475,0.47789473684210526,133,174,0.764367816091954,39,171,210,250,63,20,102,131,677,2016_Cory Joseph
2016,DeMarre Carroll,SF,29,105,270,0.3888888888888889,46,118,0.3898305084745763,59,152,0.3881578947368421,30,50,0.6,31,91,122,27,44,6,28,63,286,2016_DeMarre Carroll
2016,J.J. Redick,SG,31,422,880,0.47954545454545455,200,421,0.4750593824228028,222,459,0.48366013071895425,182,205,0.8878048780487805,10,129,139,106,42,5,78,135,1226,2016_J.J. Redick
2016,Joffrey Lauvergne,C,24,195,380,0.5131578947368421,13,53,0.24528301886792453,182,327,0.5565749235474006,62,69,0.8985507246376812,77,213,290,56,13,15,54,115,465,2016_Joffrey Lauvergne
2016,Lance Thomas,PF,27,169,382,0.4424083769633508,44,109,0.4036697247706422,125,273,0.45787545787545786,102,119,0.8571428571428571,34,97,131,53,22,7,57,109,484,2016_Lance Thomas
2016,Patty Mills,PG,27,260,612,0.42483660130718953,123,320,0.384375,137,292,0.4691780821917808,47,58,0.8103448275862069,27,131,158,226,59,6,76,102,690,2016_Patty Mills
2016,Rodney Stuckey,PG,29,183,443,0.41309255079006774,20,83,0.24096385542168675,163,360,0.4527777777777778,131,158,0.8291139240506329,19,137,156,142,43,8,76,77,517,2016_Rodney Stuckey
2016,Russ Smith,PG,24,7,22,0.3181818181818182,1,5,0.2,6,17,0.35294117647058826,8,13,0.6153846153846154,1,8,9,11,5,1,7,5,23,2016_Russ Smith
2016,Tyler Hansbrough,PF,30,32,71,0.4507042253521127,2,3,0.6666666666666666,30,68,0.4411764705882353,38,65,0.5846153846153846,40,49,89,8,12,7,12,55,104,2016_Tyler Hansbrough
2016,Tyler Johnson,SG,23,118,243,0.48559670781893005,27,71,0.38028169014084506,91,172,0.5290697674418605,51,64,0.796875,28,81,109,79,24,14,47,66,314,2016_Tyler Johnson
2017,Beno Udrih,PG,34,92,197,0.467005076142132,11,32,0.34375,81,165,0.4909090909090909,32,34,0.9411764705882353,6,51,57,131,13,0,37,29,227,2017_Beno Udrih
2017,Brian Roberts,PG,31,46,122,0.3770491803278688,17,44,0.38636363636363635,29,78,0.3717948717948718,33,39,0.8461538461538461,5,34,39,52,9,1,26,18,142,2017_Brian Roberts
2017,Cory Joseph,SG,25,299,661,0.4523449319213313,48,135,0.35555555555555557,251,526,0.47718631178707227,94,122,0.7704918032786885,51,184,235,265,66,13,108,140,740,2017_Cory Joseph
2017,Courtney Lee,SG,31,321,704,0.4559659090909091,108,269,0.40148698884758366,213,435,0.4896551724137931,85,98,0.8673469387755102,53,207,260,179,81,23,69,141,835,2017_Courtney Lee
2017,Dario Saric,PF,22,381,927,0.4110032362459547,106,341,0.31085043988269795,275,586,0.46928327645051193,172,220,0.7818181818181819,112,401,513,182,57,30,183,162,1040,2017_Dario Saric
2017,Garrett Temple,SG,30,183,432,0.4236111111111111,82,220,0.37272727272727274,101,212,0.47641509433962265,58,74,0.7837837837837838,32,151,183,169,84,28,78,141,506,2017_Garrett Temple
2017,Gorgui Dieng,PF,27,332,661,0.5022692889561271,16,43,0.37209302325581395,316,618,0.511326860841424,136,167,0.8143712574850299,188,459,647,158,88,95,107,254,816,2017_Gorgui Dieng
2017,J.J. Redick,SG,32,396,890,0.4449438202247191,201,468,0.42948717948717946,195,422,0.46208530805687204,180,202,0.8910891089108911,11,160,171,110,55,13,98,125,1173,2017_J.J. Redick
2017,J.R. Smith,SG,31,123,356,0.3455056179775281,95,271,0.3505535055350554,28,85,0.32941176470588235,10,15,0.6666666666666666,17,96,113,62,40,11,26,77,351,2017_J.R. Smith
2017,JaVale McGee,C,29,208,319,0.6520376175548589,0,4,0.0,208,315,0.6603174603174603,56,111,0.5045045045045045,100,144,244,17,19,67,40,109,472,2017_JaVale McGee
2017,Jarrod Uthoff,PF,23,16,38,0.42105263157894735,3,9,0.3333333333333333,13,29,0.4482758620689655,5,7,0.7142857142857143,8,14,22,9,2,4,3,8,40,2017_Jarrod Uthoff
2017,Jeremy Lin,PG,28,175,400,0.4375,58,156,0.3717948717948718,117,244,0.47950819672131145,115,141,0.8156028368794326,11,124,135,184,41,14,86,79,523,2017_Jeremy Lin
2017,Joffrey Lauvergne,C_PF_PF-C,25,296,672,0.44047619047619047,66,196,0.336734693877551,230,476,0.4831932773109244,92,146,0.6301369863013698,144,358,502,140,50,12,112,166,750,2017_Joffrey Lauvergne
2017,Kyle Lowry,PG,30,426,918,0.46405228758169936,193,468,0.41239316239316237,233,450,0.5177777777777778,299,365,0.8191780821917808,48,240,288,417,88,19,173,170,1344,2017_Kyle Lowry
2017,Luc Mbah,SF,30,191,378,0.5052910052910053,43,110,0.39090909090909093,148,268,0.5522388059701493,59,87,0.6781609195402298,47,127,174,39,81,35,47,122,484,2017_Luc Mbah
2017,Patty Mills,PG,28,273,622,0.43890675241157556,147,356,0.41292134831460675,126,266,0.47368421052631576,66,80,0.825,24,118,142,280,65,3,101,109,759,2017_Patty Mills
2017,Rajon Rondo,PG,30,229,561,0.40819964349376114,50,133,0.37593984962406013,179,428,0.4182242990654206,30,50,0.6,73,282,355,461,99,11,168,144,538,2017_Rajon Rondo
2017,Raymond Felton,PG,32,221,514,0.42996108949416345,46,144,0.3194444444444444,175,370,0.47297297297297297,50,64,0.78125,33,184,217,191,67,22,83,125,538,2017_Raymond Felton
2017,Timothe Luwawu-Cabarrot,SF,21,145,361,0.40166204986149584,50,161,0.3105590062111801,95,200,0.475,105,123,0.8536585365853658,25,124,149,75,32,10,73,154,445,2017_Timothe Luwawu-Cabarrot
2017,Tyler Johnson,PG,24,357,824,0.433252427184466,93,250,0.372,264,574,0.45993031358885017,195,254,0.7677165354330708,50,243,293,233,84,44,90,176,1002,2017_Tyler Johnson
2003,Aaron Williams,C,31,199,439,0.4533029612756264,0,1,0.0,199,438,0.454337899543379,102,130,0.7846153846153846,137,194,331,88,27,57,85,206,500,2003_Aaron Williams
2003,Adam Harrington,SG,22,22,74,0.2972972972972973,10,28,0.35714285714285715,12,46,0.2608695652173913,6,8,0.75,2,14,16,24,4,2,4,16,60,2003_Adam Harrington
2003,Antonio Daniels,SG,27,84,186,0.45161290322580644,18,59,0.3050847457627119,66,127,0.5196850393700787,65,76,0.8552631578947368,11,61,72,85,33,9,32,43,251,2003_Antonio Daniels
2003,Earl Boykins,PG,26,199,464,0.42887931034482757,29,77,0.37662337662337664,170,387,0.4392764857881137,173,200,0.865,35,53,88,221,38,4,73,75,600,2003_Earl Boykins
2003,Fred Jones,SG,23,9,24,0.375,2,7,0.2857142857142857,7,17,0.4117647058823529,3,4,0.75,4,5,9,5,6,1,6,13,23,2003_Fred Jones
2003,Jason Collins,C,24,140,338,0.41420118343195267,0,4,0.0,140,334,0.41916167664670656,180,236,0.7627118644067796,136,232,368,87,47,44,85,252,460,2003_Jason Collins
2003,Jeff Trepagnier,SG,23,17,40,0.425,4,8,0.5,13,32,0.40625,7,7,1.0,8,8,16,6,8,0,8,5,45,2003_Jeff Trepagnier
2003,Kurt Thomas,C,30,497,1028,0.48346303501945526,2,3,0.6666666666666666,495,1025,0.48292682926829267,138,184,0.75,160,477,637,162,81,97,138,344,1134,2003_Kurt Thomas
2003,Maceo Baston,PF,27,15,25,0.6,0,0,NaN,15,25,0.6,10,12,0.8333333333333334,4,19,23,0,4,11,6,16,40,2003_Maceo Baston
2003,Matt Maloney,PG,31,8,25,0.32,5,15,0.3333333333333333,3,10,0.3,3,5,0.6,1,6,7,17,4,0,5,9,24,2003_Matt Maloney
2003,Monty Williams,SF,31,34,80,0.425,0,2,0.0,34,78,0.4358974358974359,24,32,0.75,12,33,45,26,12,5,17,33,92,2003_Monty Williams
2003,Pepe Sanchez,PG,25,0,5,0.0,0,0,NaN,0,5,0.0,0,0,NaN,4,2,6,8,5,0,2,3,0,2003_Pepe Sanchez
2003,Rasual Butler,SG,23,207,572,0.3618881118881119,50,171,0.29239766081871343,157,401,0.3915211970074813,76,104,0.7307692307692307,29,157,186,93,21,43,77,105,540,2003_Rasual Butler
2003,Rod Strickland,PG,36,120,278,0.4316546762589928,1,11,0.09090909090909091,119,267,0.44569288389513106,79,107,0.7383177570093458,20,75,95,215,46,6,76,55,320,2003_Rod Strickland
2003,Ron Mercer,SG,26,244,597,0.40871021775544386,3,16,0.1875,241,581,0.41480206540447506,65,81,0.8024691358024691,32,122,154,112,49,14,54,123,556,2003_Ron Mercer
2004,Antonio Daniels,PG,28,187,398,0.46984924623115576,42,116,0.3620689655172414,145,282,0.5141843971631206,155,184,0.842391304347826,23,119,142,298,45,6,61,64,571,2004_Antonio Daniels
2004,Cuttino Mobley,SG,28,460,1081,0.425531914893617,164,420,0.3904761904761905,296,661,0.44780635400907715,176,217,0.8110599078341014,40,322,362,258,107,33,180,179,1260,2004_Cuttino Mobley
2004,Donyell Marshall,PF,30,940,2040,0.46078431372549017,262,650,0.40307692307692305,678,1390,0.48776978417266187,268,364,0.7362637362637363,420,1196,1616,244,186,248,234,494,2410,2004_Donyell Marshall
2004,Eddie Robinson,SF,27,157,326,0.4815950920245399,1,5,0.2,156,321,0.48598130841121495,28,43,0.6511627906976745,27,77,104,58,33,10,45,57,343,2004_Eddie Robinson
2004,James Jones,SF,23,2,9,0.2222222222222222,1,4,0.25,1,5,0.2,2,2,1.0,0,2,2,0,1,0,0,1,7,2004_James Jones
2004,Jason Collins,C,25,163,384,0.4244791666666667,0,2,0.0,163,382,0.42670157068062825,136,184,0.7391304347826086,143,257,400,153,67,56,97,251,462,2004_Jason Collins
2004,Jeff Trepagnier,SG,24,10,38,0.2631578947368421,2,4,0.5,8,34,0.23529411764705882,3,6,0.5,6,9,15,4,3,0,6,7,25,2004_Jeff Trepagnier
2004,Kurt Thomas,PF,31,392,829,0.47285886610373945,0,3,0.0,392,826,0.4745762711864407,106,127,0.8346456692913385,145,517,662,149,56,80,132,298,890,2004_Kurt Thomas
2004,Marcus Camby,C,29,262,549,0.4772313296903461,0,2,0.0,262,547,0.4789762340036563,98,136,0.7205882352941176,211,516,727,132,86,187,98,239,622,2004_Marcus Camby
2004,Rafer Alston,PG,27,287,764,0.3756544502617801,161,434,0.3709677419354839,126,330,0.38181818181818183,103,134,0.7686567164179104,26,200,226,372,114,18,128,212,838,2004_Rafer Alston
2004,Rasual Butler,SF,24,119,250,0.476,50,108,0.46296296296296297,69,142,0.4859154929577465,16,21,0.7619047619047619,4,57,61,23,10,13,28,72,304,2004_Rasual Butler
2004,Richard Hamilton,SG,25,530,1166,0.45454545454545453,18,68,0.2647058823529412,512,1098,0.4663023679417122,297,342,0.868421052631579,78,201,279,310,103,17,210,222,1375,2004_Richard Hamilton
2004,Scottie Pippen,SF,38,53,140,0.37857142857142856,13,48,0.2708333333333333,40,92,0.43478260869565216,17,27,0.6296296296296297,20,48,68,50,21,9,29,38,136,2004_Scottie Pippen
2004,Speedy Claxton,PG,25,224,524,0.42748091603053434,4,22,0.18181818181818182,220,502,0.43824701195219123,182,224,0.8125,38,118,156,267,97,9,102,146,634,2004_Speedy Claxton
2004,Theron Smith,SF,23,16,43,0.37209302325581395,6,12,0.5,10,31,0.3225806451612903,6,8,0.75,13,28,41,7,5,5,14,18,44,2004_Theron Smith
2004,Troy Bell,PG,23,4,18,0.2222222222222222,0,4,0.0,4,14,0.2857142857142857,3,3,1.0,3,1,4,4,1,0,6,6,11,2004_Troy Bell
2005,Antonio Daniels,PG,29,273,623,0.43820224719101125,49,165,0.296969696969697,224,458,0.4890829694323144,248,304,0.8157894736842105,20,149,169,309,51,3,78,78,843,2005_Antonio Daniels
2005,Caron Butler,SF,24,441,991,0.4450050454086781,38,125,0.304,403,866,0.4653579676674365,275,319,0.8620689655172413,146,304,450,146,110,23,125,213,1195,2005_Caron Butler
2005,Erik Daniels,SF,22,6,18,0.3333333333333333,1,2,0.5,5,16,0.3125,0,0,NaN,7,11,18,4,2,0,6,7,13,2005_Erik Daniels
2005,James Jones,SF,24,126,318,0.39622641509433965,66,166,0.39759036144578314,60,152,0.39473684210526316,53,62,0.8548387096774194,39,135,174,57,31,28,43,123,371,2005_James Jones
2005,Jason Collins,C,26,186,451,0.4124168514412417,2,6,0.3333333333333333,184,445,0.4134831460674157,137,209,0.6555023923444976,153,335,488,105,71,71,91,322,511,2005_Jason Collins
2005,Kurt Thomas,PF,32,424,901,0.47058823529411764,2,4,0.5,422,897,0.47045707915273133,66,84,0.7857142857142857,170,661,831,160,70,79,99,310,916,2005_Kurt Thomas
2005,Laron Profit,SF,27,56,128,0.4375,8,28,0.2857142857142857,48,100,0.48,16,25,0.64,24,52,76,37,16,5,27,44,136,2005_Laron Profit
2005,Marcus Fizer,PF,26,133,292,0.4554794520547945,0,6,0.0,133,286,0.46503496503496505,70,103,0.6796116504854369,29,146,175,64,25,13,63,96,336,2005_Marcus Fizer
2005,Matt Carroll,SG,24,70,180,0.3888888888888889,13,39,0.3333333333333333,57,141,0.40425531914893614,71,83,0.8554216867469879,13,47,60,17,17,2,25,37,224,2005_Matt Carroll
2005,Maurice Taylor,C_PF_PF-C,28,406,892,0.4551569506726457,6,18,0.3333333333333333,400,874,0.4576659038901602,126,206,0.6116504854368932,134,380,514,134,54,40,188,360,944,2005_Maurice Taylor
2005,Milt Palacio,PG,26,175,392,0.44642857142857145,2,12,0.16666666666666666,173,380,0.45526315789473687,115,155,0.7419354838709677,26,108,134,279,48,13,104,126,467,2005_Milt Palacio
2005,Rasual Butler,SF,25,163,409,0.39853300733496333,57,153,0.37254901960784315,106,256,0.4140625,37,48,0.7708333333333334,15,136,151,62,18,29,37,104,420,2005_Rasual Butler
2005,Shawn Marion,PF,26,613,1289,0.47556245151280063,114,341,0.3343108504398827,499,948,0.5263713080168776,229,275,0.8327272727272728,235,680,915,154,163,119,125,199,1569,2005_Shawn Marion
2005,Stromile Swift,PF,25,219,488,0.4487704918032787,0,4,0.0,219,484,0.4524793388429752,166,219,0.7579908675799086,92,181,273,43,41,92,90,182,604,2005_Stromile Swift
2005,Travis Outlaw,SF,20,133,267,0.49812734082397003,4,10,0.4,129,257,0.5019455252918288,49,75,0.6533333333333333,40,81,121,35,30,40,39,77,319,2005_Travis Outlaw
2005,Zaza Pachulia,C,20,160,354,0.4519774011299435,0,1,0.0,160,353,0.45325779036827196,138,185,0.745945945945946,131,247,378,60,44,34,70,166,458,2005_Zaza Pachulia
2006,Danny Granger,SF,22,221,478,0.46234309623430964,30,93,0.3225806451612903,191,385,0.4961038961038961,115,148,0.777027027027027,131,253,384,90,58,62,80,211,587,2006_Danny Granger
2006,Eduardo Najera,PF,29,127,301,0.4219269102990033,4,12,0.3333333333333333,123,289,0.42560553633217996,89,114,0.7807017543859649,128,197,325,52,53,34,54,165,347,2006_Eduardo Najera
2006,James Jones,SF,25,243,581,0.41824440619621345,110,285,0.38596491228070173,133,296,0.44932432432432434,103,121,0.8512396694214877,44,209,253,57,38,49,35,142,699,2006_James Jones
2006,Jared Jeffries,PF,24,187,415,0.4506024096385542,16,50,0.32,171,365,0.4684931506849315,99,168,0.5892857142857143,164,215,379,148,58,50,99,223,489,2006_Jared Jeffries
2006,Jason Collins,C,27,104,262,0.3969465648854962,3,12,0.25,101,250,0.404,44,86,0.5116279069767442,93,249,342,70,46,40,61,251,255,2006_Jason Collins
2006,Jason Kidd,PG,32,366,905,0.4044198895027624,139,395,0.3518987341772152,227,510,0.44509803921568625,194,244,0.7950819672131147,86,494,580,672,150,29,192,157,1065,2006_Jason Kidd
2006,Kurt Thomas,C,33,190,391,0.4859335038363171,0,0,NaN,190,391,0.4859335038363171,75,92,0.8152173913043478,102,313,415,57,23,54,57,193,455,2006_Kurt Thomas
2006,Rasual Butler,SF,26,257,633,0.4060031595576619,92,242,0.38016528925619836,165,391,0.4219948849104859,79,114,0.6929824561403509,51,181,232,40,33,45,65,142,685,2006_Rasual Butler
2006,Travis Outlaw,PF,21,162,368,0.44021739130434784,14,53,0.2641509433962264,148,315,0.46984126984126984,62,89,0.6966292134831461,48,141,189,34,31,46,37,112,400,2006_Travis Outlaw
2006,Walter McCarty,SF,31,33,99,0.3333333333333333,10,45,0.2222222222222222,23,54,0.42592592592592593,12,21,0.5714285714285714,15,53,68,23,8,5,19,52,88,2006_Walter McCarty
2006,Zaza Pachulia,C,21,307,681,0.45080763582966227,0,2,0.0,307,679,0.4521354933726068,297,404,0.7351485148514851,264,349,613,129,89,39,180,286,911,2006_Zaza Pachulia
2007,C.J. Miles,SG,19,40,116,0.3448275862068966,7,32,0.21875,33,84,0.39285714285714285,14,23,0.6086956521739131,11,24,35,25,11,4,28,60,101,2007_C.J. Miles
2007,Danny Granger,SF,23,398,868,0.45852534562211983,110,288,0.3819444444444444,288,580,0.496551724137931,236,294,0.8027210884353742,114,267,381,114,67,61,135,245,1142,2007_Danny Granger
2007,Darrick Martin,PG,35,33,94,0.35106382978723405,13,37,0.35135135135135137,20,57,0.3508771929824561,15,21,0.7142857142857143,2,10,12,43,3,0,12,22,94,2007_Darrick Martin
2007,James Jones,SF,26,162,440,0.36818181818181817,90,238,0.37815126050420167,72,202,0.3564356435643564,71,81,0.8765432098765432,33,143,176,45,28,42,28,115,485,2007_James Jones
2007,Jason Collins,PF,28,55,151,0.36423841059602646,0,2,0.0,55,149,0.3691275167785235,59,127,0.4645669291338583,90,226,316,46,40,38,73,273,169,2007_Jason Collins
2007,Keith Bogans,SG,26,99,245,0.40408163265306124,53,137,0.38686131386861317,46,108,0.42592592592592593,47,63,0.746031746031746,16,77,93,59,28,2,46,98,298,2007_Keith Bogans
2007,Kelenna Azubuike,SG,23,98,220,0.44545454545454544,34,79,0.43037974683544306,64,141,0.45390070921985815,61,78,0.782051282051282,26,68,94,28,22,10,39,49,291,2007_Kelenna Azubuike
2007,Kurt Thomas,C,34,126,259,0.4864864864864865,0,1,0.0,126,258,0.4883720930232558,56,71,0.7887323943661971,86,293,379,24,24,29,35,156,308,2007_Kurt Thomas
2007,Lamar Odom,PF,27,319,681,0.4684287812041116,54,182,0.2967032967032967,265,499,0.531062124248497,198,283,0.6996466431095406,102,445,547,270,53,32,163,182,890,2007_Lamar Odom
2007,Linton Johnson,PF,26,93,190,0.48947368421052634,10,30,0.3333333333333333,83,160,0.51875,30,37,0.8108108108108109,52,111,163,18,33,18,27,101,226,2007_Linton Johnson
2007,Pops Mensah-Bonsu,PF,23,11,17,0.6470588235294118,0,0,NaN,11,17,0.6470588235294118,7,18,0.3888888888888889,9,12,21,0,1,0,9,8,29,2007_Pops Mensah-Bonsu
2007,Rasual Butler,SF,27,314,788,0.39847715736040606,134,363,0.3691460055096419,180,425,0.4235294117647059,56,87,0.6436781609195402,42,214,256,63,40,54,67,148,818,2007_Rasual Butler
2007,Ronnie Brewer,SG,21,102,193,0.5284974093264249,0,9,0.0,102,184,0.5543478260869565,56,83,0.6746987951807228,37,38,75,24,37,6,24,44,260,2007_Ronnie Brewer
2007,Ryan Gomes,PF,24,338,723,0.46749654218533887,16,42,0.38095238095238093,322,681,0.47283406754772395,189,233,0.8111587982832618,125,282,407,119,48,13,105,169,881,2007_Ryan Gomes
2007,Shaun Livingston,PG,21,208,449,0.46325167037861914,5,16,0.3125,203,433,0.46882217090069284,82,116,0.7068965517241379,56,128,184,274,59,29,108,135,503,2007_Shaun Livingston
2007,Tim Thomas,PF,29,299,723,0.4135546334716459,136,356,0.38202247191011235,163,367,0.444141689373297,102,144,0.7083333333333334,63,315,378,171,55,28,106,228,836,2007_Tim Thomas
2007,Travis Outlaw,PF,22,246,567,0.43386243386243384,10,37,0.2702702702702703,236,530,0.44528301886792454,143,181,0.7900552486187845,65,152,217,52,61,74,66,150,645,2007_Travis Outlaw
2007,Zaza Pachulia,C,22,291,614,0.4739413680781759,0,1,0.0,291,613,0.47471451876019577,293,373,0.7855227882037533,199,301,500,106,77,36,162,267,875,2007_Zaza Pachulia
2008,Aaron Brooks,PG,23,93,225,0.41333333333333333,36,109,0.3302752293577982,57,116,0.49137931034482757,42,49,0.8571428571428571,13,43,56,87,13,5,44,69,264,2008_Aaron Brooks
2008,Andres Nocioni,SF,28,379,877,0.4321550741163056,126,346,0.36416184971098264,253,531,0.4764595103578154,196,243,0.8065843621399177,48,294,342,95,25,43,133,245,1080,2008_Andres Nocioni
2008,Danny Granger,SF,24,537,1205,0.445643153526971,171,423,0.40425531914893614,366,782,0.4680306905370844,322,378,0.8518518518518519,93,393,486,166,95,84,171,290,1567,2008_Danny Granger
2008,James Jones,SF,27,143,327,0.43730886850152906,91,205,0.44390243902439025,52,122,0.4262295081967213,86,98,0.8775510204081632,43,118,161,34,24,15,28,96,463,2008_James Jones
2008,Jason Collins,C,29,106,226,0.4690265486725664,0,2,0.0,106,224,0.4732142857142857,68,148,0.4594594594594595,128,228,356,50,46,50,96,388,280,2008_Jason Collins
2008,Kurt Thomas,C_PF_C-PF,35,390,792,0.49242424242424243,0,2,0.0,390,790,0.4936708860759494,106,160,0.6625,260,754,1014,134,112,114,92,376,886,2008_Kurt Thomas
2008,Michael Redd,SG,28,550,1243,0.4424778761061947,130,359,0.362116991643454,420,884,0.4751131221719457,402,490,0.8204081632653061,85,224,309,247,65,13,181,120,1632,2008_Michael Redd
2008,Nenad Krstic,C,24,123,300,0.41,0,2,0.0,123,298,0.412751677852349,52,69,0.7536231884057971,35,165,200,27,9,17,41,111,298,2008_Nenad Krstic
2008,Rasual Butler,SF,28,91,260,0.35,44,133,0.3308270676691729,47,127,0.3700787401574803,26,31,0.8387096774193549,16,84,100,36,15,21,10,66,252,2008_Rasual Butler
2008,Ronnie Brewer,SG,22,354,634,0.5583596214511041,11,50,0.22,343,584,0.5873287671232876,195,257,0.7587548638132295,97,121,218,134,129,19,69,110,914,2008_Ronnie Brewer
2008,Sean Marks,C,32,23,43,0.5348837209302325,1,4,0.25,22,39,0.5641025641025641,12,19,0.631578947368421,9,27,36,4,3,10,8,23,59,2008_Sean Marks
2008,Stephon Marbury,PG,30,111,265,0.4188679245283019,28,74,0.3783783783783784,83,191,0.43455497382198954,83,116,0.7155172413793104,17,42,59,113,21,2,48,57,333,2008_Stephon Marbury
2008,Tarence Kinsey,SG,23,16,38,0.42105263157894735,3,7,0.42857142857142855,13,31,0.41935483870967744,5,6,0.8333333333333334,3,9,12,2,3,0,3,11,40,2008_Tarence Kinsey
2008,Thaddeus Young,PF,19,264,490,0.5387755102040817,6,19,0.3157894736842105,258,471,0.5477707006369427,76,103,0.7378640776699029,120,192,312,58,73,8,64,126,610,2008_Thaddeus Young
2008,Travis Outlaw,PF,23,417,964,0.43257261410788383,40,101,0.39603960396039606,377,863,0.43684820393974505,218,294,0.7414965986394558,96,280,376,106,59,63,107,173,1092,2008_Travis Outlaw
2008,Zaza Pachulia,C,23,107,245,0.43673469387755104,0,3,0.0,107,242,0.44214876033057854,108,153,0.7058823529411765,89,159,248,36,24,13,69,140,322,2008_Zaza Pachulia
2009,Brian Scalabrine,C,30,48,114,0.42105263157894735,24,61,0.39344262295081966,24,53,0.4528301886792453,16,18,0.8888888888888888,7,43,50,18,7,10,12,73,136,2009_Brian Scalabrine
2009,Cedric Simmons,PF,23,22,50,0.44,0,0,NaN,22,50,0.44,14,32,0.4375,10,22,32,4,2,8,4,16,58,2009_Cedric Simmons
2009,Charlie Villanueva,PF,24,487,1089,0.44719926538108357,89,258,0.3449612403100775,398,831,0.4789410348977136,201,240,0.8375,154,366,520,137,50,56,138,254,1264,2009_Charlie Villanueva
2009,Danny Granger,SF,25,571,1277,0.447141738449491,182,450,0.40444444444444444,389,827,0.4703748488512696,404,460,0.8782608695652174,49,292,341,183,69,97,165,207,1728,2009_Danny Granger
2009,Gerald Green,SG,23,79,180,0.4388888888888889,14,46,0.30434782608695654,65,134,0.48507462686567165,27,32,0.84375,14,40,54,15,10,5,33,51,199,2009_Gerald Green
2009,J.R. Giddens,SF,23,2,3,0.6666666666666666,0,0,NaN,2,3,0.6666666666666666,0,0,NaN,2,1,3,0,1,0,1,1,4,2009_J.R. Giddens
2009,James Jones,SF,28,55,149,0.3691275167785235,33,96,0.34375,22,53,0.41509433962264153,26,31,0.8387096774193549,12,50,62,20,12,14,12,58,169,2009_James Jones
2009,Kenny Thomas,PF,31,3,8,0.375,0,0,NaN,3,8,0.375,0,0,NaN,4,11,15,1,6,1,1,9,6,2009_Kenny Thomas
2009,Kevin Durant,SF,20,661,1390,0.47553956834532374,97,230,0.4217391304347826,564,1160,0.4862068965517241,452,524,0.8625954198473282,77,405,482,205,96,53,225,134,1871,2009_Kevin Durant
2009,Kurt Thomas,PF,36,153,304,0.5032894736842105,0,2,0.0,153,302,0.5066225165562914,37,45,0.8222222222222222,134,271,405,66,34,58,42,170,343,2009_Kurt Thomas
2009,Linas Kleiza,SF,24,289,646,0.4473684210526316,87,267,0.3258426966292135,202,379,0.5329815303430079,148,204,0.7254901960784313,92,235,327,64,31,14,82,155,813,2009_Linas Kleiza
2009,Lindsey Hunter,PG,38,27,82,0.32926829268292684,16,48,0.3333333333333333,11,34,0.3235294117647059,3,5,0.6,2,10,12,37,20,1,19,28,73,2009_Lindsey Hunter
2009,Pops Mensah-Bonsu,PF,25,78,206,0.3786407766990291,0,4,0.0,78,202,0.38613861386138615,66,96,0.6875,110,116,226,12,18,10,38,86,222,2009_Pops Mensah-Bonsu
2009,Rasual Butler,SF,29,348,803,0.43337484433374845,140,359,0.38997214484679665,208,444,0.46846846846846846,86,110,0.7818181818181819,49,222,271,75,51,61,59,159,922,2009_Rasual Butler
2009,Ronnie Brewer,SF,23,421,828,0.5084541062801933,22,85,0.25882352941176473,399,743,0.5370121130551817,247,352,0.7017045454545454,101,199,300,179,138,30,110,128,1111,2009_Ronnie Brewer
2009,Ryan Bowen,SF,33,22,38,0.5789473684210527,0,0,NaN,22,38,0.5789473684210527,3,5,0.6,10,14,24,9,14,5,5,37,47,2009_Ryan Bowen
2009,Sasha Pavlovic,SF,25,116,275,0.4218181818181818,48,117,0.41025641025641024,68,158,0.43037974683544306,25,54,0.46296296296296297,31,96,127,72,22,16,48,122,305,2009_Sasha Pavlovic
2009,Stephon Marbury,PG,31,38,111,0.34234234234234234,6,25,0.24,32,86,0.37209302325581395,6,13,0.46153846153846156,2,26,28,75,10,3,37,34,88,2009_Stephon Marbury
2009,Travis Outlaw,SF,24,385,850,0.45294117647058824,89,236,0.3771186440677966,296,614,0.4820846905537459,175,242,0.7231404958677686,70,261,331,83,47,57,94,168,1034,2009_Travis Outlaw
2009,Zaza Pachulia,C,24,159,320,0.496875,0,3,0.0,159,317,0.501577287066246,163,230,0.7086956521739131,173,263,436,57,35,26,91,208,481,2009_Zaza Pachulia
2010,Acie Law,PG,25,70,150,0.4666666666666667,10,32,0.3125,60,118,0.5084745762711864,76,98,0.7755102040816326,6,28,34,52,22,2,34,32,226,2010_Acie Law
2010,Andrei Kirilenko,SF,28,244,482,0.5062240663900415,26,89,0.29213483146067415,218,393,0.55470737913486,174,234,0.7435897435897436,76,188,264,158,83,71,79,102,688,2010_Andrei Kirilenko
2010,Anthony Parker,SG,34,206,475,0.4336842105263158,108,261,0.41379310344827586,98,214,0.45794392523364486,75,95,0.7894736842105263,30,201,231,157,63,18,71,151,595,2010_Anthony Parker
2010,Bobby Brown,PG,25,176,474,0.37130801687763715,52,196,0.2653061224489796,124,278,0.4460431654676259,26,30,0.8666666666666667,18,58,76,176,30,2,92,84,430,2010_Bobby Brown
2010,Brandon Roy,SG,25,491,1038,0.4730250481695568,73,221,0.33031674208144796,418,817,0.5116279069767442,343,440,0.7795454545454545,73,212,285,305,61,16,129,136,1398,2010_Brandon Roy
2010,Corey Maggette,PF,30,457,886,0.5158013544018059,13,50,0.26,444,836,0.5311004784688995,460,551,0.8348457350272233,92,281,373,172,51,4,168,231,1387,2010_Corey Maggette
2010,Danny Green,SG,22,15,39,0.38461538461538464,6,22,0.2727272727272727,9,17,0.5294117647058824,4,6,0.6666666666666666,8,9,17,5,6,3,5,9,40,2010_Danny Green
2010,David Andersen,C,29,147,340,0.4323529411764706,27,78,0.34615384615384615,120,262,0.4580152671755725,46,67,0.6865671641791045,54,154,208,44,15,12,37,119,367,2010_David Andersen
2010,Deron Williams,PG,25,494,1053,0.4691358024691358,96,259,0.37065637065637064,398,794,0.5012594458438288,335,418,0.8014354066985646,50,253,303,798,96,16,252,208,1419,2010_Deron Williams
2010,Francisco Garcia,SG,28,82,176,0.4659090909090909,23,59,0.3898305084745763,59,117,0.5042735042735043,15,17,0.8823529411764706,11,55,66,45,10,19,21,49,202,2010_Francisco Garcia
2010,Jason Collins,C,31,8,23,0.34782608695652173,0,1,0.0,8,22,0.36363636363636365,0,2,0.0,5,9,14,4,3,2,5,21,16,2010_Jason Collins
2010,Jeff Green,PF,23,485,1070,0.4532710280373832,104,312,0.3333333333333333,381,758,0.5026385224274407,165,223,0.7399103139013453,112,378,490,134,104,72,135,221,1239,2010_Jeff Green
2010,Lou Williams,PG,23,318,677,0.46971935007385524,70,206,0.33980582524271846,248,471,0.5265392781316348,192,233,0.8240343347639485,25,162,187,268,80,15,106,110,898,2010_Lou Williams
2010,Matt Bonner,PF,29,166,372,0.44623655913978494,90,231,0.38961038961038963,76,141,0.5390070921985816,35,48,0.7291666666666666,52,162,214,68,30,24,39,109,457,2010_Matt Bonner
2010,Oliver Lafayette,SG,25,3,6,0.5,1,2,0.5,2,4,0.5,0,0,NaN,1,3,4,2,0,0,1,0,7,2010_Oliver Lafayette
2010,Othyus Jeffers,SG,24,12,29,0.41379310344827586,0,0,NaN,12,29,0.41379310344827586,13,19,0.6842105263157895,8,11,19,1,4,0,6,10,37,2010_Othyus Jeffers
2010,Randy Foye,PG,26,256,619,0.4135702746365105,63,182,0.34615384615384615,193,437,0.4416475972540046,129,145,0.8896551724137931,16,114,130,228,33,10,94,123,704,2010_Randy Foye
2010,Rasual Butler,SF,30,356,870,0.4091954022988506,145,432,0.33564814814814814,211,438,0.4817351598173516,122,145,0.8413793103448276,39,201,240,116,36,68,79,121,979,2010_Rasual Butler
2010,Reggie Evans,PF,29,34,69,0.4927536231884058,0,0,NaN,34,69,0.4927536231884058,27,60,0.45,30,75,105,8,14,4,22,44,95,2010_Reggie Evans
2010,Shannon Brown,SG,24,253,592,0.42736486486486486,62,189,0.328042328042328,191,403,0.4739454094292804,99,121,0.8181818181818182,30,153,183,108,57,31,67,129,667,2010_Shannon Brown
2010,Steven Hunter,C,28,17,43,0.3953488372093023,0,0,NaN,17,43,0.3953488372093023,19,36,0.5277777777777778,18,24,42,0,1,10,9,10,53,2010_Steven Hunter
2010,Theo Ratliff,C,36,140,304,0.4605263157894737,0,0,NaN,140,304,0.4605263157894737,76,100,0.76,118,196,314,50,24,122,82,174,356,2010_Theo Ratliff
2011,Andre Miller,PG,34,388,844,0.4597156398104265,4,37,0.10810810810810811,384,807,0.4758364312267658,249,292,0.8527397260273972,97,205,302,566,114,12,197,171,1029,2011_Andre Miller
2011,Antonio Daniels,PG,35,2,5,0.4,0,2,0.0,2,3,0.6666666666666666,2,2,1.0,0,5,5,2,0,0,1,0,6,2011_Antonio Daniels
2011,Brandon Roy,SG,26,209,523,0.39961759082217974,38,114,0.3333333333333333,171,409,0.4180929095354523,117,138,0.8478260869565217,28,93,121,129,37,12,55,76,573,2011_Brandon Roy
2011,Danny Green,SG,23,17,35,0.4857142857142857,7,19,0.3684210526315789,10,16,0.625,0,0,NaN,3,12,15,2,2,1,5,7,41,2011_Danny Green
2011,David West,PF,30,528,1040,0.5076923076923077,2,9,0.2222222222222222,526,1031,0.510184287099903,264,327,0.8073394495412844,155,374,529,164,67,62,142,202,1322,2011_David West
2011,Ersan Ilyasova,PF,23,221,507,0.4358974358974359,36,121,0.2975206611570248,185,386,0.4792746113989637,93,104,0.8942307692307693,105,260,365,56,51,24,63,159,571,2011_Ersan Ilyasova
2011,James Jones,SF,30,146,346,0.42196531791907516,123,287,0.42857142857142855,23,59,0.3898305084745763,60,72,0.8333333333333334,23,137,160,43,29,19,21,129,475,2011_James Jones
2011,Jason Collins,C,32,34,71,0.4788732394366197,1,1,1.0,33,70,0.4714285714285714,27,41,0.6585365853658537,30,72,102,22,9,9,26,97,96,2011_Jason Collins
2011,Kevin Seraphin,PF,21,66,147,0.4489795918367347,0,0,NaN,66,147,0.4489795918367347,22,31,0.7096774193548387,80,72,152,10,17,28,42,126,154,2011_Kevin Seraphin
2011,Kosta Koufos,C,21,136,300,0.4533333333333333,0,4,0.0,136,296,0.4594594594594595,48,86,0.5581395348837209,114,146,260,14,20,50,62,118,320,2011_Kosta Koufos
2011,Ramon Sessions,PG,24,362,776,0.46649484536082475,3,15,0.2,359,761,0.47174770039421815,348,423,0.8226950354609929,46,209,255,419,60,8,178,93,1075,2011_Ramon Sessions
2011,Rasual Butler,SG,31,158,474,0.3333333333333333,92,272,0.3382352941176471,66,202,0.32673267326732675,36,54,0.6666666666666666,20,134,154,54,16,30,48,74,444,2011_Rasual Butler
2011,Shannon Brown,SG,25,273,643,0.42457231726283046,74,212,0.3490566037735849,199,431,0.4617169373549884,92,101,0.9108910891089109,35,122,157,96,67,16,75,124,712,2011_Shannon Brown
2011,Tyler Hansbrough,PF,25,285,613,0.46492659053833607,0,2,0.0,285,611,0.4664484451718494,197,253,0.7786561264822134,145,221,366,41,37,15,76,160,767,2011_Tyler Hansbrough
2012,Beno Udrih,SG,29,146,332,0.4397590361445783,17,59,0.288135593220339,129,273,0.4725274725274725,39,55,0.7090909090909091,26,76,102,227,37,1,77,69,348,2012_Beno Udrih
2012,Bismack Biyombo,C,19,129,278,0.46402877697841727,0,0,NaN,129,278,0.46402877697841727,69,143,0.4825174825174825,113,255,368,27,20,115,71,145,327,2012_Bismack Biyombo
2012,Courtney Lee,SG,26,251,580,0.43275862068965515,87,217,0.4009216589861751,164,363,0.45179063360881544,71,86,0.8255813953488372,26,133,159,88,68,22,64,106,660,2012_Courtney Lee
2012,Danny Green,SG,24,211,477,0.44234800838574423,102,234,0.4358974358974359,109,243,0.448559670781893,79,100,0.79,54,174,228,86,58,46,67,107,603,2012_Danny Green
2012,Grant Hill,SF,39,201,451,0.44567627494456763,14,53,0.2641509433962264,187,398,0.46984924623115576,83,109,0.7614678899082569,29,142,171,107,41,29,65,88,499,2012_Grant Hill
2012,J.R. Smith,SG,26,165,405,0.4074074074074074,67,193,0.3471502590673575,98,212,0.46226415094339623,39,55,0.7090909090909091,29,107,136,84,54,6,46,87,436,2012_J.R. Smith
2012,James Jones,SG,31,57,150,0.38,46,114,0.40350877192982454,11,36,0.3055555555555556,25,30,0.8333333333333334,6,43,49,19,17,9,10,45,185,2012_James Jones
2012,Jason Collins,C,33,16,40,0.4,0,0,NaN,16,40,0.4,7,15,0.4666666666666667,12,36,48,10,4,3,10,34,39,2012_Jason Collins
2012,Josh Davis,PF,31,10,27,0.37037037037037035,4,13,0.3076923076923077,6,14,0.42857142857142855,4,8,0.5,16,11,27,6,7,1,3,19,28,2012_Josh Davis
2012,Kyle Lowry,PG,25,210,513,0.4093567251461988,79,211,0.3744075829383886,131,302,0.4337748344370861,171,198,0.8636363636363636,37,176,213,310,73,14,130,133,670,2012_Kyle Lowry
2012,Luc Mbah,PF,25,133,261,0.5095785440613027,1,4,0.25,132,257,0.5136186770428015,66,103,0.6407766990291263,77,150,227,29,40,22,39,93,333,2012_Luc Mbah
2012,Rasual Butler,SF,32,41,133,0.3082706766917293,21,77,0.2727272727272727,20,56,0.35714285714285715,7,12,0.5833333333333334,6,60,66,19,7,5,15,39,110,2012_Rasual Butler
2012,Raymond Felton,PG,27,261,642,0.40654205607476634,62,203,0.3054187192118227,199,439,0.4533029612756264,100,124,0.8064516129032258,27,122,149,390,78,10,170,122,684,2012_Raymond Felton
2012,Shannon Brown,SG,26,251,598,0.4197324414715719,68,188,0.3617021276595745,183,410,0.44634146341463415,80,99,0.8080808080808081,38,119,157,69,44,15,64,66,650,2012_Shannon Brown
2013,Andrew Bogut,C,28,83,184,0.45108695652173914,1,1,1.0,82,183,0.44808743169398907,19,38,0.5,68,177,245,67,20,55,35,85,186,2013_Andrew Bogut
2013,Anthony Randolph,PF,23,56,114,0.49122807017543857,0,8,0.0,56,106,0.5283018867924528,31,45,0.6888888888888889,29,66,95,12,19,21,37,41,143,2013_Anthony Randolph
2013,Brandon Roy,SG,28,11,35,0.3142857142857143,0,9,0.0,11,26,0.4230769230769231,7,10,0.7,3,11,14,23,3,0,7,5,29,2013_Brandon Roy
2013,Chris Andersen,C,34,71,123,0.5772357723577236,2,3,0.6666666666666666,69,120,0.575,63,93,0.6774193548387096,57,115,172,17,16,44,24,89,207,2013_Chris Andersen
2013,Danny Green,SG,25,297,663,0.4479638009049774,177,413,0.42857142857142855,120,250,0.48,67,79,0.8481012658227848,36,208,244,141,92,54,94,124,838,2013_Danny Green
2013,Jamal Crawford,SG,32,445,1016,0.43799212598425197,149,396,0.37626262626262624,296,620,0.4774193548387097,216,248,0.8709677419354839,22,106,128,193,79,13,146,71,1255,2013_Jamal Crawford
2013,James Jones,SF,32,21,61,0.3442622950819672,16,53,0.3018867924528302,5,8,0.625,2,4,0.5,0,22,22,13,2,6,3,16,60,2013_James Jones
2013,Jason Collins,C,34,18,58,0.3103448275862069,0,0,NaN,18,58,0.3103448275862069,46,64,0.71875,44,76,120,16,24,20,36,170,82,2013_Jason Collins
2013,Jeff Ayres,PF,25,61,126,0.48412698412698413,2,4,0.5,59,122,0.48360655737704916,21,23,0.9130434782608695,29,75,104,15,6,12,23,44,145,2013_Jeff Ayres
2013,Jonas Valanciunas,C,20,204,366,0.5573770491803278,0,0,NaN,204,366,0.5573770491803278,146,185,0.7891891891891892,121,251,372,45,17,78,94,188,554,2013_Jonas Valanciunas
2013,Kris Joseph,SF,24,4,28,0.14285714285714285,0,6,0.0,4,22,0.18181818181818182,10,16,0.625,2,12,14,2,6,0,4,6,18,2013_Kris Joseph
2013,Kurt Thomas,PF,40,45,83,0.5421686746987951,1,1,1.0,44,82,0.5365853658536586,6,13,0.46153846153846156,24,65,89,21,10,16,8,52,97,2013_Kurt Thomas
2013,Mickael Gelabale,SF,29,72,139,0.5179856115107914,16,52,0.3076923076923077,56,87,0.6436781609195402,21,24,0.875,32,67,99,26,16,4,16,47,181,2013_Mickael Gelabale
2013,Perry Jones,SF,21,39,99,0.3939393939393939,0,2,0.0,39,97,0.4020618556701031,10,15,0.6666666666666666,12,50,62,10,5,6,15,23,88,2013_Perry Jones
2013,Shannon Brown,SG,27,240,571,0.4203152364273205,39,141,0.2765957446808511,201,430,0.46744186046511627,98,125,0.784,44,105,149,108,59,15,74,92,617,2013_Shannon Brown
2014,Danny Granger,SF,30,232,614,0.3778501628664495,86,256,0.3359375,146,358,0.40782122905027934,126,134,0.9402985074626866,62,204,266,82,24,34,92,124,676,2014_Danny Granger
2014,Danny Green,SG,26,218,505,0.4316831683168317,132,318,0.41509433962264153,86,187,0.45989304812834225,50,63,0.7936507936507936,25,204,229,104,65,61,76,107,618,2014_Danny Green
2014,James Jones,SF,33,31,68,0.45588235294117646,28,54,0.5185185185185185,3,14,0.21428571428571427,7,11,0.6363636363636364,2,21,23,9,3,4,4,6,97,2014_James Jones
2014,Jason Collins,C,35,11,24,0.4583333333333333,0,3,0.0,11,21,0.5238095238095238,3,4,0.75,7,12,19,4,8,1,7,30,25,2014_Jason Collins
2014,John Jenkins,SG,22,16,42,0.38095238095238093,4,18,0.2222222222222222,12,24,0.5,4,4,1.0,3,19,22,11,1,1,11,11,40,2014_John Jenkins
2014,Jonas Valanciunas,C,21,359,676,0.5310650887573964,0,1,0.0,359,675,0.5318518518518518,198,260,0.7615384615384615,226,488,714,57,24,71,136,249,916,2014_Jonas Valanciunas
2014,Meyers Leonard,C,21,41,91,0.45054945054945056,0,6,0.0,41,85,0.4823529411764706,16,21,0.7619047619047619,26,85,111,18,7,5,15,76,98,2014_Meyers Leonard
2014,Perry Jones,PF,22,83,181,0.4585635359116022,22,61,0.36065573770491804,61,120,0.5083333333333333,28,42,0.6666666666666666,28,86,114,26,14,19,21,62,216,2014_Perry Jones
2014,Rasual Butler,SG,34,51,110,0.4636363636363636,26,62,0.41935483870967744,25,48,0.5208333333333334,8,14,0.5714285714285714,6,35,41,17,7,9,11,30,136,2014_Rasual Butler
2014,Reggie Jackson,PG,23,403,916,0.43995633187772926,83,245,0.33877551020408164,320,671,0.47690014903129657,158,177,0.8926553672316384,43,270,313,331,85,9,168,142,1047,2014_Reggie Jackson
2014,Shannon Brown,SG,28,48,132,0.36363636363636365,0,4,0.0,48,128,0.375,30,42,0.7142857142857143,14,42,56,18,26,0,36,48,126,2014_Shannon Brown
2014,Steven Adams,C,20,93,185,0.5027027027027027,0,0,NaN,93,185,0.5027027027027027,79,136,0.5808823529411765,142,190,332,43,40,57,71,203,265,2014_Steven Adams
2014,Xavier Henry,SF,22,144,345,0.41739130434782606,28,81,0.345679012345679,116,264,0.4393939393939394,116,177,0.655367231638418,25,89,114,51,44,7,57,79,432,2014_Xavier Henry
2015,Andre Iguodala,SF,31,231,496,0.4657258064516129,74,212,0.3490566037735849,157,284,0.5528169014084507,68,114,0.5964912280701754,44,213,257,228,89,25,88,100,604,2015_Andre Iguodala
2015,Bradley Beal,SG,21,363,851,0.42655699177438305,106,259,0.4092664092664093,257,592,0.4341216216216216,130,166,0.7831325301204819,57,184,241,194,76,18,123,136,962,2015_Bradley Beal
2015,Danny Granger,SF,31,65,162,0.4012345679012346,30,84,0.35714285714285715,35,78,0.44871794871794873,28,37,0.7567567567567568,20,60,80,17,13,6,24,67,188,2015_Danny Granger
2015,Danny Green,SG,27,322,738,0.4363143631436314,191,457,0.4179431072210066,131,281,0.46619217081850534,111,127,0.8740157480314961,54,289,343,158,101,87,93,163,946,2015_Danny Green
2015,Earl Clark,PF,27,11,30,0.36666666666666664,4,14,0.2857142857142857,7,16,0.4375,1,4,0.25,1,22,23,3,3,4,6,12,27,2015_Earl Clark
2015,Henry Sims,C,24,238,502,0.47410358565737054,4,22,0.18181818181818182,234,480,0.4875,106,137,0.7737226277372263,121,238,359,79,39,30,99,135,586,2015_Henry Sims
2015,James Jones,SF,34,74,201,0.3681592039800995,63,175,0.36,11,26,0.4230769230769231,39,46,0.8478260869565217,9,53,62,24,13,8,13,67,250,2015_James Jones
2015,Joe Harris,SG,23,48,120,0.4,31,84,0.36904761904761907,17,36,0.4722222222222222,9,15,0.6,7,34,41,26,7,2,27,62,136,2015_Joe Harris
2015,Jonas Valanciunas,C,22,373,652,0.5720858895705522,0,1,0.0,373,651,0.5729646697388633,217,276,0.7862318840579711,215,478,693,39,33,95,109,222,963,2015_Jonas Valanciunas
2015,Julius Randle,PF,20,1,3,0.3333333333333333,0,0,NaN,1,3,0.3333333333333333,0,2,0.0,0,0,0,0,0,0,1,1,2,2015_Julius Randle
2015,Kemba Walker,PG,24,378,981,0.3853211009174312,85,280,0.30357142857142855,293,701,0.41797432239657634,234,283,0.8268551236749117,35,185,220,318,89,31,100,92,1075,2015_Kemba Walker
2015,Lou Amundson,PF,32,218,510,0.42745098039215684,0,2,0.0,218,508,0.42913385826771655,82,174,0.47126436781609193,188,348,536,140,44,104,124,252,518,2015_Lou Amundson
2015,Perry Jones,SF,23,73,184,0.3967391304347826,14,60,0.23333333333333334,59,124,0.47580645161290325,24,37,0.6486486486486487,6,70,76,18,17,8,24,50,184,2015_Perry Jones
2015,Rasual Butler,SF,35,218,517,0.42166344294003866,91,235,0.3872340425531915,127,282,0.450354609929078,53,67,0.7910447761194029,27,170,197,63,29,22,48,98,580,2015_Rasual Butler
2015,Ronny Turiaf,C,32,0,0,NaN,0,0,NaN,0,0,NaN,0,0,NaN,0,1,1,2,0,0,0,0,0,2015_Ronny Turiaf
2015,Shannon Brown,SG,29,7,19,0.3684210526315789,3,7,0.42857142857142855,4,12,0.3333333333333333,3,4,0.75,0,1,1,3,4,0,4,8,20,2015_Shannon Brown
2015,Will Bynum,SG,32,10,31,0.3225806451612903,0,9,0.0,10,22,0.45454545454545453,2,4,0.5,2,4,6,18,1,1,8,9,22,2015_Will Bynum
2015,Zaza Pachulia,C,30,240,529,0.45368620037807184,0,3,0.0,240,526,0.45627376425855515,126,160,0.7875,197,303,500,178,80,21,133,170,606,2015_Zaza Pachulia
2016,Caron Butler,SF,35,25,59,0.423728813559322,3,18,0.16666666666666666,22,41,0.5365853658536586,10,12,0.8333333333333334,5,17,22,10,9,1,3,19,63,2016_Caron Butler
2016,Clint Capela,C,21,231,397,0.5818639798488665,0,1,0.0,231,396,0.5833333333333334,80,211,0.3791469194312796,194,300,494,47,59,92,60,190,542,2016_Clint Capela
2016,Danny Green,SG,28,211,561,0.3761140819964349,116,349,0.332378223495702,95,212,0.4481132075471698,34,46,0.7391304347826086,48,255,303,141,79,64,75,141,572,2016_Danny Green
2016,Derrick Favors,PF,24,418,811,0.5154130702836005,0,4,0.0,418,807,0.5179677819083024,180,254,0.7086614173228346,169,334,503,94,74,91,104,150,1016,2016_Derrick Favors
2016,Eric Bledsoe,PG,26,223,492,0.4532520325203252,48,129,0.37209302325581395,175,363,0.4820936639118457,138,172,0.8023255813953488,18,107,125,190,63,19,110,75,632,2016_Eric Bledsoe
2016,James Jones,SF,35,58,142,0.4084507042253521,41,104,0.3942307692307692,17,38,0.4473684210526316,21,26,0.8076923076923077,8,42,50,14,11,10,13,50,178,2016_James Jones
2016,Jerami Grant,SF,21,251,599,0.41903171953255425,35,146,0.23972602739726026,216,453,0.4768211920529801,212,322,0.6583850931677019,99,262,361,135,54,127,110,215,749,2016_Jerami Grant
2016,Jonas Valanciunas,C,23,303,536,0.5652985074626866,0,0,NaN,303,536,0.5652985074626866,162,213,0.7605633802816901,184,363,547,42,25,80,85,158,768,2016_Jonas Valanciunas
2016,Julius Randle,PF,21,358,835,0.4287425149700599,10,36,0.2777777777777778,348,799,0.4355444305381727,193,270,0.7148148148148148,172,657,829,144,53,29,149,242,919,2016_Julius Randle
2016,Keith Appling,PG,23,2,8,0.25,0,3,0.0,2,5,0.4,2,2,1.0,0,1,1,1,1,0,3,5,6,2016_Keith Appling
2016,Kelly Olynyk,C,24,253,556,0.4550359712230216,85,210,0.40476190476190477,168,346,0.48554913294797686,96,128,0.75,72,209,281,105,52,33,74,163,687,2016_Kelly Olynyk
2016,Mario Hezonja,SF,20,181,418,0.43301435406698563,67,192,0.3489583333333333,114,226,0.504424778761062,49,54,0.9074074074074074,28,148,176,109,39,17,97,124,478,2016_Mario Hezonja
2016,Rasual Butler,SF,36,49,104,0.47115384615384615,15,49,0.30612244897959184,34,55,0.6181818181818182,11,16,0.6875,3,53,56,24,13,23,8,11,124,2016_Rasual Butler
2016,Ronnie Price,PG,32,116,302,0.3841059602649007,68,196,0.3469387755102041,48,106,0.4528301886792453,31,41,0.7560975609756098,25,74,99,147,74,13,70,161,331,2016_Ronnie Price
2016,Tyreke Evans,SG,26,136,314,0.43312101910828027,33,85,0.38823529411764707,103,229,0.4497816593886463,74,93,0.7956989247311828,20,109,129,164,32,8,73,66,379,2016_Tyreke Evans
2016,Zaza Pachulia,C,31,219,470,0.46595744680851064,0,3,0.0,219,467,0.4689507494646681,212,276,0.7681159420289855,249,469,718,128,64,22,119,181,650,2016_Zaza Pachulia
2017,Brandon Knight,SG,25,209,525,0.3980952380952381,45,139,0.3237410071942446,164,386,0.42487046632124353,132,154,0.8571428571428571,25,93,118,130,27,5,89,87,595,2017_Brandon Knight
2017,Danny Green,SG,29,176,449,0.39198218262806234,118,311,0.37942122186495175,58,138,0.42028985507246375,27,32,0.84375,31,193,224,124,71,58,76,120,497,2017_Danny Green
2017,DeMarcus Cousins,C,26,1294,2866,0.4515003489183531,262,728,0.3598901098901099,1032,2138,0.48269410664172124,1034,1340,0.7716417910447761,306,1288,1594,664,200,184,538,556,3884,2017_DeMarcus Cousins
2017,James Jones,SF,36,44,92,0.4782608695652174,31,66,0.4696969696969697,13,26,0.5,13,20,0.65,3,35,38,14,7,10,10,37,132,2017_James Jones
2017,Joel Anthony,C,34,10,16,0.625,0,0,NaN,10,16,0.625,5,8,0.625,8,23,31,3,2,6,4,11,25,2017_Joel Anthony
2017,Jonas Valanciunas,C,24,391,702,0.5569800569800569,1,2,0.5,390,700,0.5571428571428572,176,217,0.8110599078341014,226,533,759,57,37,63,106,216,959,2017_Jonas Valanciunas
2017,Jonathon Simmons,SG,27,177,421,0.42042755344418054,30,102,0.29411764705882354,147,319,0.4608150470219436,99,132,0.75,20,140,160,126,47,25,76,146,483,2017_Jonathon Simmons
2017,Julius Randle,PF,22,377,773,0.48771021992238034,17,63,0.2698412698412698,360,710,0.5070422535211268,204,282,0.723404255319149,151,485,636,264,49,37,173,248,975,2017_Julius Randle
2017,Justin Holiday,SG,27,233,538,0.43308550185873607,97,273,0.3553113553113553,136,265,0.5132075471698113,66,80,0.825,27,198,225,102,65,31,66,109,629,2017_Justin Holiday
2017,K.J. McDaniels,SF,23,154,338,0.4556213017751479,40,132,0.30303030303030304,114,206,0.5533980582524272,64,76,0.8421052631578947,30,134,164,26,38,36,58,98,412,2017_K.J. McDaniels
2017,Luis Scola,PF,36,71,151,0.47019867549668876,17,50,0.34,54,101,0.5346534653465347,25,37,0.6756756756756757,51,88,139,37,14,4,34,63,184,2017_Luis Scola
2017,Mario Hezonja,SF,21,117,330,0.35454545454545455,43,144,0.2986111111111111,74,186,0.3978494623655914,40,50,0.8,20,126,146,62,30,14,58,74,317,2017_Mario Hezonja
2017,Marshall Plumlee,C,24,16,30,0.5333333333333333,0,0,NaN,16,30,0.5333333333333333,8,19,0.42105263157894735,23,28,51,10,4,4,12,23,40,2017_Marshall Plumlee
2017,Sheldon McClellan,SG,24,30,75,0.4,7,30,0.23333333333333334,23,45,0.5111111111111111,23,27,0.8518518518518519,4,30,34,15,8,2,5,17,90,2017_Sheldon McClellan
2017,Tomas Satoransky,SG,25,61,146,0.4178082191780822,9,37,0.24324324324324326,52,109,0.47706422018348627,23,33,0.696969696969697,25,58,83,92,26,6,38,60,154,2017_Tomas Satoransky
2017,Zaza Pachulia,C,32,164,307,0.5342019543973942,0,2,0.0,164,305,0.5377049180327869,98,126,0.7777777777777778,140,270,410,132,59,33,88,166,426,2017_Zaza Pachulia
2003,Anthony Johnson,PG,28,103,231,0.4458874458874459,13,35,0.37142857142857144,90,196,0.45918367346938777,51,74,0.6891891891891891,13,65,78,86,37,5,41,93,270,2003_Anthony Johnson
2003,Arvydas Sabonis,C,38,172,361,0.47645429362880887,3,6,0.5,169,355,0.476056338028169,129,164,0.7865853658536586,88,247,335,142,61,49,75,141,476,2003_Arvydas Sabonis
2003,Avery Johnson,PG,37,63,150,0.42,0,2,0.0,63,148,0.42567567567567566,30,39,0.7692307692307693,10,21,31,64,15,1,29,26,156,2003_Avery Johnson
2003,Darrell Armstrong,PG,34,263,643,0.40902021772939345,78,232,0.33620689655172414,185,411,0.45012165450121655,165,188,0.8776595744680851,91,204,295,323,135,13,160,167,769,2003_Darrell Armstrong
2003,DeShawn Stevenson,SG,21,114,284,0.4014084507042254,4,12,0.3333333333333333,110,272,0.40441176470588236,47,68,0.6911764705882353,22,63,85,40,22,8,49,57,279,2003_DeShawn Stevenson
2003,Eddie Jones,SG,31,291,688,0.42296511627906974,98,241,0.4066390041493776,193,447,0.4317673378076063,189,230,0.8217391304347826,35,191,226,173,64,31,85,137,869,2003_Eddie Jones
2003,Erick Strickland,SG,29,163,380,0.42894736842105263,62,160,0.3875,101,220,0.4590909090909091,70,87,0.8045977011494253,23,122,145,209,38,7,98,111,458,2003_Erick Strickland
2003,Gerald Wallace,SF,20,90,183,0.4918032786885246,1,4,0.25,89,179,0.4972067039106145,39,74,0.527027027027027,38,90,128,23,24,15,44,68,220,2003_Gerald Wallace
2003,Jamal Sampson,PF,19,0,2,0.0,0,0,NaN,0,2,0.0,0,0,NaN,1,1,2,1,1,0,0,0,0,2003_Jamal Sampson
2003,Jason Richardson,SG,22,476,1161,0.4099913867355728,123,334,0.36826347305389223,353,827,0.4268440145102781,207,271,0.7638376383763837,111,267,378,247,90,23,179,201,1282,2003_Jason Richardson
2003,John Amaechi,C,32,37,118,0.3135593220338983,0,0,NaN,37,118,0.3135593220338983,25,52,0.4807692307692308,26,51,77,21,14,7,34,50,99,2003_John Amaechi
2003,Mark Madsen,PF,27,69,163,0.4233128834355828,0,0,NaN,69,163,0.4233128834355828,36,61,0.5901639344262295,86,73,159,38,15,19,27,116,174,2003_Mark Madsen
2003,Metta World,SF,23,362,846,0.42789598108747046,71,211,0.33649289099526064,291,635,0.4582677165354331,273,371,0.7358490566037735,101,261,362,198,159,50,145,242,1068,2003_Metta World
2003,Michael Dickerson,SG,27,10,24,0.4166666666666667,4,11,0.36363636363636365,6,13,0.46153846153846156,5,5,1.0,1,5,6,8,5,1,6,16,29,2003_Michael Dickerson
2003,Pau Gasol,PF,22,569,1116,0.5098566308243727,1,10,0.1,568,1106,0.5135623869801085,416,565,0.736283185840708,192,528,720,229,34,148,213,220,1555,2003_Pau Gasol
2003,Sean Marks,PF,27,22,59,0.3728813559322034,0,1,0.0,22,58,0.3793103448275862,10,15,0.6666666666666666,8,27,35,3,5,6,14,37,54,2003_Sean Marks
2003,Tamar Slay,SG,22,39,103,0.3786407766990291,7,25,0.28,32,78,0.41025641025641024,7,10,0.7,8,23,31,14,14,3,20,31,92,2003_Tamar Slay
2003,Tom Gugliotta,PF,33,60,132,0.45454545454545453,0,1,0.0,60,131,0.4580152671755725,9,9,1.0,25,75,100,31,14,5,31,35,129,2003_Tom Gugliotta
2003,Wang Zhizhi,C,25,62,162,0.38271604938271603,16,47,0.3404255319148936,46,115,0.4,42,58,0.7241379310344828,26,51,77,10,8,10,31,41,182,2003_Wang Zhizhi
2004,Anthony Johnson,PG,29,167,411,0.40632603406326034,41,122,0.3360655737704918,126,289,0.4359861591695502,75,94,0.7978723404255319,28,102,130,202,64,8,75,138,450,2004_Anthony Johnson
2004,Avery Johnson,PG,38,80,199,0.4020100502512563,0,3,0.0,80,196,0.40816326530612246,52,78,0.6666666666666666,3,30,33,111,26,3,51,34,212,2004_Avery Johnson
2004,Brian Cook,C,23,67,141,0.475177304964539,0,5,0.0,67,136,0.49264705882352944,21,28,0.75,31,70,101,20,16,16,17,64,155,2004_Brian Cook
2004,Brian Scalabrine,PF,25,86,218,0.3944954128440367,10,41,0.24390243902439024,76,177,0.4293785310734463,58,70,0.8285714285714286,42,131,173,65,21,14,42,113,240,2004_Brian Scalabrine
2004,Darrell Armstrong,PG,35,291,736,0.3953804347826087,135,429,0.3146853146853147,156,307,0.50814332247557,123,144,0.8541666666666666,63,163,226,311,133,16,155,148,840,2004_Darrell Armstrong
2004,DeShawn Stevenson,SF_SG_SG-SF,22,752,1742,0.4316877152698048,38,142,0.2676056338028169,714,1600,0.44625,276,408,0.6764705882352942,158,438,596,316,104,34,240,280,1818,2004_DeShawn Stevenson
2004,Dwyane Wade,PG,22,371,798,0.4649122807017544,16,53,0.3018867924528302,355,745,0.47651006711409394,233,312,0.7467948717948718,85,162,247,275,86,34,196,140,991,2004_Dwyane Wade
2004,Eddie Jones,SG,32,473,1156,0.4091695501730104,177,479,0.3695198329853862,296,677,0.43722304283604135,278,333,0.8348348348348348,38,270,308,258,92,34,129,226,1401,2004_Eddie Jones
2004,Jahidi White,C,27,198,380,0.5210526315789473,0,0,NaN,198,380,0.5210526315789473,126,252,0.5,194,328,522,14,50,102,132,352,522,2004_Jahidi White
2004,Kenny Thomas,PF,26,381,813,0.46863468634686345,1,5,0.2,380,808,0.47029702970297027,243,323,0.7523219814241486,261,489,750,111,82,33,172,219,1006,2004_Kenny Thomas
2004,Mark Madsen,C,28,101,204,0.4950980392156863,0,6,0.0,101,198,0.51010101010101,57,118,0.4830508474576271,134,138,272,28,33,18,47,175,259,2004_Mark Madsen
2004,Metta World,SF,24,468,1112,0.420863309352518,75,242,0.30991735537190085,393,870,0.4517241379310345,322,439,0.7334851936218679,100,285,385,272,152,50,202,194,1333,2004_Metta World
2004,Nikoloz Tskitishvili,PF,20,40,122,0.32786885245901637,3,11,0.2727272727272727,37,111,0.3333333333333333,23,29,0.7931034482758621,24,39,63,10,6,8,17,50,106,2004_Nikoloz Tskitishvili
2004,Omar Cook,PG,22,7,27,0.25925925925925924,0,1,0.0,7,26,0.2692307692307692,0,0,NaN,3,3,6,24,10,0,10,14,14,2004_Omar Cook
2004,Pau Gasol,PF,23,506,1049,0.48236415633937085,4,15,0.26666666666666666,502,1034,0.48549323017408125,365,511,0.7142857142857143,206,394,600,198,44,132,187,185,1381,2004_Pau Gasol
2004,Ryan Bowen,PF,28,18,53,0.33962264150943394,0,0,NaN,18,53,0.33962264150943394,10,12,0.8333333333333334,39,48,87,18,18,16,6,47,46,2004_Ryan Bowen
2004,Tom Gugliotta,PF,34,140,406,0.3448275862068966,2,8,0.25,138,398,0.34673366834170855,40,56,0.7142857142857143,130,244,374,126,62,24,78,162,322,2004_Tom Gugliotta
2004,Wang Zhizhi,C,26,34,92,0.3695652173913043,8,28,0.2857142857142857,26,64,0.40625,18,20,0.9,8,28,36,4,6,10,12,26,94,2004_Wang Zhizhi
2005,Andrei Kirilenko,PF,23,207,420,0.4928571428571429,23,77,0.2987012987012987,184,343,0.5364431486880467,203,259,0.7837837837837838,89,166,255,132,67,136,90,101,640,2005_Andrei Kirilenko
2005,Ansu Sesay,SF,28,17,42,0.40476190476190477,2,8,0.25,15,34,0.4411764705882353,13,24,0.5416666666666666,18,20,38,12,2,3,8,16,49,2005_Ansu Sesay
2005,Chucky Atkins,PG,30,388,910,0.42637362637362636,176,455,0.3868131868131868,212,455,0.46593406593406594,163,203,0.8029556650246306,31,166,197,358,73,2,151,181,1115,2005_Chucky Atkins
2005,Darrell Armstrong,PG,36,178,554,0.3212996389891697,56,222,0.25225225225225223,122,332,0.3674698795180723,116,136,0.8529411764705882,70,160,230,356,90,16,134,184,528,2005_Darrell Armstrong
2005,DeShawn Stevenson,SG,23,174,426,0.4084507042253521,25,67,0.373134328358209,149,359,0.415041782729805,56,101,0.5544554455445545,38,64,102,69,16,9,57,73,429,2005_DeShawn Stevenson
2005,Dwyane Wade,SG,23,630,1318,0.4779969650986343,13,45,0.28888888888888886,617,1273,0.4846818538884525,581,762,0.7624671916010499,110,287,397,520,121,82,321,230,1854,2005_Dwyane Wade
2005,Eddie Jones,SF,33,351,820,0.42804878048780487,142,382,0.3717277486910995,209,438,0.4771689497716895,174,216,0.8055555555555556,38,367,405,212,86,38,99,251,1018,2005_Eddie Jones
2005,Jermaine Jackson,SG,28,17,33,0.5151515151515151,0,2,0.0,17,31,0.5483870967741935,8,13,0.6153846153846154,3,20,23,24,7,1,10,26,42,2005_Jermaine Jackson
2005,Joel Przybilla,C,25,199,333,0.5975975975975976,0,0,NaN,199,333,0.5975975975975976,90,174,0.5172413793103449,178,410,588,74,24,163,98,239,488,2005_Joel Przybilla
2005,John Edwards,C,23,11,30,0.36666666666666664,0,0,NaN,11,30,0.36666666666666664,7,14,0.5,8,11,19,3,3,4,8,12,29,2005_John Edwards
2005,Lee Nailon,SF,29,415,869,0.47756041426927504,0,2,0.0,415,867,0.4786620530565167,133,165,0.806060606060606,128,170,298,109,36,16,110,190,963,2005_Lee Nailon
2005,Mario Kasun,C,24,47,98,0.47959183673469385,0,1,0.0,47,97,0.4845360824742268,24,43,0.5581395348837209,52,76,128,8,8,13,26,86,118,2005_Mario Kasun
2005,Mark Madsen,C,29,34,66,0.5151515151515151,0,0,NaN,34,66,0.5151515151515151,20,40,0.5,63,65,128,18,7,14,24,103,88,2005_Mark Madsen
2005,Metta World,SF,25,59,119,0.4957983193277311,7,17,0.4117647058823529,52,102,0.5098039215686274,47,51,0.9215686274509803,8,37,45,22,12,6,17,27,172,2005_Metta World
2005,Omar Cook,PG,23,10,24,0.4166666666666667,0,4,0.0,10,20,0.5,3,6,0.5,2,5,7,22,6,1,6,6,23,2005_Omar Cook
2005,Pau Gasol,PF,24,357,695,0.5136690647482014,1,6,0.16666666666666666,356,689,0.5166908563134979,282,367,0.7683923705722071,130,280,410,135,37,93,137,146,997,2005_Pau Gasol
2005,Reggie Evans,PF,24,131,275,0.4763636363636364,0,2,0.0,131,273,0.47985347985347987,125,234,0.5341880341880342,254,482,736,58,58,15,104,202,387,2005_Reggie Evans
2005,Rodney White,SF,24,242,578,0.4186851211072664,48,120,0.4,194,458,0.42358078602620086,54,88,0.6136363636363636,48,130,178,88,64,22,74,128,586,2005_Rodney White
2005,Scot Pollard,C,29,79,167,0.47305389221556887,0,0,NaN,79,167,0.47305389221556887,33,49,0.673469387755102,85,120,205,18,30,24,31,123,191,2005_Scot Pollard
2005,Theo Ratliff,C,31,115,257,0.4474708171206226,0,0,NaN,115,257,0.4474708171206226,74,107,0.6915887850467289,111,220,331,34,23,158,56,183,304,2005_Theo Ratliff
2005,Tom Gugliotta,PF,35,198,482,0.4107883817427386,16,52,0.3076923076923077,182,430,0.4232558139534884,66,86,0.7674418604651163,112,270,382,136,82,34,114,208,478,2005_Tom Gugliotta
2005,Wang Zhizhi,C,27,17,36,0.4722222222222222,2,3,0.6666666666666666,15,33,0.45454545454545453,7,12,0.5833333333333334,6,12,18,5,3,2,5,9,43,2005_Wang Zhizhi
2006,Chucky Atkins,PG-SG_SG_PG,31,452,1146,0.3944153577661431,194,548,0.354014598540146,258,598,0.431438127090301,258,326,0.7914110429447853,46,194,240,396,86,4,174,304,1356,2006_Chucky Atkins
2006,Darrell Armstrong,PG,37,43,128,0.3359375,11,48,0.22916666666666666,32,80,0.4,33,42,0.7857142857142857,18,63,81,86,27,3,58,71,130,2006_Darrell Armstrong
2006,DeShawn Stevenson,SG,24,359,781,0.45966709346991036,2,15,0.13333333333333333,357,766,0.4660574412532637,180,242,0.743801652892562,59,182,241,160,58,17,123,178,900,2006_DeShawn Stevenson
2006,Didier Ilunga-Mbenga,C,25,32,60,0.5333333333333333,0,1,0.0,32,59,0.5423728813559322,10,20,0.5,19,37,56,2,6,25,16,47,74,2006_Didier Ilunga-Mbenga
2006,Dwyane Wade,SG,24,699,1413,0.49469214437367304,13,76,0.17105263157894737,686,1337,0.5130890052356021,629,803,0.7833125778331258,107,323,430,503,146,58,268,217,2040,2006_Dwyane Wade
2006,Eddie Jones,SG,34,292,722,0.40443213296398894,133,374,0.35561497326203206,159,348,0.45689655172413796,168,215,0.7813953488372093,35,244,279,177,131,27,93,201,885,2006_Eddie Jones
2006,Mario Kasun,C,25,31,69,0.4492753623188406,0,0,NaN,31,69,0.4492753623188406,18,23,0.782608695652174,24,36,60,3,2,3,15,69,80,2006_Mario Kasun
2006,Metta World,SF,26,700,1734,0.40369088811995385,156,506,0.308300395256917,544,1228,0.44299674267100975,412,610,0.6754098360655738,150,422,572,406,244,82,262,328,1968,2006_Metta World
2006,Mike Bibby,PG,27,597,1382,0.4319826338639653,192,497,0.386317907444668,405,885,0.4576271186440678,342,403,0.8486352357320099,29,211,240,444,82,10,199,169,1728,2006_Mike Bibby
2006,Pau Gasol,PF,25,600,1194,0.5025125628140703,3,12,0.25,597,1182,0.5050761421319797,425,617,0.6888168557536467,191,522,713,371,46,153,235,184,1628,2006_Pau Gasol
2006,Ray Allen,SG,30,681,1500,0.454,269,653,0.4119448698315467,412,847,0.48642266824085006,324,359,0.9025069637883009,71,261,332,286,105,16,188,151,1955,2006_Ray Allen
2007,Beno Udrih,PG,24,127,344,0.3691860465116279,33,115,0.28695652173913044,94,229,0.4104803493449782,53,60,0.8833333333333333,11,71,82,122,27,1,56,70,340,2007_Beno Udrih
2007,Chris Webber,PF,33,578,1278,0.4522691705790297,8,22,0.36363636363636365,570,1256,0.4538216560509554,204,320,0.6375,248,626,874,376,120,82,214,286,1368,2007_Chris Webber
2007,Chucky Atkins,PG,32,310,715,0.43356643356643354,116,306,0.3790849673202614,194,409,0.4743276283618582,252,311,0.8102893890675241,18,121,139,346,50,4,127,136,988,2007_Chucky Atkins
2007,Damon Stoudamire,PG,33,171,437,0.391304347826087,59,175,0.33714285714285713,112,262,0.42748091603053434,66,83,0.7951807228915663,31,108,139,299,47,2,101,95,467,2007_Damon Stoudamire
2007,Darrell Armstrong,PG,38,156,377,0.41379310344827586,72,214,0.3364485981308411,84,163,0.5153374233128835,73,93,0.7849462365591398,34,101,135,191,70,6,76,102,457,2007_Darrell Armstrong
2007,David Wesley,SG,36,22,75,0.29333333333333333,9,38,0.23684210526315788,13,37,0.35135135135135137,20,28,0.7142857142857143,3,32,35,37,12,4,17,32,73,2007_David Wesley
2007,DeShawn Stevenson,SG,25,347,753,0.46082337317397076,74,183,0.40437158469945356,273,570,0.4789473684210526,152,216,0.7037037037037037,55,161,216,218,65,19,119,155,920,2007_DeShawn Stevenson
2007,Dwyane Wade,SG,25,472,962,0.49064449064449067,21,79,0.26582278481012656,451,883,0.5107587768969423,432,535,0.8074766355140187,51,188,239,384,107,62,216,117,1397,2007_Dwyane Wade
2007,Eddie Jones,SG,35,356,844,0.4218009478672986,156,444,0.35135135135135137,200,400,0.5,118,150,0.7866666666666666,62,318,380,218,136,20,94,248,986,2007_Eddie Jones
2007,Grant Hill,SG,34,342,660,0.5181818181818182,2,12,0.16666666666666666,340,648,0.5246913580246914,248,324,0.7654320987654321,53,184,237,138,61,25,144,146,934,2007_Grant Hill
2007,Ira Newble,SF,32,16,37,0.43243243243243246,8,15,0.5333333333333333,8,22,0.36363636363636365,6,10,0.6,13,17,30,2,6,0,3,17,46,2007_Ira Newble
2007,J.R. Smith,SG,21,284,644,0.4409937888198758,149,382,0.3900523560209424,135,262,0.5152671755725191,102,126,0.8095238095238095,30,113,143,91,49,9,85,147,819,2007_J.R. Smith
2007,Juan Dixon,SG,28,598,1406,0.42532005689900426,158,452,0.3495575221238938,440,954,0.4612159329140461,202,232,0.8706896551724138,54,262,316,246,152,18,202,354,1556,2007_Juan Dixon
2007,Kyle Lowry,PG,20,14,38,0.3684210526315789,3,8,0.375,11,30,0.36666666666666664,25,28,0.8928571428571429,12,19,31,32,14,1,12,20,56,2007_Kyle Lowry
2007,Matt Harpring,SF,30,322,656,0.49085365853658536,13,39,0.3333333333333333,309,617,0.5008103727714749,237,309,0.7669902912621359,117,236,353,99,52,11,118,232,894,2007_Matt Harpring
2007,Metta World,SF,27,458,1040,0.4403846153846154,93,260,0.3576923076923077,365,780,0.46794871794871795,307,415,0.7397590361445783,102,352,454,235,149,43,146,205,1316,2007_Metta World
2007,Michael Ruffin,PF,30,5,18,0.2777777777777778,0,0,NaN,5,18,0.2777777777777778,7,19,0.3684210526315789,35,27,62,6,6,8,12,43,17,2007_Michael Ruffin
2007,Pau Gasol,C,26,462,858,0.5384615384615384,3,11,0.2727272727272727,459,847,0.5419126328217237,299,400,0.7475,149,432,581,201,29,126,162,137,1226,2007_Pau Gasol
2007,Ray Allen,SG,31,505,1153,0.43798785776235905,165,443,0.3724604966139955,340,710,0.4788732394366197,279,309,0.9029126213592233,57,190,247,228,82,11,154,113,1454,2007_Ray Allen
2007,Raymond Felton,PG,22,393,1024,0.3837890625,103,312,0.3301282051282051,290,712,0.40730337078651685,204,256,0.796875,51,216,267,545,118,10,230,180,1093,2007_Raymond Felton
2007,Sean May,PF,22,164,328,0.5,2,3,0.6666666666666666,162,325,0.49846153846153846,86,112,0.7678571428571429,73,160,233,66,19,24,56,100,416,2007_Sean May
2007,Smush Parker,PG,25,342,785,0.4356687898089172,110,301,0.3654485049833887,232,484,0.4793388429752066,113,175,0.6457142857142857,45,161,206,228,119,10,153,211,907,2007_Smush Parker
2007,Troy Hudson,PG,30,74,195,0.37948717948717947,28,80,0.35,46,115,0.4,26,32,0.8125,8,40,48,73,14,2,40,23,202,2007_Troy Hudson
2008,Anderson Varejao,C,25,136,295,0.4610169491525424,0,2,0.0,136,293,0.4641638225255973,49,82,0.5975609756097561,134,265,399,53,37,26,59,134,321,2008_Anderson Varejao
2008,Andrew Bogut,C,23,465,910,0.510989010989011,0,7,0.0,465,903,0.5149501661129569,189,322,0.5869565217391305,245,518,763,199,64,135,172,254,1119,2008_Andrew Bogut
2008,Calvin Booth,C,31,9,27,0.3333333333333333,0,0,NaN,9,27,0.3333333333333333,6,10,0.6,6,32,38,8,6,18,4,35,24,2008_Calvin Booth
2008,Chucky Atkins,SG,33,42,122,0.3442622950819672,25,79,0.31645569620253167,17,43,0.3953488372093023,4,9,0.4444444444444444,3,28,31,47,9,1,10,27,113,2008_Chucky Atkins
2008,Darrell Armstrong,PG,39,40,110,0.36363636363636365,23,69,0.3333333333333333,17,41,0.4146341463414634,20,30,0.6666666666666666,17,50,67,73,28,2,41,53,123,2008_Darrell Armstrong
2008,DeShawn Stevenson,SG,26,301,780,0.3858974358974359,158,413,0.38256658595641646,143,367,0.3896457765667575,157,197,0.7969543147208121,37,198,235,252,65,15,102,110,917,2008_DeShawn Stevenson
2008,Dwyane Wade,SG,26,439,937,0.46851654215581645,22,77,0.2857142857142857,417,860,0.4848837209302326,354,467,0.7580299785867237,45,169,214,354,87,37,224,137,1254,2008_Dwyane Wade
2008,Eddie Jones,SG,36,66,180,0.36666666666666664,34,116,0.29310344827586204,32,64,0.5,10,14,0.7142857142857143,18,114,132,69,26,8,29,72,176,2008_Eddie Jones
2008,Jelani McCoy,C,30,1,1,1.0,0,0,NaN,1,1,1.0,1,2,0.5,1,6,7,0,0,5,4,7,3,2008_Jelani McCoy
2008,Joakim Noah,C,22,177,367,0.4822888283378747,0,1,0.0,177,366,0.48360655737704916,134,194,0.6907216494845361,174,242,416,84,68,64,89,173,488,2008_Joakim Noah
2008,Matt Harpring,SF,31,237,474,0.5,2,10,0.2,235,464,0.5064655172413793,146,205,0.7121951219512195,96,144,240,82,45,14,95,162,622,2008_Matt Harpring
2008,Metta World,SF,28,436,962,0.45322245322245325,84,221,0.38009049773755654,352,741,0.4750337381916329,212,295,0.7186440677966102,101,227,328,199,133,38,148,159,1168,2008_Metta World
2008,Mickael Gelabale,SG,24,69,157,0.4394904458598726,16,37,0.43243243243243246,53,120,0.44166666666666665,14,18,0.7777777777777778,16,42,58,33,10,9,27,31,168,2008_Mickael Gelabale
2008,Pau Gasol,C,27,950,1780,0.5337078651685393,8,32,0.25,942,1748,0.5389016018306636,584,724,0.8066298342541437,310,796,1106,422,60,196,248,278,2492,2008_Pau Gasol
2008,Ray Allen,SG,32,439,986,0.44523326572008115,180,452,0.39823008849557523,259,534,0.4850187265917603,215,237,0.9071729957805907,75,193,268,225,65,16,127,147,1273,2008_Ray Allen
2008,Troy Hudson,PG,31,9,31,0.2903225806451613,4,12,0.3333333333333333,5,19,0.2631578947368421,6,6,1.0,0,7,7,9,3,0,7,4,28,2008_Troy Hudson
2009,Chucky Atkins,PG,34,68,226,0.3008849557522124,30,114,0.2631578947368421,38,112,0.3392857142857143,30,32,0.9375,10,38,48,118,20,4,46,54,196,2009_Chucky Atkins
2009,DeShawn Stevenson,SG,27,72,231,0.3116883116883117,35,129,0.2713178294573643,37,102,0.3627450980392157,32,60,0.5333333333333333,11,65,76,98,21,2,32,43,211,2009_DeShawn Stevenson
2009,Devin Harris,PG,25,455,1039,0.4379210779595765,64,220,0.2909090909090909,391,819,0.47741147741147744,496,605,0.8198347107438017,30,201,231,476,114,13,212,164,1470,2009_Devin Harris
2009,Dwyane Wade,SG,27,854,1739,0.49108683151236343,88,278,0.31654676258992803,766,1461,0.5242984257357974,590,771,0.7652399481193255,89,309,398,589,173,106,272,178,2386,2009_Dwyane Wade
2009,Eric Gordon,SG,20,411,901,0.45615982241953384,131,337,0.3887240356083086,280,564,0.49645390070921985,299,350,0.8542857142857143,45,156,201,215,78,35,164,172,1252,2009_Eric Gordon
2009,Joakim Noah,C,23,207,372,0.5564516129032258,0,1,0.0,207,371,0.5579514824797843,123,182,0.6758241758241759,244,362,606,106,49,110,82,238,537,2009_Joakim Noah
2009,Maceo Baston,PF,33,25,46,0.5434782608695652,0,1,0.0,25,45,0.5555555555555556,17,27,0.6296296296296297,22,30,52,7,6,10,12,39,67,2009_Maceo Baston
2009,Matt Harpring,SG,32,111,241,0.4605809128630705,0,2,0.0,111,239,0.46443514644351463,55,72,0.7638888888888888,47,76,123,28,29,9,29,102,277,2009_Matt Harpring
2009,Metta World,SF,29,416,1037,0.40115718418514945,153,383,0.39947780678851175,263,654,0.40214067278287463,196,262,0.7480916030534351,65,294,359,229,105,24,140,155,1181,2009_Metta World
2009,Michael Beasley,PF,20,452,957,0.4723092998955068,33,81,0.4074074074074074,419,876,0.478310502283105,186,241,0.7717842323651453,110,329,439,83,41,37,121,184,1123,2009_Michael Beasley
2009,Pau Gasol,C,28,592,1045,0.5665071770334928,1,2,0.5,591,1043,0.5666347075743049,343,439,0.7813211845102506,262,518,780,284,52,81,157,172,1528,2009_Pau Gasol
2009,Ray Allen,SG,33,499,1040,0.4798076923076923,199,486,0.4094650205761317,300,554,0.5415162454873647,237,249,0.9518072289156626,66,212,278,218,69,13,134,157,1434,2009_Ray Allen
2009,Sun Yue,SG,23,3,11,0.2727272727272727,0,6,0.0,3,5,0.6,0,0,NaN,0,0,0,2,1,1,3,10,6,2009_Sun Yue
2010,Amir Johnson,PF,22,208,334,0.6227544910179641,0,4,0.0,208,330,0.6303030303030303,95,149,0.6375838926174496,154,241,395,48,44,66,63,255,511,2010_Amir Johnson
2010,Andre Iguodala,SF,26,496,1120,0.44285714285714284,94,303,0.3102310231023102,402,817,0.4920440636474908,315,430,0.7325581395348837,82,447,529,472,141,55,218,145,1401,2010_Andre Iguodala
2010,Andrew Bynum,C,22,392,688,0.5697674418604651,0,1,0.0,392,687,0.5705967976710334,193,261,0.7394636015325671,177,364,541,68,35,94,115,193,977,2010_Andrew Bynum
2010,Anthony Johnson,PG,35,49,111,0.44144144144144143,13,39,0.3333333333333333,36,72,0.5,19,20,0.95,8,40,48,63,11,1,26,32,130,2010_Anthony Johnson
2010,Brook Lopez,C,21,563,1129,0.49867139061116034,0,2,0.0,563,1127,0.49955634427684115,416,509,0.8172888015717092,270,439,709,187,55,139,204,251,1542,2010_Brook Lopez
2010,Byron Mullens,PF,20,7,19,0.3684210526315789,0,0,NaN,7,19,0.3684210526315789,0,0,NaN,3,7,10,1,2,0,4,13,14,2010_Byron Mullens
2010,Cedric Jackson,PG,23,12,40,0.3,2,12,0.16666666666666666,10,28,0.35714285714285715,14,24,0.5833333333333334,4,12,16,28,6,4,22,14,40,2010_Cedric Jackson
2010,DeAndre Jordan,C,21,144,238,0.6050420168067226,0,2,0.0,144,236,0.6101694915254238,48,128,0.375,122,230,352,21,16,62,75,152,336,2010_DeAndre Jordan
2010,Hamed Haddadi,C,24,24,62,0.3870967741935484,0,3,0.0,24,59,0.4067796610169492,14,19,0.7368421052631579,26,49,75,10,1,14,20,57,62,2010_Hamed Haddadi
2010,Hasheem Thabeet,C,22,77,131,0.5877862595419847,0,0,NaN,77,131,0.5877862595419847,54,93,0.5806451612903226,85,158,243,11,15,89,43,162,208,2010_Hasheem Thabeet
2010,Kwame Brown,C,27,62,124,0.5,0,1,0.0,62,123,0.5040650406504065,33,98,0.336734693877551,53,124,177,22,15,12,43,93,157,2010_Kwame Brown
2010,Lou Amundson,PF,27,152,276,0.5507246376811594,0,1,0.0,152,275,0.5527272727272727,67,123,0.5447154471544715,128,218,346,31,24,73,57,169,371,2010_Lou Amundson
2010,Metta World,SF,30,306,740,0.4135135135135135,105,296,0.3547297297297297,201,444,0.4527027027027027,128,186,0.6881720430107527,99,232,331,234,106,21,121,165,845,2010_Metta World
2010,Ronny Turiaf,C,27,85,146,0.5821917808219178,0,1,0.0,85,145,0.5862068965517241,37,78,0.47435897435897434,54,137,191,90,23,54,49,98,207,2010_Ronny Turiaf
2010,Serge Ibaka,PF,20,201,370,0.5432432432432432,1,2,0.5,200,368,0.5434782608695652,58,92,0.6304347826086957,138,259,397,10,25,97,68,194,461,2010_Serge Ibaka
2010,Will Bynum,PG,27,237,534,0.4438202247191011,12,55,0.21818181818181817,225,479,0.4697286012526096,142,178,0.797752808988764,24,118,142,283,55,7,115,143,628,2010_Will Bynum
2011,Brook Lopez,C,22,644,1309,0.4919786096256685,0,1,0.0,644,1308,0.4923547400611621,385,489,0.787321063394683,197,291,488,129,47,120,176,240,1673,2011_Brook Lopez
2011,Byron Mullens,PF,21,9,28,0.32142857142857145,0,0,NaN,9,28,0.32142857142857145,7,14,0.5,6,18,24,0,2,3,8,11,25,2011_Byron Mullens
2011,Derrick Favors,PF,19,430,832,0.5168269230769231,0,0,NaN,430,832,0.5168269230769231,206,346,0.5953757225433526,342,482,824,78,58,136,154,492,1066,2011_Derrick Favors
2011,Gary Neal,SG,26,285,632,0.4509493670886076,129,308,0.41883116883116883,156,324,0.48148148148148145,84,104,0.8076923076923077,21,175,196,96,27,4,78,148,783,2011_Gary Neal
2011,Hamed Haddadi,C,25,30,58,0.5172413793103449,0,1,0.0,30,57,0.5263157894736842,15,23,0.6521739130434783,24,44,68,5,2,13,11,29,75,2011_Hamed Haddadi
2011,Hasheem Thabeet,C,23,34,80,0.425,0,0,NaN,34,80,0.425,38,70,0.5428571428571428,48,102,150,8,18,32,34,152,106,2011_Hasheem Thabeet
2011,Henry Walker,SG,23,104,236,0.4406779661016949,59,153,0.38562091503267976,45,83,0.5421686746987951,31,44,0.7045454545454546,16,106,122,34,21,6,37,81,298,2011_Henry Walker
2011,Kwame Brown,C,28,194,375,0.5173333333333333,0,0,NaN,194,375,0.5173333333333333,136,231,0.5887445887445888,147,303,450,43,26,39,69,174,524,2011_Kwame Brown
2011,Metta World,SF,31,261,658,0.3966565349544073,83,233,0.3562231759656652,178,425,0.4188235294117647,92,136,0.6764705882352942,100,167,267,175,124,36,90,181,697,2011_Metta World
2011,Pau Gasol,C,30,593,1120,0.5294642857142857,1,3,0.3333333333333333,592,1117,0.5299910474485229,354,430,0.8232558139534883,268,568,836,273,48,130,142,203,1541,2011_Pau Gasol
2011,Ronnie Price,SG,27,74,210,0.3523809523809524,20,69,0.2898550724637681,54,141,0.3829787234042553,29,39,0.7435897435897436,22,39,61,56,42,5,55,106,197,2011_Ronnie Price
2011,Serge Ibaka,PF,21,335,617,0.5429497568881686,0,1,0.0,335,616,0.5438311688311688,138,184,0.75,214,408,622,22,31,198,71,267,808,2011_Serge Ibaka
2012,Brook Lopez,C,23,38,77,0.4935064935064935,0,0,NaN,38,77,0.4935064935064935,20,32,0.625,8,10,18,6,1,4,6,8,96,2012_Brook Lopez
2012,Byron Mullens,C,22,251,591,0.42470389170896783,12,51,0.23529411764705882,239,540,0.4425925925925926,92,112,0.8214285714285714,96,231,327,57,21,52,74,137,606,2012_Byron Mullens
2012,Christian Eyenga,SF,22,12,50,0.24,2,6,0.3333333333333333,10,44,0.22727272727272727,8,16,0.5,8,20,28,10,6,10,6,14,34,2012_Christian Eyenga
2012,DeShawn Stevenson,SF,30,49,172,0.28488372093023256,41,145,0.2827586206896552,8,27,0.2962962962962963,9,16,0.5625,7,94,101,41,19,4,19,59,148,2012_DeShawn Stevenson
2012,Derrick Rose,PG,23,302,695,0.43453237410071943,54,173,0.31213872832369943,248,522,0.47509578544061304,194,239,0.8117154811715481,26,105,131,307,35,28,119,52,852,2012_Derrick Rose
2012,Dwyane Wade,SG,30,416,837,0.4970131421744325,15,56,0.26785714285714285,401,781,0.5134443021766966,235,297,0.7912457912457912,73,164,237,225,82,63,129,110,1082,2012_Dwyane Wade
2012,Edwin Ubiles,SF,25,5,18,0.2777777777777778,1,5,0.2,4,13,0.3076923076923077,3,3,1.0,2,8,10,1,1,1,1,1,14,2012_Edwin Ubiles
2012,Gary Neal,SG,27,212,486,0.43621399176954734,83,198,0.41919191919191917,129,288,0.4479166666666667,50,64,0.78125,12,106,118,117,27,2,60,75,557,2012_Gary Neal
2012,Hamed Haddadi,C,26,26,48,0.5416666666666666,0,1,0.0,26,47,0.5531914893617021,18,26,0.6923076923076923,28,43,71,8,1,26,21,43,70,2012_Hamed Haddadi
2012,Hasheem Thabeet,C,24,22,42,0.5238095238095238,0,0,NaN,22,42,0.5238095238095238,26,40,0.65,32,52,84,0,2,20,16,40,70,2012_Hasheem Thabeet
2012,Jason Kapono,SG,30,21,55,0.38181818181818183,8,27,0.2962962962962963,13,28,0.4642857142857143,4,4,1.0,2,12,14,11,3,0,6,21,54,2012_Jason Kapono
2012,Jason Kidd,PG,38,99,273,0.3626373626373626,79,223,0.3542600896860987,20,50,0.4,22,28,0.7857142857142857,15,183,198,264,82,10,91,83,299,2012_Jason Kidd
2012,Jimmy Butler,SG,22,32,79,0.4050632911392405,2,11,0.18181818181818182,30,68,0.4411764705882353,43,56,0.7678571428571429,23,33,56,14,11,5,14,20,109,2012_Jimmy Butler
2012,Joel Anthony,C,29,85,152,0.5592105263157895,0,0,NaN,85,152,0.5592105263157895,49,71,0.6901408450704225,100,150,250,9,36,84,45,126,219,2012_Joel Anthony
2012,Klay Thompson,SG,21,318,718,0.4428969359331476,111,268,0.4141791044776119,207,450,0.46,79,91,0.8681318681318682,24,137,161,133,49,20,103,155,826,2012_Klay Thompson
2012,Kwame Brown,C,29,21,40,0.525,0,0,NaN,21,40,0.525,15,34,0.4411764705882353,16,41,57,4,8,0,14,21,57,2012_Kwame Brown
2012,Malcolm Thomas,PF,23,0,3,0.0,0,0,NaN,0,3,0.0,1,2,0.5,1,2,3,1,1,1,0,0,1,2012_Malcolm Thomas
2012,Manny Harris,SG,22,60,150,0.4,12,36,0.3333333333333333,48,114,0.42105263157894735,41,59,0.6949152542372882,11,59,70,31,13,6,27,28,173,2012_Manny Harris
2012,Metta World,SF,32,183,465,0.3935483870967742,56,189,0.2962962962962963,127,276,0.4601449275362319,71,115,0.6173913043478261,71,147,218,140,69,27,69,137,493,2012_Metta World
2012,Pau Gasol,PF,31,459,917,0.5005452562704471,7,27,0.25925925925925924,452,890,0.5078651685393258,204,261,0.7816091954022989,183,495,678,237,37,88,142,127,1129,2012_Pau Gasol
2012,Serge Ibaka,PF,22,262,490,0.5346938775510204,1,3,0.3333333333333333,261,487,0.5359342915811088,78,118,0.6610169491525424,193,305,498,28,33,241,79,179,603,2012_Serge Ibaka
2012,Shelvin Mack,PG,21,88,220,0.4,12,42,0.2857142857142857,76,178,0.42696629213483145,42,59,0.711864406779661,12,80,92,131,28,2,48,50,230,2012_Shelvin Mack
2013,Brook Lopez,C,24,570,1094,0.5210237659963437,0,1,0.0,570,1093,0.5215004574565416,297,392,0.7576530612244898,208,304,512,70,33,154,131,152,1437,2013_Brook Lopez
2013,Byron Mullens,PF,23,217,563,0.38543516873889877,66,208,0.3173076923076923,151,355,0.4253521126760563,64,99,0.6464646464646465,71,266,337,81,34,32,74,110,564,2013_Byron Mullens
2013,Cartier Martin,SF,28,96,252,0.38095238095238093,58,146,0.3972602739726027,38,106,0.3584905660377358,20,28,0.7142857142857143,11,89,100,20,19,6,32,58,270,2013_Cartier Martin
2013,Cory Higgins,SG,23,6,19,0.3157894736842105,1,5,0.2,5,14,0.35714285714285715,1,2,0.5,1,2,3,5,3,0,0,5,14,2013_Cory Higgins
2013,Damien Wilkins,SG,33,145,316,0.4588607594936709,17,51,0.3333333333333333,128,265,0.4830188679245283,81,109,0.7431192660550459,32,73,105,91,37,18,49,98,388,2013_Damien Wilkins
2013,Dante Cunningham,PF,25,314,671,0.46795827123695977,0,6,0.0,314,665,0.47218045112781953,67,103,0.6504854368932039,142,266,408,67,84,38,56,153,695,2013_Dante Cunningham
2013,DeShawn Stevenson,SG,31,98,262,0.37404580152671757,76,209,0.36363636363636365,22,53,0.41509433962264153,12,23,0.5217391304347826,18,104,122,52,29,6,23,69,284,2013_DeShawn Stevenson
2013,Donatas Motiejunas,PF,22,97,213,0.45539906103286387,24,83,0.2891566265060241,73,130,0.5615384615384615,32,51,0.6274509803921569,36,57,93,31,7,10,37,73,250,2013_Donatas Motiejunas
2013,Dwyane Wade,SG,31,569,1093,0.5205855443732845,17,66,0.25757575757575757,552,1027,0.5374878286270691,308,425,0.7247058823529412,86,258,344,352,128,56,194,140,1463,2013_Dwyane Wade
2013,Gary Neal,SG,28,246,597,0.4120603015075377,89,251,0.3545816733067729,157,346,0.45375722543352603,64,74,0.8648648648648649,13,130,143,129,30,2,69,93,645,2013_Gary Neal
2013,Hamed Haddadi,C,27,70,164,0.4268292682926829,0,0,NaN,70,164,0.4268292682926829,28,54,0.5185185185185185,86,136,222,24,12,54,62,120,168,2013_Hamed Haddadi
2013,Hasheem Thabeet,C,25,64,106,0.6037735849056604,0,0,NaN,64,106,0.6037735849056604,32,53,0.6037735849056604,69,126,195,11,30,60,41,148,160,2013_Hasheem Thabeet
2013,Jeremy Pargo,PG-SG_SG_PG,26,198,500,0.396,50,148,0.33783783783783783,148,352,0.42045454545454547,84,124,0.6774193548387096,16,82,98,184,26,4,100,92,530,2013_Jeremy Pargo
2013,Klay Thompson,SG,22,508,1205,0.4215767634854772,211,526,0.4011406844106464,297,679,0.4374079528718704,132,157,0.8407643312101911,32,274,306,183,86,45,157,237,1359,2013_Klay Thompson
2013,Metta World,SF,33,332,824,0.4029126213592233,141,412,0.3422330097087379,191,412,0.46359223300970875,124,169,0.7337278106508875,101,271,372,112,122,42,98,198,929,2013_Metta World
2013,Pau Gasol,PF,32,270,579,0.46632124352331605,8,28,0.2857142857142857,262,551,0.47549909255898365,125,178,0.702247191011236,111,310,421,200,24,61,104,93,673,2013_Pau Gasol
2013,Serge Ibaka,PF,23,446,778,0.5732647814910026,20,57,0.3508771929824561,426,721,0.5908460471567267,143,191,0.7486910994764397,222,395,617,43,28,242,125,213,1055,2013_Serge Ibaka
2013,Shaun Livingston,PG,27,332,692,0.4797687861271676,0,8,0.0,332,684,0.4853801169590643,170,196,0.8673469387755102,62,254,316,430,96,62,152,254,834,2013_Shaun Livingston
2013,Tony Wroten,SG,19,33,86,0.38372093023255816,4,16,0.25,29,70,0.4142857142857143,21,29,0.7241379310344828,13,15,28,43,8,4,29,34,91,2013_Tony Wroten
2013,Wesley Johnson,SF,25,161,396,0.4065656565656566,50,155,0.3225806451612903,111,241,0.4605809128630705,27,35,0.7714285714285715,21,102,123,34,22,18,48,56,399,2013_Wesley Johnson
2014,Aaron Brooks,PG,29,466,1162,0.4010327022375215,192,496,0.3870967741935484,274,666,0.4114114114114114,166,190,0.8736842105263158,86,194,280,466,104,26,234,292,1290,2014_Aaron Brooks
2014,Adonis Thomas,SF,20,12,28,0.42857142857142855,2,10,0.2,10,18,0.5555555555555556,2,2,1.0,0,6,6,6,0,0,2,12,28,2014_Adonis Thomas
2014,Andrew Nicholson,PF,24,180,420,0.42857142857142855,28,89,0.3146067415730337,152,331,0.459214501510574,47,57,0.8245614035087719,53,202,255,25,18,23,51,150,435,2014_Andrew Nicholson
2014,Brook Lopez,C,25,129,229,0.5633187772925764,0,1,0.0,129,228,0.5657894736842105,94,115,0.8173913043478261,39,63,102,16,9,30,28,52,352,2014_Brook Lopez
2014,Byron Mullens,C,24,146,330,0.44242424242424244,66,178,0.3707865168539326,80,152,0.5263157894736842,20,40,0.5,48,136,184,28,30,22,54,128,378,2014_Byron Mullens
2014,Derrick Williams,SF-PF_SF_PF,22,412,964,0.42738589211618255,52,198,0.26262626262626265,360,766,0.4699738903394256,372,518,0.7181467181467182,142,504,646,112,96,40,152,228,1248,2014_Derrick Williams
2014,Draymond Green,SF,23,187,459,0.4074074074074074,55,165,0.3333333333333333,132,294,0.4489795918367347,82,123,0.6666666666666666,86,323,409,152,102,72,91,231,511,2014_Draymond Green
2014,Dwyane Wade,SG,32,415,761,0.545335085413929,9,32,0.28125,406,729,0.5569272976680384,189,258,0.7325581395348837,60,181,241,252,79,29,161,106,1028,2014_Dwyane Wade
2014,Ed Davis,PF,24,155,290,0.5344827586206896,0,0,NaN,155,290,0.5344827586206896,47,89,0.5280898876404494,92,168,260,27,17,43,40,114,357,2014_Ed Davis
2014,Gary Neal,SG,29,386,942,0.40976645435244163,136,360,0.37777777777777777,250,582,0.42955326460481097,188,210,0.8952380952380953,20,160,180,166,36,0,128,130,1096,2014_Gary Neal
2014,Gerald Wallace,SF,31,116,230,0.5043478260869565,19,64,0.296875,97,166,0.5843373493975904,47,101,0.46534653465346537,36,176,212,143,73,14,97,79,298,2014_Gerald Wallace
2014,Hasheem Thabeet,C,26,13,23,0.5652173913043478,0,0,NaN,13,23,0.5652173913043478,1,5,0.2,9,31,40,1,4,9,14,47,27,2014_Hasheem Thabeet
2014,Kirk Hinrich,PG,33,243,619,0.3925686591276252,85,242,0.3512396694214876,158,377,0.41909814323607425,95,125,0.76,31,161,192,286,80,26,120,203,666,2014_Kirk Hinrich
2014,Klay Thompson,SG,23,559,1259,0.44400317712470216,223,535,0.41682242990654206,336,724,0.46408839779005523,147,185,0.7945945945945946,38,211,249,181,74,37,135,234,1488,2014_Klay Thompson
2014,Mario Chalmers,PG,27,254,560,0.45357142857142857,87,226,0.38495575221238937,167,334,0.5,121,163,0.7423312883435583,41,173,214,357,119,16,162,210,716,2014_Mario Chalmers
2014,Metta World,SF,34,56,141,0.3971631205673759,17,54,0.3148148148148148,39,87,0.4482758620689655,10,16,0.625,18,41,59,17,24,8,19,44,139,2014_Metta World
2014,Pau Gasol,C,33,425,885,0.480225988700565,4,14,0.2857142857142857,421,871,0.4833524684270953,187,254,0.7362204724409449,124,456,580,201,27,92,141,124,1041,2014_Pau Gasol
2014,Serge Ibaka,PF,24,524,978,0.5357873210633947,23,60,0.38333333333333336,501,918,0.545751633986928,156,199,0.7839195979899497,224,485,709,85,39,219,123,233,1227,2014_Serge Ibaka
2015,Alonzo Gee,SF,27,174,372,0.46774193548387094,26,70,0.37142857142857144,148,302,0.4900662251655629,108,154,0.7012987012987013,74,114,188,50,70,14,66,116,482,2015_Alonzo Gee
2015,Andrew Wiggins,SF,19,497,1137,0.4371152154793316,39,126,0.30952380952380953,458,1011,0.4530168150346192,354,466,0.759656652360515,134,240,374,170,86,50,177,190,1387,2015_Andrew Wiggins
2015,Brook Lopez,C,26,506,987,0.5126646403242148,1,10,0.1,505,977,0.5168884339815762,223,274,0.8138686131386861,214,321,535,50,43,126,104,206,1236,2015_Brook Lopez
2015,Bruno Caboclo,SF,19,4,12,0.3333333333333333,2,3,0.6666666666666666,2,9,0.2222222222222222,0,0,NaN,1,1,2,0,0,1,4,3,10,2015_Bruno Caboclo
2015,Dante Exum,PG,19,145,416,0.3485576923076923,83,264,0.3143939393939394,62,152,0.40789473684210525,20,32,0.625,27,104,131,198,41,14,118,147,393,2015_Dante Exum
2015,Dewayne Dedmon,C,25,91,162,0.5617283950617284,0,1,0.0,91,161,0.5652173913043478,34,64,0.53125,118,177,295,9,16,50,51,141,216,2015_Dewayne Dedmon
2015,Dwyane Wade,SG,33,509,1084,0.46955719557195574,29,102,0.28431372549019607,480,982,0.48879837067209775,284,370,0.7675675675675676,58,161,219,299,73,21,209,105,1331,2015_Dwyane Wade
2015,Gerald Green,SG,29,324,778,0.41645244215938304,137,387,0.35400516795865633,187,391,0.4782608695652174,99,120,0.825,33,153,186,91,42,12,104,145,884,2015_Gerald Green
2015,Kevin Durant,SF,26,238,467,0.5096359743040685,64,159,0.4025157232704403,174,308,0.564935064935065,146,171,0.8538011695906432,16,162,178,110,24,25,74,40,686,2015_Kevin Durant
2015,Klay Thompson,SG,24,602,1299,0.4634334103156274,239,545,0.43853211009174314,363,754,0.48143236074270557,225,256,0.87890625,27,220,247,222,87,60,149,122,1668,2015_Klay Thompson
2015,Nikola Vucevic,C,24,631,1206,0.5232172470978441,2,6,0.3333333333333333,629,1200,0.5241666666666667,164,218,0.7522935779816514,238,572,810,147,54,54,148,220,1428,2015_Nikola Vucevic
2015,Pau Gasol,PF,34,570,1153,0.4943625325238508,12,26,0.46153846153846156,558,1127,0.4951197870452529,294,366,0.8032786885245902,220,699,919,210,25,147,158,147,1446,2015_Pau Gasol
2015,Ray McCallum,PG,23,206,470,0.43829787234042555,34,111,0.3063063063063063,172,359,0.479108635097493,57,84,0.6785714285714286,52,128,180,188,45,11,85,92,503,2015_Ray McCallum
2015,Serge Ibaka,PF,25,374,786,0.4758269720101781,77,205,0.375609756097561,297,581,0.5111876075731497,92,110,0.8363636363636363,135,364,499,55,30,155,97,194,917,2015_Serge Ibaka
2015,Tim Hardaway,SG,22,279,717,0.3891213389121339,121,354,0.3418079096045198,158,363,0.43526170798898073,125,156,0.8012820512820513,12,144,156,127,20,14,82,119,804,2015_Tim Hardaway
2015,Tyler Zeller,C,25,340,619,0.5492730210016155,0,0,NaN,340,619,0.5492730210016155,153,186,0.8225806451612904,146,319,465,113,18,52,76,205,833,2015_Tyler Zeller
2015,Zoran Dragic,SG,25,22,60,0.36666666666666664,6,28,0.21428571428571427,16,32,0.5,6,10,0.6,10,6,16,10,4,0,10,12,56,2015_Zoran Dragic
2016,Brandon Jennings,PG,26,224,608,0.3684210526315789,102,310,0.32903225806451614,122,298,0.40939597315436244,114,156,0.7307692307692307,32,160,192,340,58,14,114,114,664,2016_Brandon Jennings
2016,Brook Lopez,C,27,591,1157,0.5108038029386344,2,14,0.14285714285714285,589,1143,0.5153105861767279,317,403,0.7866004962779156,204,369,573,147,58,124,175,215,1501,2016_Brook Lopez
2016,Deron Williams,PG,31,321,775,0.41419354838709677,97,282,0.34397163120567376,224,493,0.4543610547667343,179,206,0.8689320388349514,19,171,190,378,61,14,150,155,918,2016_Deron Williams
2016,Dwyane Wade,SG,34,540,1183,0.45646661031276414,7,44,0.1590909090909091,533,1139,0.4679543459174715,322,406,0.7931034482758621,82,220,302,344,79,42,203,116,1409,2016_Dwyane Wade
2016,Hassan Whiteside,C,26,413,682,0.6055718475073314,0,0,NaN,413,682,0.6055718475073314,214,329,0.6504559270516718,238,627,865,30,44,269,137,201,1040,2016_Hassan Whiteside
2016,Joakim Noah,C,30,51,133,0.38345864661654133,0,1,0.0,51,132,0.38636363636363635,22,45,0.4888888888888889,87,168,255,110,18,29,52,77,124,2016_Joakim Noah
2016,Jordan McRae,PG,24,68,156,0.4358974358974359,20,44,0.45454545454545453,48,112,0.42857142857142855,42,56,0.75,8,32,40,50,6,2,30,34,198,2016_Jordan McRae
2016,Jusuf Nurkic,C,21,101,242,0.41735537190082644,0,3,0.0,101,239,0.4225941422594142,61,99,0.6161616161616161,65,110,175,40,24,44,55,91,263,2016_Jusuf Nurkic
2016,Klay Thompson,SG,25,651,1386,0.4696969696969697,276,650,0.4246153846153846,375,736,0.5095108695652174,193,221,0.8733031674208145,35,271,306,166,60,49,138,152,1771,2016_Klay Thompson
2016,Metta World,SF,36,55,177,0.3107344632768362,26,84,0.30952380952380953,29,93,0.3118279569892473,40,57,0.7017543859649122,19,70,89,27,22,11,15,67,176,2016_Metta World
2016,Pau Gasol,C,35,467,995,0.46934673366834173,24,69,0.34782608695652173,443,926,0.47840172786177104,229,289,0.7923875432525952,155,638,793,294,42,146,164,148,1187,2016_Pau Gasol
2016,Randy Foye,SG,32,338,964,0.3506224066390041,150,500,0.3,188,464,0.4051724137931034,122,148,0.8243243243243243,48,264,312,322,78,58,172,262,948,2016_Randy Foye
2016,Rondae Hollis-Jefferson,SF,21,63,138,0.45652173913043476,4,14,0.2857142857142857,59,124,0.47580645161290325,37,52,0.7115384615384616,39,115,154,43,39,16,26,61,167,2016_Rondae Hollis-Jefferson
2016,Serge Ibaka,PF,26,416,869,0.47871116225546606,60,184,0.32608695652173914,356,685,0.5197080291970803,91,121,0.7520661157024794,141,392,533,66,38,148,108,211,983,2016_Serge Ibaka
2017,Brook Lopez,C,28,555,1172,0.4735494880546075,134,387,0.3462532299741602,421,785,0.5363057324840764,295,364,0.8104395604395604,121,282,403,176,38,124,184,192,1539,2017_Brook Lopez
2017,Chandler Parsons,SF,28,75,222,0.33783783783783783,25,93,0.26881720430107525,50,129,0.3875968992248062,35,43,0.813953488372093,6,78,84,55,20,5,24,52,210,2017_Chandler Parsons
2017,Dwyane Wade,SG,35,414,955,0.43350785340314135,45,145,0.3103448275862069,369,810,0.45555555555555555,223,281,0.7935943060498221,64,207,271,229,86,41,138,112,1096,2017_Dwyane Wade
2017,Isaiah Whitehead,PG,21,204,508,0.4015748031496063,44,149,0.2953020134228188,160,359,0.4456824512534819,91,113,0.8053097345132744,32,152,184,192,42,36,142,175,543,2017_Isaiah Whitehead
2017,Joakim Noah,C,31,99,201,0.4925373134328358,0,1,0.0,99,200,0.495,34,78,0.4358974358974359,161,241,402,103,30,37,58,127,232,2017_Joakim Noah
2017,Klay Thompson,SG,26,644,1376,0.4680232558139535,268,647,0.4142194744976816,376,729,0.5157750342935528,186,218,0.8532110091743119,49,236,285,160,66,40,128,139,1742,2017_Klay Thompson
2017,Lance Thomas,PF,28,97,244,0.3975409836065574,38,85,0.4470588235294118,59,159,0.3710691823899371,43,51,0.8431372549019608,32,110,142,35,21,5,25,85,275,2017_Lance Thomas
2017,Metta World,SF,37,19,68,0.27941176470588236,9,38,0.23684210526315788,10,30,0.3333333333333333,10,16,0.625,5,15,20,11,9,2,7,18,57,2017_Metta World
2017,Pau Gasol,C,36,303,604,0.5016556291390728,56,104,0.5384615384615384,247,500,0.494,130,184,0.7065217391304348,107,394,501,150,24,70,81,110,792,2017_Pau Gasol
2017,Paul Zipser,SF,22,88,221,0.39819004524886875,33,99,0.3333333333333333,55,122,0.45081967213114754,31,40,0.775,15,110,125,36,15,16,40,78,240,2017_Paul Zipser
2017,Ramon Sessions,PG,30,100,263,0.38022813688212925,21,62,0.3387096774193548,79,201,0.39303482587064675,91,118,0.7711864406779662,11,62,73,129,26,3,46,43,312,2017_Ramon Sessions
2017,Rondae Hollis-Jefferson,SF,22,235,542,0.43357933579335795,15,67,0.22388059701492538,220,475,0.4631578947368421,190,253,0.7509881422924901,96,356,452,154,82,44,116,177,675,2017_Rondae Hollis-Jefferson
2017,Serge Ibaka,PF,27,942,1964,0.47963340122199594,248,634,0.3911671924290221,694,1330,0.5218045112781955,214,250,0.856,258,818,1076,150,82,248,210,430,2346,2017_Serge Ibaka
2003,Brandon Armstrong,SG,22,9,27,0.3333333333333333,1,6,0.16666666666666666,8,21,0.38095238095238093,5,6,0.8333333333333334,0,4,4,2,3,1,5,8,24,2003_Brandon Armstrong
2003,Calvin Booth,C,26,52,119,0.4369747899159664,0,2,0.0,52,117,0.4444444444444444,34,47,0.723404255319149,32,77,109,12,11,33,22,74,138,2003_Calvin Booth
2003,Chris Andersen,C,24,114,285,0.4,0,1,0.0,114,284,0.4014084507042254,77,140,0.55,109,165,274,32,30,60,60,90,305,2003_Chris Andersen
2003,Clarence Weatherspoon,PF,32,186,414,0.4492753623188406,0,0,NaN,186,414,0.4492753623188406,149,194,0.7680412371134021,214,385,599,68,69,36,63,174,521,2003_Clarence Weatherspoon
2003,Jamal Crawford,PG,22,334,808,0.41336633663366334,86,242,0.35537190082644626,248,566,0.4381625441696113,104,129,0.8062015503875969,21,164,185,334,77,25,134,126,858,2003_Jamal Crawford
2003,Jelani McCoy,C,25,194,395,0.4911392405063291,0,0,NaN,194,395,0.4911392405063291,69,126,0.5476190476190477,95,260,355,43,28,60,96,162,457,2003_Jelani McCoy
2003,Jerome Williams,PF,29,267,535,0.49906542056074765,1,6,0.16666666666666666,266,529,0.502835538752363,156,281,0.5551601423487544,231,419,650,95,116,26,98,197,691,2003_Jerome Williams
2003,Juaquin Hawkins,SG,29,57,148,0.38513513513513514,10,24,0.4166666666666667,47,124,0.3790322580645161,10,20,0.5,16,62,78,47,29,6,29,57,134,2003_Juaquin Hawkins
2003,Ken Johnson,C,24,15,37,0.40540540540540543,0,0,NaN,15,37,0.40540540540540543,2,6,0.3333333333333333,4,28,32,0,1,12,6,20,32,2003_Ken Johnson
2003,Kevin Willis,C,40,123,257,0.4785992217898833,0,2,0.0,123,255,0.4823529411764706,51,83,0.6144578313253012,83,143,226,24,20,20,60,120,297,2003_Kevin Willis
2003,Raja Bell,SG,26,93,211,0.44075829383886256,21,51,0.4117647058823529,72,160,0.45,23,34,0.6764705882352942,47,98,145,57,52,8,43,134,230,2003_Raja Bell
2003,Ryan Humphrey,PF,23,70,240,0.2916666666666667,0,0,NaN,70,240,0.2916666666666667,46,78,0.5897435897435898,68,130,198,22,18,36,46,150,186,2003_Ryan Humphrey
2004,Aaron Williams,C,32,172,342,0.5029239766081871,1,3,0.3333333333333333,171,339,0.504424778761062,105,155,0.6774193548387096,101,193,294,81,34,46,89,187,450,2004_Aaron Williams
2004,Ben Handlogten,C,30,25,47,0.5319148936170213,0,0,NaN,25,47,0.5319148936170213,18,27,0.6666666666666666,22,33,55,6,3,4,10,32,68,2004_Ben Handlogten
2004,Brandon Armstrong,SG,23,65,175,0.37142857142857144,19,52,0.36538461538461536,46,123,0.37398373983739835,2,4,0.5,12,31,43,14,12,2,24,49,151,2004_Brandon Armstrong
2004,Clarence Weatherspoon,PF,33,208,422,0.4928909952606635,0,2,0.0,208,420,0.49523809523809526,106,144,0.7361111111111112,148,260,408,60,60,30,70,150,522,2004_Clarence Weatherspoon
2004,Earl Boykins,SG,27,321,766,0.41906005221932113,55,171,0.3216374269005848,266,595,0.4470588235294118,142,162,0.8765432098765432,42,101,143,295,51,3,100,84,839,2004_Earl Boykins
2004,Fred Jones,SG,24,123,311,0.3954983922829582,27,89,0.30337078651685395,96,222,0.43243243243243246,124,149,0.8322147651006712,25,101,126,173,65,18,73,132,397,2004_Fred Jones
2004,Moochie Norris,PG,30,160,434,0.3686635944700461,40,116,0.3448275862068966,120,318,0.37735849056603776,108,142,0.7605633802816901,20,110,130,242,88,10,128,102,468,2004_Moochie Norris
2004,Raja Bell,SG,27,329,805,0.40869565217391307,62,166,0.37349397590361444,267,639,0.41784037558685444,195,248,0.7862903225806451,60,181,241,107,63,13,111,262,915,2004_Raja Bell
2004,Rod Strickland,PG,37,300,706,0.42492917847025496,20,72,0.2777777777777778,280,634,0.4416403785488959,144,196,0.7346938775510204,68,242,310,488,70,22,170,152,764,2004_Rod Strickland
2004,Ron Mercer,SG,27,90,211,0.4265402843601896,2,7,0.2857142857142857,88,204,0.43137254901960786,13,17,0.7647058823529411,10,39,49,22,14,5,26,37,195,2004_Ron Mercer
2004,Ryan Humphrey,PF,24,1,4,0.25,0,1,0.0,1,3,0.3333333333333333,0,0,NaN,2,1,3,1,1,0,2,3,2,2004_Ryan Humphrey
2005,Andre Iguodala,SG,21,269,546,0.4926739926739927,47,142,0.33098591549295775,222,404,0.5495049504950495,156,210,0.7428571428571429,89,375,464,246,138,48,139,204,741,2005_Andre Iguodala
2005,Clarence Weatherspoon,PF,34,47,114,0.41228070175438597,0,0,NaN,47,114,0.41228070175438597,29,35,0.8285714285714286,35,87,122,17,9,6,15,74,123,2005_Clarence Weatherspoon
2005,Cuttino Mobley,SG,29,816,1864,0.43776824034334766,300,684,0.43859649122807015,516,1180,0.43728813559322033,336,410,0.8195121951219512,90,368,458,376,148,60,266,304,2268,2005_Cuttino Mobley
2005,Donyell Marshall,PF,31,262,592,0.44256756756756754,151,363,0.41597796143250687,111,229,0.4847161572052402,72,91,0.7912087912087912,95,333,428,81,57,46,42,136,747,2005_Donyell Marshall
2005,Lawrence Funderburke,PF,34,3,6,0.5,0,0,NaN,3,6,0.5,3,5,0.6,1,2,3,0,0,0,0,2,9,2005_Lawrence Funderburke
2005,Rafael Araujo,C,24,76,175,0.4342857142857143,1,3,0.3333333333333333,75,172,0.436046511627907,43,55,0.7818181818181819,59,126,185,16,21,8,52,157,196,2005_Rafael Araujo
2005,Rafer Alston,PG,28,403,974,0.4137577002053388,139,389,0.35732647814910024,264,585,0.4512820512820513,191,258,0.7403100775193798,42,237,279,514,118,7,170,212,1136,2005_Rafer Alston
2005,Raja Bell,SG,28,303,667,0.4542728635682159,54,134,0.40298507462686567,249,533,0.46716697936210133,112,150,0.7466666666666667,48,153,201,91,44,8,79,205,772,2005_Raja Bell
2005,Richard Hamilton,SG,26,510,1160,0.4396551724137931,36,118,0.3050847457627119,474,1042,0.45489443378119004,368,429,0.8578088578088578,74,221,295,372,77,13,217,232,1424,2005_Richard Hamilton
2005,Ryan Humphrey,SF,25,42,103,0.4077669902912621,0,2,0.0,42,101,0.4158415841584158,18,37,0.4864864864864865,50,37,87,6,10,1,23,35,102,2005_Ryan Humphrey
2005,Speedy Claxton,PG,26,514,1222,0.4206219312602291,22,122,0.18032786885245902,492,1100,0.44727272727272727,374,508,0.7362204724409449,74,294,368,748,218,16,238,368,1424,2005_Speedy Claxton
2005,Theron Smith,SF,24,44,136,0.3235294117647059,3,12,0.25,41,124,0.33064516129032256,14,16,0.875,39,77,116,28,6,4,27,58,105,2005_Theron Smith
2006,Alvin Williams,PG,31,0,3,0.0,0,2,0.0,0,1,0.0,1,2,0.5,0,3,3,0,0,0,0,0,1,2006_Alvin Williams
2006,Caron Butler,SF,25,494,1086,0.4548802946593002,41,120,0.3416666666666667,453,966,0.468944099378882,289,332,0.8704819277108434,114,352,466,186,127,18,175,238,1318,2006_Caron Butler
2006,Laron Profit,SG,28,40,84,0.47619047619047616,3,18,0.16666666666666666,37,66,0.5606060606060606,21,24,0.875,8,35,43,15,11,5,24,25,104,2006_Laron Profit
2006,Luol Deng,SF,20,442,954,0.46331236897274636,21,78,0.2692307692307692,421,876,0.4805936073059361,207,276,0.75,127,389,516,147,72,50,105,128,1112,2006_Luol Deng
2006,Marcus Fizer,PF,27,9,17,0.5294117647058824,1,1,1.0,8,16,0.5,1,2,0.5,1,6,7,1,0,0,2,5,20,2006_Marcus Fizer
2006,Matt Carroll,SG,25,192,476,0.40336134453781514,72,185,0.3891891891891892,120,291,0.41237113402061853,138,168,0.8214285714285714,34,123,157,35,47,11,48,120,594,2006_Matt Carroll
2006,Maurice Taylor,PF,29,182,389,0.46786632390745503,0,1,0.0,182,388,0.4690721649484536,58,83,0.6987951807228916,65,164,229,53,21,14,103,177,422,2006_Maurice Taylor
2006,Milt Palacio,PG,27,171,403,0.42431761786600497,1,16,0.0625,170,387,0.4392764857881137,98,150,0.6533333333333333,17,117,134,190,47,14,110,125,441,2006_Milt Palacio
2006,Noel Felix,SF,24,6,25,0.24,1,3,0.3333333333333333,5,22,0.22727272727272727,5,8,0.625,3,10,13,2,2,3,8,13,18,2006_Noel Felix
2006,Rafael Araujo,C,25,53,145,0.36551724137931035,0,1,0.0,53,144,0.3680555555555556,15,28,0.5357142857142857,43,101,144,15,24,6,42,104,121,2006_Rafael Araujo
2006,Raja Bell,SG,29,425,930,0.45698924731182794,197,446,0.44170403587443946,228,484,0.47107438016528924,115,146,0.7876712328767124,44,209,253,207,76,22,89,248,1162,2006_Raja Bell
2006,Randy Holcomb,SF,26,1,1,1.0,0,0,NaN,1,1,1.0,0,0,NaN,1,0,1,0,0,0,0,2,2,2006_Randy Holcomb
2006,Ronnie Price,PG,22,21,58,0.3620689655172414,6,27,0.2222222222222222,15,31,0.4838709677419355,12,12,1.0,5,10,15,11,6,0,10,10,60,2006_Ronnie Price
2006,Shawn Marion,PF,27,716,1365,0.5245421245421246,96,290,0.3310344827586207,620,1075,0.5767441860465117,241,298,0.8087248322147651,249,710,959,143,160,137,125,223,1769,2006_Shawn Marion
2006,Stromile Swift,C,26,225,458,0.4912663755458515,0,2,0.0,225,456,0.4934210526315789,136,209,0.6507177033492823,103,188,291,25,38,50,91,198,586,2006_Stromile Swift
2007,Daniel Gibson,PG,20,98,231,0.42424242424242425,52,124,0.41935483870967744,46,107,0.42990654205607476,28,39,0.717948717948718,28,64,92,69,23,8,44,94,276,2007_Daniel Gibson
2007,Jared Jeffries,SF,25,95,206,0.46116504854368934,2,20,0.1,93,186,0.5,31,68,0.45588235294117646,111,127,238,67,44,30,61,150,223,2007_Jared Jeffries
2007,Jason Kidd,PG,33,369,908,0.4063876651982379,124,361,0.34349030470914127,245,547,0.44789762340036565,179,230,0.7782608695652173,135,520,655,736,127,23,213,146,1041,2007_Jason Kidd
2007,Luol Deng,SF,21,630,1218,0.5172413793103449,1,7,0.14285714285714285,629,1211,0.5194054500412882,279,359,0.7771587743732591,148,431,579,204,97,48,153,167,1540,2007_Luol Deng
2007,Mardy Collins,SF,22,87,228,0.3815789473684211,13,47,0.2765957446808511,74,181,0.4088397790055249,48,82,0.5853658536585366,28,76,104,83,32,3,57,75,235,2007_Mardy Collins
2007,Marvin Williams,PF,20,306,706,0.43342776203966005,11,45,0.24444444444444444,295,661,0.4462934947049924,216,265,0.8150943396226416,84,253,337,121,52,30,127,191,839,2007_Marvin Williams
2007,P.J. Tucker,SF,21,11,22,0.5,0,0,NaN,11,22,0.5,8,14,0.5714285714285714,11,12,23,3,2,0,6,12,30,2007_P.J. Tucker
2007,Rafael Araujo,C,26,27,65,0.4153846153846154,0,0,NaN,27,65,0.4153846153846154,18,29,0.6206896551724138,22,44,66,10,6,2,17,39,72,2007_Rafael Araujo
2008,Chris Mihm,C,28,32,95,0.3368421052631579,0,0,NaN,32,95,0.3368421052631579,18,27,0.6666666666666666,28,49,77,13,4,14,17,42,82,2008_Chris Mihm
2008,Daniel Gibson,PG,21,201,465,0.432258064516129,118,268,0.44029850746268656,83,197,0.4213197969543147,85,105,0.8095238095238095,30,104,134,145,47,14,76,163,605,2008_Daniel Gibson
2008,Darrick Martin,PG,36,10,43,0.23255813953488372,2,16,0.125,8,27,0.2962962962962963,5,6,0.8333333333333334,3,4,7,21,6,0,1,12,27,2008_Darrick Martin
2008,Keith Bogans,SG,27,241,588,0.4098639455782313,148,409,0.36185819070904646,93,179,0.5195530726256983,81,110,0.7363636363636363,42,224,266,104,59,10,53,164,711,2008_Keith Bogans
2008,Keith Langford,SG,24,1,4,0.25,0,0,NaN,1,4,0.25,0,0,NaN,0,2,2,0,0,0,0,1,2,2008_Keith Langford
2008,Kelenna Azubuike,SG,24,261,587,0.444633730834753,71,195,0.3641025641025641,190,392,0.4846938775510204,99,138,0.717391304347826,107,217,324,75,45,34,58,159,692,2008_Kelenna Azubuike
2008,Lamar Odom,PF,28,417,795,0.5245283018867924,31,113,0.2743362831858407,386,682,0.5659824046920822,229,328,0.698170731707317,197,622,819,273,75,72,156,222,1094,2008_Lamar Odom
2008,Linton Johnson,PF,27,18,38,0.47368421052631576,2,6,0.3333333333333333,16,32,0.5,4,4,1.0,10,18,28,8,0,2,10,22,42,2008_Linton Johnson
2008,Luol Deng,SF,22,429,896,0.47879464285714285,8,22,0.36363636363636365,421,874,0.4816933638443936,204,265,0.769811320754717,136,258,394,155,57,29,120,117,1070,2008_Luol Deng
2008,Mardy Collins,SG,23,57,175,0.32571428571428573,8,32,0.25,49,143,0.34265734265734266,23,38,0.6052631578947368,19,56,75,89,24,8,56,56,145,2008_Mardy Collins
2008,Marvin Williams,SF,21,424,918,0.46187363834422657,1,10,0.1,423,908,0.4658590308370044,336,409,0.8215158924205379,119,338,457,137,81,33,127,225,1185,2008_Marvin Williams
2008,Ryan Gomes,PF,25,392,857,0.4574095682613769,59,179,0.329608938547486,333,678,0.4911504424778761,190,229,0.8296943231441049,133,342,475,145,65,10,96,154,1033,2008_Ryan Gomes
2009,Aaron Brooks,PG,24,316,783,0.40357598978288634,113,309,0.3656957928802589,203,474,0.4282700421940928,149,172,0.8662790697674418,33,124,157,238,46,8,125,152,894,2009_Aaron Brooks
2009,Andres Nocioni,SF_PF_PF-SF,29,598,1402,0.42653352353780316,248,622,0.3987138263665595,350,780,0.44871794871794873,290,366,0.7923497267759563,108,614,722,204,78,66,226,522,1734,2009_Andres Nocioni
2009,Daniel Gibson,PG,22,206,527,0.3908918406072106,108,283,0.38162544169611307,98,244,0.4016393442622951,66,86,0.7674418604651163,31,124,155,132,44,16,61,163,586,2009_Daniel Gibson
2009,Devin Brown,SG,30,111,313,0.3546325878594249,28,97,0.28865979381443296,83,216,0.38425925925925924,78,100,0.78,31,88,119,54,32,5,54,81,328,2009_Devin Brown
2009,Jamaal Magloire,C,30,65,131,0.4961832061068702,0,0,NaN,65,131,0.4961832061068702,29,60,0.48333333333333334,82,140,222,22,11,25,32,121,159,2009_Jamaal Magloire
2009,Luol Deng,SF,23,265,591,0.44839255499153974,8,20,0.4,257,571,0.4500875656742557,152,191,0.7958115183246073,80,215,295,94,60,25,72,85,690,2009_Luol Deng
2009,Mardy Collins,PG-SG_SG_PG,24,210,494,0.4251012145748988,26,62,0.41935483870967744,184,432,0.42592592592592593,56,92,0.6086956521739131,62,152,214,222,62,20,116,160,502,2009_Mardy Collins
2009,Mario Chalmers,PG,22,278,662,0.4199395770392749,114,311,0.3665594855305466,164,351,0.4672364672364672,148,193,0.7668393782383419,37,191,228,403,160,8,165,240,818,2009_Mario Chalmers
2009,Marvin Williams,SF,22,285,622,0.45819935691318325,55,155,0.3548387096774194,230,467,0.4925053533190578,220,273,0.8058608058608059,110,272,382,81,57,39,70,127,845,2009_Marvin Williams
2009,Michael Redd,SG,29,249,547,0.45521023765996343,70,191,0.36649214659685864,179,356,0.5028089887640449,131,161,0.8136645962732919,24,83,107,88,35,2,53,45,699,2009_Michael Redd
2009,Nenad Krstic,C,25,191,407,0.4692874692874693,0,0,NaN,191,407,0.4692874692874693,63,79,0.7974683544303798,85,168,253,29,21,49,45,114,445,2009_Nenad Krstic
2009,Sean Marks,C,33,80,165,0.48484848484848486,2,10,0.2,78,155,0.5032258064516129,30,44,0.6818181818181818,62,125,187,14,7,33,35,121,192,2009_Sean Marks
2009,Tarence Kinsey,SG,24,31,69,0.4492753623188406,7,18,0.3888888888888889,24,51,0.47058823529411764,33,38,0.868421052631579,10,28,38,10,12,0,22,34,102,2009_Tarence Kinsey
2010,Brian Cardinal,PF,32,14,36,0.3888888888888889,3,9,0.3333333333333333,11,27,0.4074074074074074,17,18,0.9444444444444444,7,22,29,24,9,3,7,56,48,2010_Brian Cardinal
2010,Brian Cook,PF,29,7,23,0.30434782608695654,2,9,0.2222222222222222,5,14,0.35714285714285715,5,7,0.7142857142857143,1,8,9,1,0,2,6,5,21,2010_Brian Cook
2010,Darnell Jackson,PF,24,18,60,0.3,2,8,0.25,16,52,0.3076923076923077,8,12,0.6666666666666666,18,26,44,8,4,8,26,42,46,2010_Darnell Jackson
2010,Darrell Arthur,PF,21,63,146,0.4315068493150685,0,1,0.0,63,145,0.43448275862068964,17,30,0.5666666666666667,37,73,110,15,14,14,22,60,143,2010_Darrell Arthur
2010,DeJuan Blair,PF,20,275,495,0.5555555555555556,0,2,0.0,275,493,0.5578093306288032,88,161,0.546583850931677,200,326,526,65,50,39,112,224,638,2010_DeJuan Blair
2010,Jason Smith,PF,23,75,174,0.43103448275862066,10,29,0.3448275862068966,65,145,0.4482758620689655,29,42,0.6904761904761905,54,81,135,33,21,28,35,110,189,2010_Jason Smith
2010,Jordan Hill,PF,22,198,402,0.4925373134328358,0,4,0.0,198,398,0.49748743718592964,92,136,0.6764705882352942,152,198,350,40,28,42,60,184,488,2010_Jordan Hill
2010,Josh Smith,PF,24,504,999,0.5045045045045045,0,7,0.0,504,992,0.5080645161290323,261,422,0.6184834123222749,223,482,705,342,130,172,198,240,1269,2010_Josh Smith
2010,Mike Wilks,PG,30,6,12,0.5,2,3,0.6666666666666666,4,9,0.4444444444444444,2,4,0.5,1,3,4,4,0,0,4,5,16,2010_Mike Wilks
2010,Nathan Jawai,C,23,49,111,0.44144144144144143,0,1,0.0,49,110,0.44545454545454544,26,38,0.6842105263157895,49,55,104,24,10,9,27,58,124,2010_Nathan Jawai
2010,Raja Bell,SG,33,56,122,0.45901639344262296,24,54,0.4444444444444444,32,68,0.47058823529411764,6,6,1.0,10,36,46,26,8,4,10,30,142,2010_Raja Bell
2010,Rasho Nesterovic,C,33,81,149,0.5436241610738255,0,0,NaN,81,149,0.5436241610738255,1,5,0.2,37,52,89,25,10,17,16,54,163,2010_Rasho Nesterovic
2010,Shelden Williams,PF,26,63,121,0.5206611570247934,0,1,0.0,63,120,0.525,75,98,0.7653061224489796,47,99,146,21,13,21,30,85,201,2010_Shelden Williams
2010,Steve Blake,PG,29,434,1044,0.4157088122605364,232,588,0.3945578231292517,202,456,0.44298245614035087,72,96,0.75,42,332,374,760,116,12,256,246,1172,2010_Steve Blake
2010,Tim Duncan,C,33,561,1082,0.5184842883548983,2,11,0.18181818181818182,559,1071,0.5219421101774043,271,374,0.7245989304812834,221,567,788,246,45,117,140,152,1395,2010_Tim Duncan
2011,Acie Law,PG,26,162,372,0.43548387096774194,12,72,0.16666666666666666,150,300,0.5,94,128,0.734375,24,102,126,168,64,0,86,122,430,2011_Acie Law
2011,Al-Farouq Aminu,SF,20,160,406,0.39408866995073893,45,143,0.3146853146853147,115,263,0.4372623574144487,92,119,0.773109243697479,75,192,267,60,59,25,103,121,457,2011_Al-Farouq Aminu
2011,Andrei Kirilenko,SF,29,253,542,0.466789667896679,36,98,0.3673469387755102,217,444,0.48873873873873874,208,270,0.7703703703703704,100,227,327,192,81,74,117,113,750,2011_Andrei Kirilenko
2011,Anthony Parker,SF,35,220,552,0.39855072463768115,86,227,0.3788546255506608,134,325,0.4123076923076923,74,95,0.7789473684210526,33,185,218,218,67,10,80,109,600,2011_Anthony Parker
2011,Corey Maggette,SF,31,253,559,0.4525939177101968,28,78,0.358974358974359,225,481,0.4677754677754678,271,325,0.8338461538461538,44,197,241,84,21,5,127,175,805,2011_Corey Maggette
2011,Darnell Jackson,PF,25,77,158,0.4873417721518987,3,11,0.2727272727272727,74,147,0.5034013605442177,30,49,0.6122448979591837,49,45,94,14,12,3,23,61,187,2011_Darnell Jackson
2011,Deron Williams,PG,26,856,1950,0.438974358974359,210,634,0.3312302839116719,646,1316,0.4908814589665654,696,824,0.8446601941747572,80,440,520,1334,158,30,460,380,2618,2011_Deron Williams
2011,Francisco Garcia,SF,29,207,475,0.4357894736842105,81,224,0.36160714285714285,126,251,0.50199203187251,65,76,0.8552631578947368,24,109,133,71,51,49,45,126,560,2011_Francisco Garcia
2011,Jason Smith,C,24,136,307,0.44299674267100975,0,2,0.0,136,305,0.4459016393442623,59,70,0.8428571428571429,89,152,241,36,26,32,53,150,331,2011_Jason Smith
2011,Jeff Green,SF_PF_PF-SF,24,736,1640,0.44878048780487806,128,422,0.3033175355450237,608,1218,0.49917898193760263,396,488,0.8114754098360656,146,574,720,216,106,74,198,420,1996,2011_Jeff Green
2011,Jordan Crawford,SG,22,384,1000,0.384,66,256,0.2578125,318,744,0.4274193548387097,146,168,0.8690476190476191,62,148,210,234,78,6,166,126,980,2011_Jordan Crawford
2011,Jordan Hill,C,23,173,352,0.4914772727272727,0,2,0.0,173,350,0.4942857142857143,60,85,0.7058823529411765,128,178,306,29,14,52,62,157,406,2011_Jordan Hill
2011,Lou Williams,SG,24,323,795,0.40628930817610065,88,253,0.34782608695652173,235,542,0.43357933579335795,293,356,0.8230337078651685,32,117,149,252,47,17,102,128,1027,2011_Lou Williams
2011,Othyus Jeffers,SG,25,62,130,0.47692307692307695,2,8,0.25,60,122,0.4918032786885246,60,92,0.6521739130434783,50,84,134,40,34,0,28,64,186,2011_Othyus Jeffers
2011,Raja Bell,SG,34,191,467,0.4089935760171306,68,193,0.35233160621761656,123,274,0.4489051094890511,91,102,0.8921568627450981,31,145,176,118,56,14,63,169,541,2011_Raja Bell
2011,Randy Foye,SG,27,206,531,0.3879472693032015,71,217,0.3271889400921659,135,314,0.4299363057324841,133,149,0.8926174496644296,13,90,103,170,47,21,95,122,616,2011_Randy Foye
2011,Theo Ratliff,C,37,1,6,0.16666666666666666,0,0,NaN,1,6,0.16666666666666666,0,2,0.0,6,7,13,3,2,5,3,7,2,2011_Theo Ratliff
2012,Al-Farouq Aminu,SF,21,150,365,0.410958904109589,13,47,0.2765957446808511,137,318,0.4308176100628931,86,114,0.7543859649122807,95,213,308,66,59,34,91,136,399,2012_Al-Farouq Aminu
2012,Andre Miller,SG,35,242,552,0.4384057971014493,18,83,0.21686746987951808,224,469,0.47761194029850745,137,169,0.8106508875739645,53,168,221,441,63,9,177,133,639,2012_Andre Miller
2012,Courtney Fortson,PG,23,22,64,0.34375,6,26,0.23076923076923078,16,38,0.42105263157894735,20,30,0.6666666666666666,12,18,30,20,6,0,20,10,70,2012_Courtney Fortson
2012,Darius Morris,PG,21,18,42,0.42857142857142855,4,9,0.4444444444444444,14,33,0.42424242424242425,6,9,0.6666666666666666,2,14,16,21,2,0,19,16,46,2012_Darius Morris
2012,David West,PF,31,349,716,0.48743016759776536,2,9,0.2222222222222222,347,707,0.4908062234794908,142,176,0.8068181818181818,118,315,433,140,52,46,93,160,842,2012_David West
2012,Ersan Ilyasova,PF,24,294,597,0.49246231155778897,51,112,0.45535714285714285,243,485,0.5010309278350515,143,183,0.7814207650273224,196,333,529,71,42,44,76,133,782,2012_Ersan Ilyasova
2012,Jason Smith,PF,25,181,348,0.5201149425287356,1,9,0.1111111111111111,180,339,0.5309734513274337,33,47,0.7021276595744681,72,124,196,34,21,41,40,102,396,2012_Jason Smith
2012,Jordan Crawford,SG,23,349,872,0.40022935779816515,79,273,0.2893772893772894,270,599,0.4507512520868113,161,203,0.7931034482758621,44,124,168,190,59,5,141,111,938,2012_Jordan Crawford
2012,Jordan Hill,C,24,164,330,0.49696969696969695,0,6,0.0,164,324,0.5061728395061729,60,94,0.6382978723404256,122,250,372,32,28,54,62,142,388,2012_Jordan Hill
2012,Kevin Seraphin,C,22,203,382,0.5314136125654451,0,1,0.0,203,381,0.5328083989501312,47,70,0.6714285714285714,103,177,280,33,19,76,66,133,453,2012_Kevin Seraphin
2012,Kosta Koufos,C,22,115,192,0.5989583333333334,0,0,NaN,115,192,0.5989583333333334,33,55,0.6,95,163,258,15,24,41,33,96,263,2012_Kosta Koufos
2012,Mychel Thompson,SG,23,7,24,0.2916666666666667,4,11,0.36363636363636365,3,13,0.23076923076923078,0,0,NaN,0,5,5,7,2,1,5,8,18,2012_Mychel Thompson
2012,Raja Bell,SG,35,81,174,0.46551724137931033,34,87,0.39080459770114945,47,87,0.5402298850574713,21,25,0.84,6,43,49,38,13,2,21,78,217,2012_Raja Bell
2012,Ramon Sessions,PG,25,484,1130,0.4283185840707965,86,194,0.44329896907216493,398,936,0.4252136752136752,388,496,0.782258064516129,66,362,428,708,88,6,282,200,1442,2012_Ramon Sessions
2012,Royal Ivey,SG,30,26,73,0.3561643835616438,18,53,0.33962264150943394,8,20,0.4,1,8,0.125,1,23,24,10,14,0,9,36,71,2012_Royal Ivey
2012,Tristan Thompson,PF,20,194,442,0.43891402714932126,0,2,0.0,194,440,0.4409090909090909,106,192,0.5520833333333334,187,202,389,27,27,62,81,134,494,2012_Tristan Thompson
2012,Tyler Hansbrough,PF,26,194,479,0.40501043841336115,0,1,0.0,194,478,0.40585774058577406,226,278,0.8129496402877698,113,177,290,30,54,9,65,159,614,2012_Tyler Hansbrough
2013,Al-Farouq Aminu,SF,22,225,474,0.47468354430379744,4,19,0.21052631578947367,221,455,0.4857142857142857,101,137,0.7372262773722628,139,446,585,103,92,51,116,153,555,2013_Al-Farouq Aminu
2013,Chris Wilcox,C,30,110,153,0.7189542483660131,0,1,0.0,110,152,0.7236842105263158,39,58,0.6724137931034483,55,125,180,22,32,28,34,125,259,2013_Chris Wilcox
2013,Courtney Lee,SG,27,246,530,0.4641509433962264,58,156,0.3717948717948718,188,374,0.5026737967914439,62,72,0.8611111111111112,31,159,190,143,89,21,84,139,612,2013_Courtney Lee
2013,Darius Morris,PG,22,73,188,0.3882978723404255,24,66,0.36363636363636365,49,122,0.4016393442622951,24,37,0.6486486486486487,24,33,57,76,21,2,45,58,194,2013_Darius Morris
2013,Eddy Curry,C,30,4,8,0.5,0,0,NaN,4,8,0.5,1,4,0.25,2,2,4,0,0,0,3,7,9,2013_Eddy Curry
2013,Garrett Temple,SG,26,105,258,0.4069767441860465,26,80,0.325,79,178,0.4438202247191011,26,37,0.7027027027027027,29,94,123,115,50,17,61,94,262,2013_Garrett Temple
2013,J.R. Smith,SG,27,527,1249,0.42193755004003203,155,436,0.3555045871559633,372,813,0.4575645756457565,237,311,0.7620578778135049,64,361,425,218,100,24,134,226,1446,2013_J.R. Smith
2013,Jason Smith,C,26,167,341,0.4897360703812317,0,4,0.0,167,337,0.49554896142433236,86,102,0.8431372549019608,64,122,186,34,15,45,55,123,420,2013_Jason Smith
2013,Jordan Crawford,SG,24,602,1450,0.41517241379310343,166,492,0.33739837398373984,436,958,0.4551148225469729,258,318,0.8113207547169812,88,330,418,450,78,14,282,212,1628,2013_Jordan Crawford
2013,Jordan Hill,PF,25,77,155,0.4967741935483871,0,2,0.0,77,153,0.5032679738562091,40,61,0.6557377049180327,82,84,166,13,8,19,26,55,194,2013_Jordan Hill
2013,Kendall Marshall,PG,21,56,151,0.3708609271523179,23,73,0.3150684931506849,33,78,0.4230769230769231,8,14,0.5714285714285714,4,38,42,143,22,4,57,48,143,2013_Kendall Marshall
2013,Kyle Lowry,PG,26,250,623,0.4012841091492777,101,279,0.36200716845878134,149,344,0.4331395348837209,190,239,0.7949790794979079,56,265,321,435,94,24,157,218,791,2013_Kyle Lowry
2013,Luc Mbah,SF,26,151,377,0.4005305039787798,13,37,0.35135135135135137,138,340,0.40588235294117647,72,126,0.5714285714285714,89,167,256,55,42,14,70,82,387,2013_Luc Mbah
2013,Raymond Felton,PG,28,377,882,0.427437641723356,93,258,0.36046511627906974,284,624,0.4551282051282051,101,128,0.7890625,51,143,194,372,94,14,155,130,948,2013_Raymond Felton
2014,Al-Farouq Aminu,SF,23,234,494,0.47368421052631576,13,48,0.2708333333333333,221,446,0.49551569506726456,91,137,0.6642335766423357,129,367,496,114,82,38,88,147,572,2014_Al-Farouq Aminu
2014,Andrew Bogut,C,29,235,375,0.6266666666666667,0,0,NaN,235,375,0.6266666666666667,22,64,0.34375,182,489,671,112,47,121,97,210,492,2014_Andrew Bogut
2014,Anthony Randolph,PF,24,68,176,0.38636363636363635,18,61,0.29508196721311475,50,115,0.43478260869565216,52,69,0.7536231884057971,20,102,122,32,26,19,39,64,206,2014_Anthony Randolph
2014,Chris Andersen,C,35,177,275,0.6436363636363637,3,12,0.25,174,263,0.6615969581749049,120,169,0.7100591715976331,129,250,379,19,32,97,53,162,477,2014_Chris Andersen
2014,Darius Morris,PG,23,78,192,0.40625,24,76,0.3157894736842105,54,116,0.46551724137931033,34,52,0.6538461538461539,14,38,52,88,26,0,54,66,214,2014_Darius Morris
2014,Jamal Crawford,SG,33,421,1011,0.41641938674579626,161,446,0.3609865470852018,260,565,0.46017699115044247,279,322,0.8664596273291926,34,124,158,223,59,12,135,120,1282,2014_Jamal Crawford
2014,Jason Smith,PF,27,131,282,0.4645390070921986,0,0,NaN,131,282,0.4645390070921986,39,50,0.78,51,130,181,29,11,29,28,100,301,2014_Jason Smith
2014,Jeff Ayres,PF,26,101,174,0.5804597701149425,0,0,NaN,101,174,0.5804597701149425,38,55,0.6909090909090909,89,169,258,60,13,25,63,146,240,2014_Jeff Ayres
2014,Jordan Crawford,SG,25,654,1576,0.4149746192893401,180,570,0.3157894736842105,474,1006,0.4711729622266402,292,338,0.863905325443787,56,310,366,562,94,10,268,240,1780,2014_Jordan Crawford
2014,Jordan Hill,PF,26,286,521,0.5489443378119002,0,1,0.0,286,520,0.55,124,181,0.6850828729281768,194,341,535,54,29,64,75,172,696,2014_Jordan Hill
2014,Ognjen Kuzmic,C,23,5,13,0.38461538461538464,0,0,NaN,5,13,0.38461538461538464,5,11,0.45454545454545453,10,11,21,2,3,4,10,17,15,2014_Ognjen Kuzmic
2014,Robbie Hummel,SF,24,67,177,0.3785310734463277,32,89,0.3595505617977528,35,88,0.3977272727272727,15,16,0.9375,35,97,132,23,16,2,10,57,181,2014_Robbie Hummel
2015,Aaron Gordon,PF,19,93,208,0.44711538461538464,13,48,0.2708333333333333,80,160,0.5,44,61,0.7213114754098361,46,123,169,33,21,22,38,83,243,2015_Aaron Gordon
2015,Al-Farouq Aminu,SF,24,147,357,0.4117647058823529,34,124,0.27419354838709675,113,233,0.48497854077253216,84,118,0.711864406779661,114,228,342,59,70,62,55,137,412,2015_Al-Farouq Aminu
2015,Alex Kirk,C,23,1,4,0.25,0,0,NaN,1,4,0.25,2,2,1.0,1,0,1,1,0,0,0,1,4,2015_Alex Kirk
2015,Bryce Cotton,PG,22,29,69,0.42028985507246375,7,20,0.35,22,49,0.4489795918367347,15,18,0.8333333333333334,3,15,18,15,4,0,12,6,80,2015_Bryce Cotton
2015,Darius Morris,PG,24,36,106,0.33962264150943394,7,33,0.21212121212121213,29,73,0.3972602739726027,4,9,0.4444444444444444,7,20,27,48,9,0,21,20,83,2015_Darius Morris
2015,Eric Moreland,PF,23,1,1,1.0,0,0,NaN,1,1,1.0,0,0,NaN,0,1,1,0,0,0,0,1,2,2015_Eric Moreland
2015,Jason Smith,C,28,257,592,0.4341216216216216,15,42,0.35714285714285715,242,550,0.44,127,153,0.8300653594771242,98,226,324,140,32,44,104,205,656,2015_Jason Smith
2015,John Jenkins,SG,23,49,99,0.494949494949495,21,52,0.40384615384615385,28,47,0.5957446808510638,16,19,0.8421052631578947,2,37,39,13,10,0,8,15,135,2015_John Jenkins
2015,Jordan Hill,C,27,357,777,0.4594594594594595,3,11,0.2727272727272727,354,766,0.4621409921671018,124,168,0.7380952380952381,174,382,556,103,34,52,106,164,841,2015_Jordan Hill
2015,Meyers Leonard,C,22,125,245,0.5102040816326531,47,112,0.41964285714285715,78,133,0.5864661654135338,30,32,0.9375,46,204,250,32,10,14,39,113,327,2015_Meyers Leonard
2015,Ognjen Kuzmic,C,24,8,12,0.6666666666666666,0,0,NaN,8,12,0.6666666666666666,4,4,1.0,7,10,17,6,2,1,5,13,20,2015_Ognjen Kuzmic
2015,Reggie Jackson,PG,24,864,1992,0.43373493975903615,144,482,0.2987551867219917,720,1510,0.4768211920529801,362,436,0.8302752293577982,112,542,654,924,124,18,372,334,2234,2015_Reggie Jackson
2015,Robbie Hummel,SF,25,79,172,0.45930232558139533,16,51,0.3137254901960784,63,121,0.5206611570247934,24,29,0.8275862068965517,31,103,134,27,16,9,18,86,198,2015_Robbie Hummel
2015,Steven Adams,C,21,217,399,0.543859649122807,0,2,0.0,217,397,0.5465994962216625,103,205,0.5024390243902439,199,324,523,66,38,86,99,222,537,2015_Steven Adams
2015,Xavier Henry,SF,23,3,13,0.23076923076923078,0,0,NaN,3,13,0.23076923076923078,14,24,0.5833333333333334,2,2,4,3,3,0,3,6,20,2015_Xavier Henry
2016,Al-Farouq Aminu,SF,25,299,719,0.41585535465924894,126,349,0.36103151862464183,173,370,0.46756756756756757,115,156,0.7371794871794872,98,401,499,138,72,53,120,171,839,2016_Al-Farouq Aminu
2016,Alan Williams,PF,23,10,24,0.4166666666666667,0,0,NaN,10,24,0.4166666666666667,9,14,0.6428571428571429,14,24,38,5,4,5,6,15,29,2016_Alan Williams
2016,Alex Stepheson,PF,28,18,54,0.3333333333333333,0,0,NaN,18,54,0.3333333333333333,8,24,0.3333333333333333,38,18,56,4,2,10,0,24,44,2016_Alex Stepheson
2016,Andre Iguodala,SF,32,176,368,0.4782608695652174,54,154,0.35064935064935066,122,214,0.5700934579439252,51,83,0.6144578313253012,52,211,263,219,73,19,79,102,457,2016_Andre Iguodala
2016,Andrew Goudelock,PG,27,9,20,0.45,1,9,0.1111111111111111,8,11,0.7272727272727273,3,4,0.75,1,1,2,4,6,2,7,4,22,2016_Andrew Goudelock
2016,Bobby Portis,PF,20,186,436,0.42660550458715596,16,52,0.3076923076923077,170,384,0.4427083333333333,48,66,0.7272727272727273,123,214,337,52,25,22,54,100,436,2016_Bobby Portis
2016,Bradley Beal,SG,22,359,799,0.4493116395494368,105,271,0.3874538745387454,254,528,0.4810606060606061,135,176,0.7670454545454546,41,147,188,162,54,11,112,117,958,2016_Bradley Beal
2016,Briante Weber,PG,23,28,78,0.358974358974359,0,10,0.0,28,68,0.4117647058823529,6,8,0.75,16,34,50,42,18,6,18,24,62,2016_Briante Weber
2016,Eric Moreland,PF,24,3,6,0.5,0,0,NaN,3,6,0.5,2,4,0.5,3,8,11,1,0,4,3,4,8,2016_Eric Moreland
2016,Henry Sims,C,25,33,77,0.42857142857142855,0,0,NaN,33,77,0.42857142857142855,25,30,0.8333333333333334,21,51,72,9,9,14,12,37,91,2016_Henry Sims
2016,Jason Smith,C,29,244,503,0.4850894632206759,4,16,0.25,240,487,0.4928131416837782,54,67,0.8059701492537313,53,166,219,62,33,65,57,163,546,2016_Jason Smith
2016,Joe Harris,SG,24,1,4,0.25,1,4,0.25,0,0,NaN,0,0,NaN,0,3,3,2,0,0,1,1,3,2016_Joe Harris
2016,Joe Young,PG,23,62,169,0.3668639053254438,10,46,0.21739130434782608,52,123,0.42276422764227645,20,25,0.8,6,44,50,65,15,0,33,30,154,2016_Joe Young
2016,Jordan Hill,C,28,278,549,0.5063752276867031,0,1,0.0,278,548,0.5072992700729927,89,125,0.712,156,295,451,87,36,37,92,155,645,2016_Jordan Hill
2016,Kemba Walker,PG,25,568,1331,0.42674680691209615,182,490,0.37142857142857144,386,841,0.4589774078478002,371,438,0.8470319634703196,56,301,357,421,126,39,171,111,1689,2016_Kemba Walker
2016,Lou Amundson,PF,33,19,53,0.3584905660377358,0,0,NaN,19,53,0.3584905660377358,14,27,0.5185185185185185,23,26,49,12,6,7,15,44,52,2016_Lou Amundson
2016,Luol Deng,PF,30,339,745,0.45503355704697984,88,256,0.34375,251,489,0.5132924335378323,145,192,0.7552083333333334,108,335,443,140,74,29,81,122,911,2016_Luol Deng
2016,P.J. Tucker,SF,30,239,582,0.4106529209621993,68,206,0.3300970873786408,171,376,0.45478723404255317,106,142,0.7464788732394366,165,347,512,177,106,20,111,202,652,2016_P.J. Tucker
2016,Trey Lyles,PF,20,191,436,0.4380733944954128,49,128,0.3828125,142,308,0.461038961038961,57,82,0.6951219512195121,59,240,299,59,26,18,65,114,488,2016_Trey Lyles
2016,Willie Cauley-Stein,C,22,191,339,0.5634218289085545,0,2,0.0,191,337,0.5667655786350149,81,125,0.648,134,218,352,37,48,66,46,146,463,2016_Willie Cauley-Stein
2017,Al-Farouq Aminu,SF,26,183,466,0.3927038626609442,70,212,0.330188679245283,113,254,0.4448818897637795,96,136,0.7058823529411765,77,374,451,99,60,44,94,102,532,2017_Al-Farouq Aminu
2017,Alan Williams,C,24,138,267,0.5168539325842697,0,1,0.0,138,266,0.518796992481203,70,112,0.625,94,198,292,23,27,32,37,125,346,2017_Alan Williams
2017,Ben Bentil,PF,21,0,3,0.0,0,1,0.0,0,2,0.0,0,0,NaN,0,2,2,0,0,0,1,1,0,2017_Ben Bentil
2017,Briante Weber,PG,24,50,120,0.4166666666666667,2,20,0.1,48,100,0.48,22,32,0.6875,16,36,52,42,24,2,16,32,124,2017_Briante Weber
2017,Chasson Randle,PG,23,80,196,0.40816326530612246,32,94,0.3404255319148936,48,102,0.47058823529411764,82,86,0.9534883720930233,12,52,64,68,18,4,38,78,274,2017_Chasson Randle
2017,Clint Capela,C,22,362,563,0.6429840142095915,0,0,NaN,362,563,0.6429840142095915,94,177,0.5310734463276836,178,348,526,64,34,80,87,179,818,2017_Clint Capela
2017,Derrick Favors,PF,25,203,417,0.486810551558753,3,10,0.3,200,407,0.4914004914004914,67,109,0.6146788990825688,92,213,305,56,45,40,60,103,476,2017_Derrick Favors
2017,Eric Bledsoe,PG,27,449,1034,0.43423597678916825,104,310,0.33548387096774196,345,724,0.47651933701657456,388,458,0.8471615720524017,52,268,320,418,92,31,223,164,1390,2017_Eric Bledsoe
2017,Jerami Grant,SF,22,304,656,0.4634146341463415,86,232,0.3706896551724138,218,424,0.5141509433962265,180,294,0.6122448979591837,76,336,412,92,66,158,88,298,874,2017_Jerami Grant
2017,Joe Young,PG,24,26,72,0.3611111111111111,5,23,0.21739130434782608,21,49,0.42857142857142855,11,15,0.7333333333333333,1,16,17,15,4,0,5,5,68,2017_Joe Young
2017,Jordan Crawford,SG,28,105,218,0.481651376146789,37,95,0.3894736842105263,68,123,0.5528455284552846,20,26,0.7692307692307693,4,30,34,57,11,2,25,30,267,2017_Jordan Crawford
2017,Jordan Hill,C,29,5,13,0.38461538461538464,0,0,NaN,5,13,0.38461538461538464,2,2,1.0,8,6,14,0,1,0,4,9,12,2017_Jordan Hill
2017,Kay Felder,PG,21,62,158,0.3924050632911392,7,22,0.3181818181818182,55,136,0.40441176470588236,35,49,0.7142857142857143,3,38,41,58,18,7,31,38,166,2017_Kay Felder
2017,Kelly Olynyk,C,25,260,508,0.5118110236220472,68,192,0.3541666666666667,192,316,0.6075949367088608,90,123,0.7317073170731707,72,288,360,148,43,29,96,207,678,2017_Kelly Olynyk
2017,Kyle Wiltjer,PF,24,4,14,0.2857142857142857,4,13,0.3076923076923077,0,1,0.0,1,2,0.5,4,6,10,2,3,1,5,4,13,2017_Kyle Wiltjer
2017,Luol Deng,SF,31,164,424,0.3867924528301887,51,165,0.3090909090909091,113,259,0.4362934362934363,46,63,0.7301587301587301,63,232,295,74,48,20,43,61,425,2017_Luol Deng
2017,Marvin Williams,PF,30,297,704,0.421875,124,354,0.3502824858757062,173,350,0.4942857142857143,131,150,0.8733333333333333,89,409,498,106,58,53,60,134,849,2017_Marvin Williams
2017,P.J. Tucker,SF,31,398,964,0.41286307053941906,140,392,0.35714285714285715,258,572,0.45104895104895104,144,186,0.7741935483870968,234,710,944,198,232,38,132,392,1080,2017_P.J. Tucker
2017,Quinn Cook,PG,23,66,132,0.5,22,52,0.4230769230769231,44,80,0.55,4,10,0.4,2,12,14,52,8,0,26,26,158,2017_Quinn Cook
2017,Ronnie Price,PG,33,4,24,0.16666666666666666,3,17,0.17647058823529413,1,7,0.14285714285714285,3,4,0.75,3,8,11,18,11,1,3,14,14,2017_Ronnie Price
2017,Tyreke Evans,SF,27,300,740,0.40540540540540543,84,236,0.3559322033898305,216,504,0.42857142857142855,138,184,0.75,26,248,274,248,70,18,122,120,822,2017_Tyreke Evans
2017,Willie Cauley-Stein,C,23,255,481,0.5301455301455301,0,2,0.0,255,479,0.5323590814196242,101,151,0.6688741721854304,85,255,340,80,53,45,69,147,611,2017_Willie Cauley-Stein
2003,Bobby Jackson,PG,29,340,732,0.4644808743169399,89,235,0.37872340425531914,251,497,0.5050301810865191,126,149,0.8456375838926175,57,162,219,182,71,3,106,126,895,2003_Bobby Jackson
2003,Chris Childs,PG,35,6,20,0.3,1,6,0.16666666666666666,5,14,0.35714285714285715,2,3,0.6666666666666666,3,2,5,16,8,1,6,17,15,2003_Chris Childs
2003,Chris Owens,SF,23,2,3,0.6666666666666666,0,0,NaN,2,3,0.6666666666666666,0,0,NaN,1,0,1,0,0,0,1,0,4,2003_Chris Owens
2003,Frank Williams,PG,22,9,33,0.2727272727272727,6,16,0.375,3,17,0.17647058823529413,4,6,0.6666666666666666,3,15,18,34,7,2,17,20,28,2003_Frank Williams
2003,Gilbert Arenas,PG,21,509,1180,0.43135593220338986,109,313,0.34824281150159747,400,867,0.461361014994233,370,468,0.7905982905982906,97,289,386,514,124,17,290,260,1497,2003_Gilbert Arenas
2003,Jeff Foster,C,26,64,178,0.3595505617977528,0,2,0.0,64,176,0.36363636363636365,34,63,0.5396825396825397,118,161,279,51,28,21,34,103,162,2003_Jeff Foster
2003,Karl Malone,PF,39,595,1289,0.4615981380915438,3,14,0.21428571428571427,592,1275,0.46431372549019606,474,621,0.7632850241545893,113,515,628,379,136,31,210,204,1667,2003_Karl Malone
2003,Keyon Dooling,SG,22,128,329,0.3890577507598784,50,139,0.3597122302158273,78,190,0.4105263157894737,44,57,0.7719298245614035,9,63,72,89,24,6,60,93,350,2003_Keyon Dooling
2003,Mike Dunleavy,SF,22,168,417,0.4028776978417266,52,150,0.3466666666666667,116,267,0.4344569288389513,78,100,0.78,66,148,214,106,53,19,86,120,466,2003_Mike Dunleavy
2003,Peja Stojakovic,SF,25,497,1034,0.48065764023210833,155,406,0.3817733990147783,342,628,0.5445859872611465,231,264,0.875,61,336,397,141,72,5,101,143,1380,2003_Peja Stojakovic
2003,Shane Battier,SF,24,275,569,0.4833040421792619,86,216,0.39814814814814814,189,353,0.5354107648725213,120,145,0.8275862068965517,128,217,345,105,102,88,68,207,756,2003_Shane Battier
2003,Terence Morris,SF,24,82,176,0.4659090909090909,7,32,0.21875,75,144,0.5208333333333334,11,14,0.7857142857142857,40,88,128,25,8,17,29,35,182,2003_Terence Morris
2003,Tim Hardaway,PG,36,18,49,0.3673469387755102,11,31,0.3548387096774194,7,18,0.3888888888888889,2,4,0.5,1,14,15,24,9,0,11,8,49,2003_Tim Hardaway
2004,Bob Sura,SG,30,404,970,0.41649484536082476,42,158,0.26582278481012656,362,812,0.4458128078817734,342,452,0.7566371681415929,200,452,652,466,124,28,210,316,1192,2004_Bob Sura
2004,Gerald Wallace,SF,21,32,89,0.3595505617977528,0,2,0.0,32,87,0.367816091954023,11,24,0.4583333333333333,35,39,74,19,14,14,8,37,75,2004_Gerald Wallace
2004,Hiram Fuller,PF,22,3,8,0.375,0,0,NaN,3,8,0.375,2,6,0.3333333333333333,4,7,11,2,0,1,4,5,8,2004_Hiram Fuller
2004,Jason Richardson,SG,23,563,1284,0.4384735202492212,77,273,0.28205128205128205,486,1011,0.4807121661721068,258,377,0.6843501326259946,124,400,524,226,86,41,196,182,1461,2004_Jason Richardson
2004,Jeff Foster,C,27,197,362,0.5441988950276243,0,4,0.0,197,358,0.5502793296089385,103,154,0.6688311688311688,248,362,610,64,71,27,60,189,497,2004_Jeff Foster
2004,Keith McLeod,PG,24,27,82,0.32926829268292684,1,10,0.1,26,72,0.3611111111111111,33,43,0.7674418604651163,5,29,34,59,16,1,29,39,88,2004_Keith McLeod
2004,Keyon Dooling,PG,23,137,352,0.38920454545454547,8,46,0.17391304347826086,129,306,0.4215686274509804,78,94,0.8297872340425532,17,62,79,130,45,6,65,108,360,2004_Keyon Dooling
2004,Kirk Hinrich,PG,23,318,823,0.3863912515188335,144,369,0.3902439024390244,174,454,0.3832599118942731,135,168,0.8035714285714286,42,217,259,517,101,21,204,276,915,2004_Kirk Hinrich
2004,Mike Dunleavy,SF,23,323,720,0.4486111111111111,94,254,0.3700787401574803,229,466,0.49141630901287553,137,185,0.7405405405405405,87,355,442,220,68,13,143,169,877,2004_Mike Dunleavy
2004,Peja Stojakovic,SF,26,665,1386,0.4797979797979798,240,554,0.4332129963898917,425,832,0.5108173076923077,394,425,0.9270588235294117,91,417,508,173,108,14,153,159,1964,2004_Peja Stojakovic
2004,Shane Battier,SF,25,242,543,0.44567219152854515,65,186,0.34946236559139787,177,357,0.4957983193277311,120,164,0.7317073170731707,102,201,303,101,101,58,56,187,669,2004_Shane Battier
2004,Tamar Slay,SG,23,21,60,0.35,4,12,0.3333333333333333,17,48,0.3541666666666667,7,14,0.5,10,15,25,14,7,1,11,20,53,2004_Tamar Slay
2004,Zoran Planinic,SG,21,53,129,0.4108527131782946,9,32,0.28125,44,97,0.4536082474226804,38,60,0.6333333333333333,14,41,55,68,13,3,36,70,153,2004_Zoran Planinic
2005,Andris Biedrins,C,18,45,78,0.5769230769230769,0,1,0.0,45,77,0.5844155844155844,19,40,0.475,47,71,118,12,12,24,12,87,109,2005_Andris Biedrins
2005,Brandin Knight,PG,23,0,1,0.0,0,0,NaN,0,1,0.0,0,0,NaN,0,0,0,1,0,0,0,0,0,2005_Brandin Knight
2005,Brian Cook,C,24,176,422,0.41706161137440756,78,199,0.39195979899497485,98,223,0.43946188340807174,28,37,0.7567567567567568,63,153,216,35,23,26,29,139,458,2005_Brian Cook
2005,Brian Scalabrine,PF,26,132,332,0.39759036144578314,22,68,0.3235294117647059,110,264,0.4166666666666667,53,69,0.7681159420289855,83,161,244,88,34,18,66,111,339,2005_Brian Scalabrine
2005,Geno Carlisle,SG,28,2,3,0.6666666666666666,0,0,NaN,2,3,0.6666666666666666,4,6,0.6666666666666666,1,0,1,1,0,0,1,1,8,2005_Geno Carlisle
2005,Jahidi White,C,28,14,31,0.45161290322580644,0,0,NaN,14,31,0.45161290322580644,14,40,0.35,11,23,34,1,2,12,11,31,42,2005_Jahidi White
2005,Jeff Foster,C,28,168,324,0.5185185185185185,0,5,0.0,168,319,0.5266457680250783,90,142,0.6338028169014085,205,345,550,43,46,12,55,186,426,2005_Jeff Foster
2005,Kenny Thomas,PF,27,734,1562,0.469910371318822,2,10,0.2,732,1552,0.47164948453608246,346,454,0.762114537444934,368,702,1070,304,134,34,262,454,1816,2005_Kenny Thomas
2005,Keyon Dooling,PG,24,139,345,0.4028985507246377,19,75,0.25333333333333335,120,270,0.4444444444444444,85,109,0.7798165137614679,11,79,90,132,39,11,65,120,382,2005_Keyon Dooling
2005,Matt Freije,PF,23,37,127,0.29133858267716534,14,54,0.25925925925925924,23,73,0.3150684931506849,5,8,0.625,16,45,61,20,13,2,17,40,93,2005_Matt Freije
2005,Mike Dunleavy,SF,24,408,905,0.450828729281768,107,276,0.38768115942028986,301,629,0.4785373608903021,134,172,0.7790697674418605,97,338,435,203,79,26,132,198,1057,2005_Mike Dunleavy
2005,Nikoloz Tskitishvili,PF,21,44,148,0.2972972972972973,4,34,0.11764705882352941,40,114,0.3508771929824561,8,14,0.5714285714285714,24,58,82,20,16,22,38,66,100,2005_Nikoloz Tskitishvili
2005,Pape Sow,C,23,23,58,0.39655172413793105,0,0,NaN,23,58,0.39655172413793105,16,27,0.5925925925925926,18,39,57,2,12,4,10,46,62,2005_Pape Sow
2005,Peja Stojakovic,SF,27,451,1016,0.4438976377952756,174,433,0.4018475750577367,277,583,0.4751286449399657,253,275,0.92,62,223,285,138,79,12,102,157,1329,2005_Peja Stojakovic
2005,Ryan Bowen,SF,29,47,111,0.42342342342342343,3,6,0.5,44,105,0.41904761904761906,14,21,0.6666666666666666,21,55,76,18,23,5,7,61,111,2005_Ryan Bowen
2005,Shane Battier,SG,26,271,613,0.44208809135399674,70,177,0.3954802259887006,201,436,0.4610091743119266,180,228,0.7894736842105263,158,255,413,126,91,77,75,201,792,2005_Shane Battier
2006,Alan Anderson,SF,23,75,181,0.4143646408839779,24,58,0.41379310344827586,51,123,0.4146341463414634,33,41,0.8048780487804879,23,47,70,32,11,4,32,48,207,2006_Alan Anderson
2006,Andrei Kirilenko,SF,24,336,730,0.4602739726027397,36,117,0.3076923076923077,300,613,0.4893964110929853,346,495,0.6989898989898989,161,391,552,299,102,220,203,162,1054,2006_Andrei Kirilenko
2006,Andris Biedrins,C,19,118,185,0.6378378378378379,0,0,NaN,118,185,0.6378378378378379,22,72,0.3055555555555556,124,159,283,24,23,47,34,190,258,2006_Andris Biedrins
2006,Deron Williams,PG,21,339,805,0.42111801242236024,91,219,0.4155251141552511,248,586,0.4232081911262799,95,135,0.7037037037037037,35,159,194,359,60,17,145,233,864,2006_Deron Williams
2006,Francisco Garcia,SF,24,130,325,0.4,39,137,0.2846715328467153,91,188,0.48404255319148937,78,101,0.7722772277227723,39,146,185,94,41,47,75,135,377,2006_Francisco Garcia
2006,Jeff Foster,C,29,138,250,0.552,0,4,0.0,138,246,0.5609756097560976,96,159,0.6037735849056604,224,350,574,50,41,27,64,191,372,2006_Jeff Foster
2006,Jermaine Jackson,PG,29,11,26,0.4230769230769231,1,4,0.25,10,22,0.45454545454545453,12,14,0.8571428571428571,8,19,27,25,4,1,13,19,35,2006_Jermaine Jackson
2006,Joel Przybilla,C,26,131,239,0.5481171548117155,0,0,NaN,131,239,0.5481171548117155,82,154,0.5324675324675324,146,245,391,43,20,130,76,149,344,2006_Joel Przybilla
2006,John Edwards,C,24,31,64,0.484375,0,0,NaN,31,64,0.484375,8,11,0.7272727272727273,18,30,48,5,3,15,12,76,70,2006_John Edwards
2006,Julius Hodge,SG,22,5,13,0.38461538461538464,0,0,NaN,5,13,0.38461538461538464,3,8,0.375,5,2,7,6,2,0,8,7,13,2006_Julius Hodge
2006,Keyon Dooling,PG,25,178,405,0.43950617283950616,13,43,0.3023255813953488,165,362,0.4558011049723757,101,121,0.8347107438016529,11,67,78,109,49,4,82,116,470,2006_Keyon Dooling
2006,Luther Head,SG,23,254,630,0.4031746031746032,113,313,0.3610223642172524,141,317,0.444794952681388,86,123,0.6991869918699187,33,233,266,215,89,9,119,169,707,2006_Luther Head
2006,Mike Dunleavy,SF,25,331,816,0.4056372549019608,74,260,0.2846153846153846,257,556,0.46223021582733814,196,252,0.7777777777777778,78,321,399,237,60,32,120,199,932,2006_Mike Dunleavy
2006,Peja Stojakovic,SF,28,890,2036,0.43713163064833005,324,808,0.400990099009901,566,1228,0.4609120521172638,476,520,0.9153846153846154,158,672,830,272,90,20,206,342,2580,2006_Peja Stojakovic
2006,Rashad McCants,SG,21,241,535,0.4504672897196262,67,180,0.37222222222222223,174,355,0.49014084507042255,78,106,0.7358490566037735,29,114,143,63,44,22,86,176,627,2006_Rashad McCants
2006,Reggie Evans,PF,25,262,536,0.48880597014925375,0,2,0.0,262,534,0.49063670411985016,230,434,0.5299539170506913,342,662,1004,76,80,20,170,332,754,2006_Reggie Evans
2006,Shane Battier,SF,27,303,621,0.48792270531400966,65,165,0.3939393939393939,238,456,0.5219298245614035,147,208,0.7067307692307693,164,265,429,136,92,114,90,223,818,2006_Shane Battier
2006,Theo Ratliff,C,32,108,189,0.5714285714285714,0,0,NaN,108,189,0.5714285714285714,54,83,0.6506024096385542,89,190,279,28,18,88,47,143,270,2006_Theo Ratliff
2006,Vitaly Potapenko,C,30,74,142,0.5211267605633803,0,0,NaN,74,142,0.5211267605633803,20,34,0.5882352941176471,54,74,128,18,4,4,32,100,168,2006_Vitaly Potapenko
2007,Alan Anderson,SG,24,37,81,0.4567901234567901,5,20,0.25,32,61,0.5245901639344263,19,23,0.8260869565217391,11,21,32,21,7,0,22,33,98,2007_Alan Anderson
2007,Andre Miller,PG,30,848,1818,0.46644664466446645,10,70,0.14285714285714285,838,1748,0.4794050343249428,444,566,0.784452296819788,194,510,704,1250,220,20,444,368,2150,2007_Andre Miller
2007,Didier Ilunga-Mbenga,C,26,5,16,0.3125,0,0,NaN,5,16,0.3125,7,8,0.875,3,8,11,6,3,5,5,17,17,2007_Didier Ilunga-Mbenga
2007,Ivan McFarlin,PF,24,5,13,0.38461538461538464,0,1,0.0,5,12,0.4166666666666667,5,7,0.7142857142857143,7,4,11,1,0,0,1,8,15,2007_Ivan McFarlin
2007,Keyon Dooling,SG,26,188,458,0.4104803493449782,31,96,0.3229166666666667,157,362,0.43370165745856354,114,141,0.8085106382978723,22,64,86,112,52,15,72,125,521,2007_Keyon Dooling
2007,Leon Powe,C,23,79,177,0.4463276836158192,0,2,0.0,79,175,0.4514285714285714,106,144,0.7361111111111112,97,118,215,10,14,22,47,104,264,2007_Leon Powe
2007,Luther Head,SG,24,306,700,0.43714285714285717,177,401,0.44139650872817954,129,299,0.431438127090301,83,105,0.7904761904761904,31,221,252,194,76,5,137,133,872,2007_Luther Head
2007,Matt Freije,PF,25,16,54,0.2962962962962963,3,22,0.13636363636363635,13,32,0.40625,5,6,0.8333333333333334,8,16,24,7,3,1,3,13,40,2007_Matt Freije
2007,Mike Bibby,PG,28,471,1166,0.4039451114922813,173,481,0.3596673596673597,298,685,0.43503649635036495,288,347,0.829971181556196,39,224,263,388,88,6,197,139,1403,2007_Mike Bibby
2007,Mike Dunleavy,SG_PF_SG-PF,26,768,1700,0.45176470588235296,140,448,0.3125,628,1252,0.5015974440894568,422,538,0.7843866171003717,168,694,862,456,168,44,298,406,2098,2007_Mike Dunleavy
2007,Peja Stojakovic,SF,29,83,196,0.42346938775510207,34,84,0.40476190476190477,49,112,0.4375,31,38,0.8157894736842105,11,43,54,11,8,4,19,29,231,2007_Peja Stojakovic
2007,Shane Battier,SF,28,292,654,0.44648318042813456,157,373,0.42091152815013405,135,281,0.4804270462633452,88,113,0.7787610619469026,67,271,338,175,79,60,72,190,829,2007_Shane Battier
2008,Beno Udrih,PG,25,328,708,0.4632768361581921,53,137,0.38686131386861317,275,571,0.4816112084063047,125,147,0.8503401360544217,34,183,217,282,56,10,148,138,834,2008_Beno Udrih
2008,Chris Webber,PF,34,15,31,0.4838709677419355,0,0,NaN,15,31,0.4838709677419355,5,12,0.4166666666666667,2,30,32,18,4,6,11,17,35,2008_Chris Webber
2008,Damon Stoudamire,PG,34,240,674,0.3560830860534125,100,298,0.33557046979865773,140,376,0.3723404255319149,54,68,0.7941176470588235,40,196,236,330,60,4,160,152,634,2008_Damon Stoudamire
2008,Grant Hill,SF,35,358,712,0.5028089887640449,33,104,0.3173076923076923,325,608,0.5345394736842105,170,196,0.8673469387755102,74,279,353,203,65,56,96,153,919,2008_Grant Hill
2008,Ira Newble,SF_SG_SG-SF,33,152,348,0.4367816091954023,32,98,0.32653061224489793,120,250,0.48,40,52,0.7692307692307693,94,156,250,36,56,16,68,138,376,2008_Ira Newble
2008,J.R. Smith,SG,22,311,674,0.46142433234421365,157,390,0.4025641025641026,154,284,0.5422535211267606,128,178,0.7191011235955056,43,109,152,128,62,12,112,144,907,2008_J.R. Smith
2008,Juan Dixon,PG,29,212,516,0.4108527131782946,60,144,0.4166666666666667,152,372,0.40860215053763443,42,52,0.8076923076923077,30,120,150,194,42,4,108,124,526,2008_Juan Dixon
2008,Keyon Dooling,PG,27,198,423,0.46808510638297873,22,65,0.3384615384615385,176,358,0.49162011173184356,163,193,0.844559585492228,7,94,101,133,36,5,61,131,581,2008_Keyon Dooling
2008,Kyle Lowry,PG,21,256,592,0.43243243243243246,36,140,0.2571428571428571,220,452,0.48672566371681414,243,348,0.6982758620689655,41,209,250,296,92,22,127,185,791,2008_Kyle Lowry
2008,Leon Powe,C,24,154,269,0.5724907063197026,0,1,0.0,154,268,0.5746268656716418,137,193,0.7098445595854922,95,132,227,15,15,16,43,127,445,2008_Leon Powe
2008,Luther Head,SG,25,206,477,0.43186582809224316,79,225,0.3511111111111111,127,252,0.503968253968254,66,81,0.8148148148148148,18,117,135,138,44,9,70,75,557,2008_Luther Head
2008,Michael Ruffin,C,31,33,62,0.532258064516129,0,0,NaN,33,62,0.532258064516129,25,63,0.3968253968253968,90,96,186,24,31,19,19,93,91,2008_Michael Ruffin
2008,Mike Dunleavy,SG,27,532,1117,0.4762757385854969,165,389,0.4241645244215938,367,728,0.5041208791208791,336,403,0.8337468982630273,59,365,424,288,86,31,190,208,1565,2008_Mike Dunleavy
2008,Raymond Felton,PG,23,412,997,0.41323971915747243,56,200,0.28,356,797,0.4466750313676286,260,325,0.8,37,199,236,583,96,12,213,184,1140,2008_Raymond Felton
2008,Shane Battier,SF,29,265,619,0.4281098546042003,139,369,0.37669376693766937,126,250,0.504,75,101,0.7425742574257426,131,276,407,155,77,90,78,196,744,2008_Shane Battier
2008,Smush Parker,PG,26,128,368,0.34782608695652173,36,156,0.23076923076923078,92,212,0.4339622641509434,38,56,0.6785714285714286,8,94,102,168,48,12,88,120,330,2008_Smush Parker
2009,Anderson Varejao,PF,26,270,504,0.5357142857142857,0,2,0.0,270,502,0.5378486055776892,154,250,0.616,166,415,581,81,75,66,80,239,694,2009_Anderson Varejao
2009,Andrew Bogut,C,24,183,317,0.5772870662460567,0,0,NaN,183,317,0.5772870662460567,56,98,0.5714285714285714,117,252,369,72,23,37,86,130,422,2009_Andrew Bogut
2009,Anthony Roberson,PG,25,88,240,0.36666666666666664,52,162,0.32098765432098764,36,78,0.46153846153846156,10,10,1.0,12,32,44,40,20,2,16,36,238,2009_Anthony Roberson
2009,Calvin Booth,C,32,10,20,0.5,0,0,NaN,10,20,0.5,12,16,0.75,10,12,22,0,2,4,2,20,32,2009_Calvin Booth
2009,Chris Andersen,C,30,160,292,0.547945205479452,2,10,0.2,158,282,0.5602836879432624,130,181,0.7182320441988951,163,279,442,31,41,175,69,174,452,2009_Chris Andersen
2009,Eddie Gill,PG,30,6,9,0.6666666666666666,2,3,0.6666666666666666,4,6,0.6666666666666666,0,0,NaN,0,4,4,11,3,1,5,10,14,2009_Eddie Gill
2009,Greg Oden,C,21,198,351,0.5641025641025641,0,0,NaN,198,351,0.5641025641025641,144,226,0.6371681415929203,169,255,424,31,25,69,87,238,540,2009_Greg Oden
2009,Keyon Dooling,PG,28,261,598,0.43645484949832775,99,235,0.42127659574468085,162,363,0.4462809917355372,127,154,0.8246753246753247,24,131,155,270,71,8,105,135,748,2009_Keyon Dooling
2009,Leon Powe,PF,25,177,338,0.5236686390532544,0,0,NaN,177,338,0.5236686390532544,184,267,0.6891385767790262,145,200,345,46,24,38,76,192,538,2009_Leon Powe
2009,Luther Head,PG-SG_SG_PG,26,110,288,0.3819444444444444,40,108,0.37037037037037035,70,180,0.3888888888888889,38,48,0.7916666666666666,12,92,104,116,34,4,50,74,298,2009_Luther Head
2009,Maurice Evans,SF,30,208,482,0.4315352697095436,98,248,0.3951612903225806,110,234,0.4700854700854701,60,73,0.821917808219178,88,155,243,54,50,10,43,163,574,2009_Maurice Evans
2009,Mike Dunleavy,SG,28,93,232,0.40086206896551724,32,90,0.35555555555555557,61,142,0.4295774647887324,53,65,0.8153846153846154,14,54,68,44,12,9,38,36,271,2009_Mike Dunleavy
2010,Andris Biedrins,C,23,81,137,0.5912408759124088,0,0,NaN,81,137,0.5912408759124088,4,25,0.16,63,196,259,57,20,44,32,117,166,2010_Andris Biedrins
2010,Anthony Tolliver,PF,24,386,898,0.4298440979955457,100,304,0.32894736842105265,286,594,0.48148148148148145,206,268,0.7686567164179104,168,472,640,174,64,66,92,256,1078,2010_Anthony Tolliver
2010,David Lee,C,26,686,1258,0.5453100158982512,0,8,0.0,686,1250,0.5488,268,330,0.8121212121212121,228,721,949,295,85,40,189,257,1640,2010_David Lee
2010,Jameer Nelson,PG,27,317,706,0.4490084985835694,86,226,0.3805309734513274,231,480,0.48125,98,116,0.8448275862068966,26,168,194,353,48,2,139,147,818,2010_Jameer Nelson
2010,Jarron Collins,C,31,12,31,0.3870967741935484,0,0,NaN,12,31,0.3870967741935484,10,25,0.4,22,40,62,6,2,3,10,42,34,2010_Jarron Collins
2010,Jeff Foster,C,33,22,46,0.4782608695652174,0,1,0.0,22,45,0.4888888888888889,5,9,0.5555555555555556,34,47,81,21,3,4,14,45,49,2010_Jeff Foster
2010,Jerryd Bayless,SG,21,200,483,0.4140786749482402,29,92,0.31521739130434784,171,391,0.4373401534526854,201,242,0.8305785123966942,18,102,120,172,26,5,94,152,630,2010_Jerryd Bayless
2010,Larry Hughes,SG,31,274,772,0.3549222797927461,86,278,0.30935251798561153,188,494,0.3805668016194332,188,226,0.831858407079646,46,238,284,274,104,30,150,140,822,2010_Larry Hughes
2010,Peja Stojakovic,SF,32,278,688,0.40406976744186046,132,352,0.375,146,336,0.43452380952380953,96,107,0.897196261682243,39,188,227,92,48,5,56,83,784,2010_Peja Stojakovic
2010,Shane Battier,SG,31,178,447,0.3982102908277405,101,279,0.36200716845878134,77,168,0.4583333333333333,77,106,0.7264150943396226,74,238,312,164,53,76,64,139,534,2010_Shane Battier
2010,Wayne Ellington,SG,22,190,448,0.42410714285714285,64,162,0.3950617283950617,126,286,0.4405594405594406,61,70,0.8714285714285714,33,126,159,74,20,5,74,72,505,2010_Wayne Ellington
2010,Yakhouba Diawara,SG,27,2,10,0.2,1,6,0.16666666666666666,1,4,0.25,0,0,NaN,1,3,4,3,1,0,3,8,5,2010_Yakhouba Diawara
2011,Amir Johnson,PF,23,281,495,0.5676767676767677,0,1,0.0,281,494,0.5688259109311741,126,160,0.7875,189,272,461,81,53,88,69,263,688,2011_Amir Johnson
2011,Andre Iguodala,SF,27,338,759,0.4453227931488801,61,181,0.3370165745856354,277,578,0.47923875432525953,208,300,0.6933333333333334,61,326,387,422,101,38,138,109,945,2011_Andre Iguodala
2011,Andrew Bynum,C,23,237,413,0.5738498789346247,0,0,NaN,237,413,0.5738498789346247,138,209,0.6602870813397129,170,338,508,73,19,106,74,140,612,2011_Andrew Bynum
2011,Andris Biedrins,C,24,142,266,0.5338345864661654,0,0,NaN,142,266,0.5338345864661654,10,31,0.3225806451612903,145,281,426,60,52,52,57,198,294,2011_Andris Biedrins
2011,Chris Johnson,C,25,18,42,0.42857142857142855,0,0,NaN,18,42,0.42857142857142855,30,40,0.75,24,40,64,6,6,18,20,42,66,2011_Chris Johnson
2011,Damion James,SF,23,46,103,0.44660194174757284,0,3,0.0,46,100,0.46,18,28,0.6428571428571429,17,68,85,20,16,12,25,36,110,2011_Damion James
2011,David Lee,PF,27,496,978,0.5071574642126789,1,3,0.3333333333333333,495,975,0.5076923076923077,210,267,0.7865168539325843,217,497,714,233,74,31,170,211,1203,2011_David Lee
2011,DeAndre Jordan,C,22,234,341,0.6862170087976539,0,1,0.0,234,340,0.6882352941176471,98,217,0.45161290322580644,207,368,575,42,41,142,101,255,566,2011_DeAndre Jordan
2011,Derrick Caracter,C,22,32,66,0.48484848484848486,0,0,NaN,32,66,0.48484848484848486,17,23,0.7391304347826086,19,24,43,7,4,10,19,47,81,2011_Derrick Caracter
2011,Jameer Nelson,PG,28,374,838,0.44630071599045346,119,297,0.4006734006734007,255,541,0.4713493530499076,130,162,0.8024691358024691,37,189,226,456,75,3,194,209,997,2011_Jameer Nelson
2011,Jeff Foster,C,34,80,167,0.47904191616766467,0,3,0.0,80,164,0.4878048780487805,27,48,0.5625,160,190,350,46,24,31,26,127,187,2011_Jeff Foster
2011,Keyon Dooling,PG,30,206,519,0.3969171483622351,81,234,0.34615384615384615,125,285,0.43859649122807015,78,94,0.8297872340425532,12,105,117,243,54,4,91,119,571,2011_Keyon Dooling
2011,Lou Amundson,PF,28,83,183,0.453551912568306,0,0,NaN,83,183,0.453551912568306,34,87,0.39080459770114945,81,104,185,17,14,33,24,87,200,2011_Lou Amundson
2011,Mike Dunleavy,SG,30,240,520,0.46153846153846156,102,254,0.4015748031496063,138,266,0.518796992481203,100,125,0.8,28,248,276,105,40,30,69,107,682,2011_Mike Dunleavy
2011,Peja Stojakovic,SF,33,200,454,0.44052863436123346,114,272,0.41911764705882354,86,182,0.4725274725274725,46,50,0.92,28,122,150,58,26,4,34,48,560,2011_Peja Stojakovic
2011,Ronny Turiaf,C,28,103,163,0.6319018404907976,0,0,NaN,103,163,0.6319018404907976,61,98,0.6224489795918368,64,143,207,92,35,73,41,160,267,2011_Ronny Turiaf
2011,Shane Battier,SF,32,458,1018,0.449901768172888,204,534,0.38202247191011235,254,484,0.5247933884297521,128,186,0.6881720430107527,180,566,746,370,138,162,158,316,1248,2011_Shane Battier
2011,Von Wafer,SG,25,67,159,0.42138364779874216,18,67,0.26865671641791045,49,92,0.532608695652174,32,38,0.8421052631578947,7,42,49,35,18,5,20,39,184,2011_Von Wafer
2011,Wayne Ellington,SG,23,160,397,0.40302267002518893,48,121,0.39669421487603307,112,276,0.4057971014492754,42,53,0.7924528301886793,26,82,108,72,28,3,53,85,410,2011_Wayne Ellington
2011,Will Bynum,PG,28,182,406,0.4482758620689655,16,50,0.32,166,356,0.46629213483146065,102,122,0.8360655737704918,15,59,74,195,52,4,83,113,482,2011_Will Bynum
2012,Andris Biedrins,C,25,39,64,0.609375,0,0,NaN,39,64,0.609375,1,9,0.1111111111111111,45,131,176,16,23,45,14,125,79,2012_Andris Biedrins
2012,Charles Jenkins,PG,22,130,291,0.44673539518900346,3,20,0.15,127,271,0.46863468634686345,34,39,0.8717948717948718,8,60,68,170,33,6,60,85,297,2012_Charles Jenkins
2012,Chris Johnson,C,26,40,82,0.4878048780487805,0,0,NaN,40,82,0.4878048780487805,30,38,0.7894736842105263,30,50,80,4,12,18,30,66,110,2012_Chris Johnson
2012,David Lee,PF,28,464,922,0.5032537960954447,0,5,0.0,464,917,0.5059978189749182,219,280,0.7821428571428571,171,374,545,162,54,22,149,179,1147,2012_David Lee
2012,Henry Walker,SG,24,68,171,0.39766081871345027,36,113,0.3185840707964602,32,58,0.5517241379310345,17,20,0.85,9,71,80,37,19,7,35,84,189,2012_Henry Walker
2012,Ivan Johnson,PF,27,141,275,0.5127272727272727,2,6,0.3333333333333333,139,269,0.516728624535316,72,100,0.72,65,161,226,32,43,18,69,116,356,2012_Ivan Johnson
2012,Jamaal Tinsley,PG,33,57,141,0.40425531914893614,10,37,0.2702702702702703,47,104,0.4519230769230769,13,17,0.7647058823529411,6,39,45,123,17,8,52,47,137,2012_Jamaal Tinsley
2012,Jameer Nelson,PG,29,259,606,0.4273927392739274,87,231,0.37662337662337664,172,375,0.45866666666666667,71,88,0.8068181818181818,29,152,181,325,38,5,135,130,676,2012_Jameer Nelson
2012,Jeff Foster,C,35,9,18,0.5,1,1,1.0,8,17,0.47058823529411764,6,9,0.6666666666666666,18,24,42,4,8,1,7,26,25,2012_Jeff Foster
2012,Keyon Dooling,SG,31,66,163,0.4049079754601227,27,81,0.3333333333333333,39,82,0.47560975609756095,23,31,0.7419354838709677,3,36,39,51,13,2,34,57,182,2012_Keyon Dooling
2012,Mike Dunleavy,SF,31,239,504,0.4742063492063492,83,208,0.39903846153846156,156,296,0.527027027027027,116,143,0.8111888111888111,29,175,204,117,28,8,58,87,677,2012_Mike Dunleavy
2012,Nolan Smith,PG,23,67,180,0.37222222222222223,13,45,0.28888888888888886,54,135,0.4,20,28,0.7142857142857143,17,39,56,62,18,3,42,55,167,2012_Nolan Smith
2012,Ronnie Price,PG,28,49,130,0.3769230769230769,13,44,0.29545454545454547,36,86,0.4186046511627907,20,25,0.8,18,38,56,67,34,3,46,72,131,2012_Ronnie Price
2012,Samuel Dalembert,C,30,200,395,0.5063291139240507,0,1,0.0,200,394,0.5076142131979695,90,113,0.7964601769911505,158,298,456,33,37,111,82,162,490,2012_Samuel Dalembert
2012,Shane Battier,SF,33,113,292,0.386986301369863,62,183,0.33879781420765026,51,109,0.46788990825688076,23,37,0.6216216216216216,56,100,156,82,64,33,37,105,311,2012_Shane Battier
2012,Vernon Macklin,C,25,19,35,0.5428571428571428,0,0,NaN,19,35,0.5428571428571428,8,14,0.5714285714285714,14,20,34,5,4,4,3,9,46,2012_Vernon Macklin
2012,Von Wafer,SG,26,71,157,0.45222929936305734,14,39,0.358974358974359,57,118,0.4830508474576271,38,54,0.7037037037037037,6,39,45,29,10,3,35,26,194,2012_Von Wafer
2012,Wayne Ellington,SG,24,122,302,0.40397350993377484,35,108,0.32407407407407407,87,194,0.4484536082474227,32,40,0.8,14,85,99,33,26,10,26,56,311,2012_Wayne Ellington
2013,Alan Anderson,SF,30,236,616,0.38311688311688313,95,285,0.3333333333333333,141,331,0.4259818731117825,126,147,0.8571428571428571,34,114,148,103,48,7,80,131,693,2013_Alan Anderson
2013,Andris Biedrins,C,26,10,21,0.47619047619047616,0,0,NaN,10,21,0.47619047619047616,4,13,0.3076923076923077,34,119,153,14,15,42,14,101,24,2013_Andris Biedrins
2013,Charles Jenkins,SG-PG_SG_PG,23,98,242,0.4049586776859504,2,4,0.5,96,238,0.40336134453781514,24,44,0.5454545454545454,16,48,64,88,30,4,42,44,222,2013_Charles Jenkins
2013,Chris Johnson,C,27,48,75,0.64,0,0,NaN,48,75,0.64,21,34,0.6176470588235294,20,40,60,8,7,28,13,49,117,2013_Chris Johnson
2013,David Lee,PF,29,602,1160,0.5189655172413793,0,4,0.0,602,1156,0.5207612456747405,255,320,0.796875,218,668,886,279,67,22,207,246,1459,2013_David Lee
2013,Jason Kidd,SG,39,152,409,0.37163814180929094,114,325,0.3507692307692308,38,84,0.4523809523809524,40,48,0.8333333333333334,50,273,323,249,125,25,76,125,458,2013_Jason Kidd
2013,Jimmy Butler,SF,23,239,512,0.466796875,40,105,0.38095238095238093,199,407,0.48894348894348894,187,233,0.8025751072961373,136,192,328,115,78,31,62,97,705,2013_Jimmy Butler
2013,Keyon Dooling,PG,32,10,21,0.47619047619047616,5,12,0.4166666666666667,5,9,0.5555555555555556,6,7,0.8571428571428571,0,1,1,8,1,0,5,8,31,2013_Keyon Dooling
2013,Malcolm Thomas,PF,24,10,20,0.5,0,0,NaN,10,20,0.5,10,16,0.625,10,22,32,8,4,4,6,16,30,2013_Malcolm Thomas
2013,Mike Dunleavy,SF,32,276,624,0.4423076923076923,128,299,0.4280936454849498,148,325,0.4553846153846154,105,128,0.8203125,31,260,291,145,39,35,90,135,785,2013_Mike Dunleavy
2013,Nolan Smith,PG,24,42,114,0.3684210526315789,6,28,0.21428571428571427,36,86,0.4186046511627907,20,28,0.7142857142857143,7,20,27,35,7,1,29,26,110,2013_Nolan Smith
2013,Shane Battier,SF,34,152,362,0.4198895027624309,136,316,0.43037974683544306,16,46,0.34782608695652173,32,38,0.8421052631578947,37,128,165,72,41,55,34,149,472,2013_Shane Battier
2013,Shelvin Mack,PG-SG_SG_PG,22,116,252,0.4603174603174603,36,98,0.3673469387755102,80,154,0.5194805194805194,18,32,0.5625,6,74,80,136,30,0,68,78,286,2013_Shelvin Mack
2013,Tyson Chandler,C,30,255,400,0.6375,0,0,NaN,255,400,0.6375,179,258,0.6937984496124031,269,434,703,62,42,75,87,188,689,2013_Tyson Chandler
2013,Wayne Ellington,SG,25,452,1058,0.42722117202268434,188,480,0.39166666666666666,264,578,0.45674740484429066,136,150,0.9066666666666666,50,282,332,208,90,6,114,162,1228,2013_Wayne Ellington
2014,Alan Anderson,SF,31,194,485,0.4,84,248,0.3387096774193548,110,237,0.4641350210970464,92,118,0.7796610169491526,40,135,175,81,48,11,62,147,564,2014_Alan Anderson
2014,Andris Biedrins,C,27,1,1,1.0,0,0,NaN,1,1,1.0,1,6,0.16666666666666666,2,15,17,0,0,0,2,6,3,2014_Andris Biedrins
2014,Cartier Martin,SF,29,222,528,0.42045454545454547,118,302,0.39072847682119205,104,226,0.46017699115044247,96,130,0.7384615384615385,26,194,220,66,54,14,68,142,658,2014_Cartier Martin
2014,Cody Zeller,C,21,172,404,0.42574257425742573,0,1,0.0,172,403,0.4267990074441687,146,200,0.73,118,235,353,92,40,41,87,170,490,2014_Cody Zeller
2014,Dante Cunningham,PF,26,236,509,0.4636542239685658,0,5,0.0,236,504,0.46825396825396826,38,67,0.5671641791044776,112,218,330,83,62,58,42,146,510,2014_Dante Cunningham
2014,Donatas Motiejunas,PF,23,131,296,0.44256756756756754,21,84,0.25,110,212,0.5188679245283019,58,96,0.6041666666666666,60,165,225,34,20,21,49,132,341,2014_Donatas Motiejunas
2014,Mike Dunleavy,SF,33,333,774,0.43023255813953487,123,324,0.37962962962962965,210,450,0.4666666666666667,140,164,0.8536585365853658,46,299,345,186,64,46,108,163,929,2014_Mike Dunleavy
2014,Shane Battier,SF,35,105,275,0.38181818181818183,73,210,0.3476190476190476,32,65,0.49230769230769234,15,23,0.6521739130434783,34,104,138,63,50,39,21,124,298,2014_Shane Battier
2014,Shaun Livingston,PG,28,235,487,0.48254620123203285,1,6,0.16666666666666666,234,481,0.4864864864864865,158,191,0.8272251308900523,67,179,246,245,93,31,105,172,629,2014_Shaun Livingston
2014,Wayne Ellington,SG,26,55,126,0.4365079365079365,25,59,0.423728813559322,30,67,0.44776119402985076,10,11,0.9090909090909091,8,35,43,19,16,2,11,33,145,2014_Wayne Ellington
2014,Wesley Johnson,SF,26,277,651,0.4254992319508449,100,271,0.36900369003690037,177,380,0.46578947368421053,61,77,0.7922077922077922,70,278,348,124,86,77,90,207,715,2014_Wesley Johnson
2015,Alan Anderson,SG,32,195,440,0.4431818181818182,73,210,0.3476190476190476,122,230,0.5304347826086957,82,101,0.8118811881188119,31,173,204,83,56,5,60,148,545,2015_Alan Anderson
2015,Andrew Nicholson,PF,25,83,190,0.4368421052631579,13,41,0.3170731707317073,70,149,0.4697986577181208,15,25,0.6,17,65,82,22,6,12,24,51,194,2015_Andrew Nicholson
2015,Cleanthony Early,SF,23,76,214,0.35514018691588783,22,84,0.2619047619047619,54,130,0.4153846153846154,36,48,0.75,22,75,97,36,24,12,40,57,210,2015_Cleanthony Early
2015,Cody Zeller,C,22,172,373,0.46112600536193027,1,1,1.0,171,372,0.4596774193548387,127,164,0.774390243902439,97,265,362,100,34,49,62,156,472,2015_Cody Zeller
2015,Derrick Williams,PF,23,217,485,0.44742268041237115,49,156,0.3141025641025641,168,329,0.5106382978723404,134,196,0.6836734693877551,41,161,202,50,34,4,56,67,617,2015_Derrick Williams
2015,Draymond Green,PF,24,339,765,0.44313725490196076,111,329,0.3373860182370821,228,436,0.5229357798165137,132,200,0.66,114,533,647,291,123,99,133,253,921,2015_Draymond Green
2015,Drew Gordon,PF,24,8,19,0.42105263157894735,0,3,0.0,8,16,0.5,1,2,0.5,7,11,18,2,1,0,8,7,17,2015_Drew Gordon
2015,Ed Davis,PF,25,282,469,0.6012793176972282,0,0,NaN,282,469,0.6012793176972282,92,189,0.48677248677248675,230,370,600,94,49,98,58,202,656,2015_Ed Davis
2015,Gerald Wallace,SF,32,14,34,0.4117647058823529,1,3,0.3333333333333333,13,31,0.41935483870967744,6,15,0.4,17,40,57,11,15,4,18,19,35,2015_Gerald Wallace
2015,Jason Richardson,SG,34,62,178,0.34831460674157305,31,96,0.3229166666666667,31,82,0.3780487804878049,17,22,0.7727272727272727,13,53,66,38,13,3,16,28,172,2015_Jason Richardson
2015,Kirk Hinrich,SG,34,142,381,0.37270341207349084,58,168,0.34523809523809523,84,213,0.39436619718309857,35,50,0.7,20,101,121,148,46,14,73,144,377,2015_Kirk Hinrich
2015,Lester Hudson,SG,30,6,14,0.42857142857142855,3,6,0.5,3,8,0.375,3,4,0.75,1,7,8,5,6,1,3,4,18,2015_Lester Hudson
2015,Mario Chalmers,PG,28,267,663,0.40271493212669685,73,248,0.29435483870967744,194,415,0.4674698795180723,206,266,0.7744360902255639,24,182,206,307,122,10,173,251,813,2015_Mario Chalmers
2015,Mike Dunleavy,SF,34,209,481,0.43451143451143454,107,263,0.4068441064638783,102,218,0.46788990825688076,70,87,0.8045977011494253,28,220,248,114,39,21,60,123,595,2015_Mike Dunleavy
2015,Sim Bhullar,C,22,1,2,0.5,0,0,NaN,1,2,0.5,0,0,NaN,0,1,1,1,0,1,0,0,2,2015_Sim Bhullar
2015,Wayne Ellington,SG,27,254,617,0.41166936790923825,90,243,0.37037037037037035,164,374,0.4385026737967914,52,64,0.8125,31,179,210,105,33,2,50,77,650,2015_Wayne Ellington
2016,Alan Anderson,SG,33,21,59,0.3559322033898305,12,37,0.32432432432432434,9,22,0.4090909090909091,11,15,0.7333333333333333,1,26,27,14,4,1,2,25,65,2016_Alan Anderson
2016,Alonzo Gee,SF,28,132,255,0.5176470588235295,17,60,0.2833333333333333,115,195,0.5897435897435898,44,66,0.6666666666666666,60,185,245,72,63,13,55,169,325,2016_Alonzo Gee
2016,Cody Zeller,C,23,231,437,0.528604118993135,1,10,0.1,230,427,0.5386416861826698,175,232,0.7543103448275862,138,317,455,71,57,63,68,204,638,2016_Cody Zeller
2016,Dewayne Dedmon,C,26,99,177,0.559322033898305,0,0,NaN,99,177,0.559322033898305,57,76,0.75,67,161,228,13,22,46,32,109,255,2016_Dewayne Dedmon
2016,Josh Smith,PF,30,254,698,0.3638968481375358,82,286,0.2867132867132867,172,412,0.4174757281553398,74,134,0.5522388059701493,102,282,384,180,68,94,154,236,664,2016_Josh Smith
2016,Kevin Durant,SF,27,698,1381,0.5054308472121651,186,481,0.3866943866943867,512,900,0.5688888888888889,447,498,0.8975903614457831,45,544,589,361,69,85,250,137,2029,2016_Kevin Durant
2016,Mike Dunleavy,SF,35,77,188,0.4095744680851064,39,99,0.3939393939393939,38,89,0.42696629213483145,29,37,0.7837837837837838,8,75,83,39,14,10,26,66,222,2016_Mike Dunleavy
2016,Nikola Vucevic,C,25,533,1046,0.5095602294455067,2,9,0.2222222222222222,531,1037,0.5120540019286403,113,150,0.7533333333333333,174,402,576,179,53,70,123,173,1181,2016_Nikola Vucevic
2016,Ray McCallum,PG,24,110,292,0.3767123287671233,30,84,0.35714285714285715,80,208,0.38461538461538464,24,30,0.8,16,78,94,120,24,14,48,58,274,2016_Ray McCallum
2016,T.J. McConnell,PG,23,218,464,0.4698275862068966,31,89,0.34831460674157305,187,375,0.49866666666666665,26,41,0.6341463414634146,43,207,250,367,95,10,140,114,493,2016_T.J. McConnell
2016,Tim Hardaway,SG,23,114,265,0.43018867924528303,48,142,0.3380281690140845,66,123,0.5365853658536586,50,56,0.8928571428571429,7,79,86,51,21,7,23,48,326,2016_Tim Hardaway
2016,Tyler Zeller,C,26,138,290,0.47586206896551725,0,0,NaN,138,290,0.47586206896551725,88,108,0.8148148148148148,62,116,178,29,10,22,46,97,364,2016_Tyler Zeller
2016,Wayne Ellington,SG,28,218,561,0.38859180035650626,96,268,0.3582089552238806,122,293,0.41638225255972694,54,63,0.8571428571428571,20,154,174,83,48,5,45,82,586,2016_Wayne Ellington
2017,Alan Anderson,SF,34,30,80,0.375,14,44,0.3181818181818182,16,36,0.4444444444444444,12,16,0.75,3,21,24,11,3,0,7,35,86,2017_Alan Anderson
2017,Alex Abrines,SG,23,134,341,0.39296187683284456,94,247,0.3805668016194332,40,94,0.425531914893617,44,49,0.8979591836734694,18,68,86,40,37,8,33,114,406,2017_Alex Abrines
2017,Andrew Harrison,PG,22,117,360,0.325,43,156,0.27564102564102566,74,204,0.3627450980392157,148,194,0.7628865979381443,23,113,136,198,54,20,85,194,425,2017_Andrew Harrison
2017,Aron Baynes,C,30,143,279,0.5125448028673835,0,0,NaN,143,279,0.5125448028673835,79,94,0.8404255319148937,111,222,333,32,17,39,50,166,365,2017_Aron Baynes
2017,Brandon Jennings,PG,27,384,1070,0.35887850467289717,158,504,0.3134920634920635,226,566,0.3992932862190813,228,304,0.75,58,334,392,790,140,10,256,232,1154,2017_Brandon Jennings
2017,Cody Zeller,PF,24,253,443,0.5711060948081265,0,1,0.0,253,442,0.5723981900452488,133,196,0.6785714285714286,135,270,405,99,62,58,65,189,639,2017_Cody Zeller
2017,Deron Williams,PG,32,526,1200,0.43833333333333335,170,468,0.36324786324786323,356,732,0.48633879781420764,180,218,0.8256880733944955,28,266,294,720,62,16,276,276,1402,2017_Deron Williams
2017,Greivis Vasquez,PG,30,2,8,0.25,1,3,0.3333333333333333,1,5,0.2,2,3,0.6666666666666666,0,2,2,5,1,1,1,6,7,2017_Greivis Vasquez
2017,Hassan Whiteside,C,27,542,973,0.5570400822199383,0,0,NaN,542,973,0.5570400822199383,225,358,0.6284916201117319,293,795,1088,57,56,161,154,226,1309,2017_Hassan Whiteside
2017,Jeff Green,PF,30,220,558,0.3942652329749104,53,193,0.27461139896373055,167,365,0.4575342465753425,145,168,0.8630952380952381,39,175,214,81,37,13,75,103,638,2017_Jeff Green
2017,Jordan McRae,SG,25,58,150,0.38666666666666666,18,51,0.35294117647058826,40,99,0.40404040404040403,27,34,0.7941176470588235,6,34,40,19,8,6,14,31,161,2017_Jordan McRae
2017,Jusuf Nurkic,C,22,542,1068,0.5074906367041199,0,2,0.0,542,1066,0.5084427767354597,240,420,0.5714285714285714,308,626,934,246,100,148,286,322,1324,2017_Jusuf Nurkic
2017,Lou Williams,SG,30,856,1996,0.4288577154308617,326,892,0.3654708520179372,530,1104,0.48007246376811596,804,914,0.8796498905908097,52,352,404,478,160,38,320,184,2842,2017_Lou Williams
2017,Malachi Richardson,SG,21,28,68,0.4117647058823529,8,28,0.2857142857142857,20,40,0.5,15,19,0.7894736842105263,3,20,23,11,5,1,8,23,79,2017_Malachi Richardson
2017,Mike Dunleavy,SF,36,186,440,0.42272727272727273,106,268,0.39552238805970147,80,172,0.46511627906976744,72,90,0.8,36,194,230,100,30,14,56,134,550,2017_Mike Dunleavy
2017,Randy Foye,SG,33,118,325,0.3630769230769231,67,203,0.33004926108374383,51,122,0.4180327868852459,54,63,0.8571428571428571,9,146,155,135,35,9,80,99,357,2017_Randy Foye
2017,Wayne Ellington,SG,29,231,555,0.41621621621621624,149,394,0.37817258883248733,82,161,0.5093167701863354,37,43,0.8604651162790697,18,115,133,70,35,4,30,70,648,2017_Wayne Ellington
2017,Wesley Matthews,SG,30,333,847,0.39315230224321135,174,479,0.36325678496868474,159,368,0.4320652173913043,146,179,0.8156424581005587,18,241,259,210,77,16,102,161,986,2017_Wesley Matthews
2003,Brent Barry,SG,31,264,577,0.45753899480069327,118,293,0.40273037542662116,146,284,0.5140845070422535,128,161,0.7950310559006211,48,253,301,384,113,15,142,199,774,2003_Brent Barry
2003,Charles Oakley,C,39,23,55,0.41818181818181815,0,0,NaN,23,55,0.41818181818181815,28,34,0.8235294117647058,37,70,107,40,13,6,21,90,74,2003_Charles Oakley
2003,Chris Webber,PF,29,661,1433,0.4612700628053036,5,21,0.23809523809523808,656,1412,0.46458923512747874,215,354,0.6073446327683616,160,544,704,364,106,88,215,204,1542,2003_Chris Webber
2003,Chris Wilcox,PF,20,73,140,0.5214285714285715,0,0,NaN,73,140,0.5214285714285715,25,50,0.5,32,72,104,21,7,12,26,65,171,2003_Chris Wilcox
2003,Damon Stoudamire,PG,29,156,415,0.3759036144578313,44,114,0.38596491228070173,112,301,0.37209302325581395,53,67,0.7910447761194029,40,115,155,204,39,6,82,67,409,2003_Damon Stoudamire
2003,Dirk Nowitzki,PF,24,690,1489,0.4633982538616521,148,390,0.37948717948717947,542,1099,0.4931756141947225,483,548,0.8813868613138686,81,710,791,239,111,82,152,206,2011,2003_Dirk Nowitzki
2003,Eddy Curry,C,20,335,573,0.5846422338568935,0,0,NaN,335,573,0.5846422338568935,179,287,0.6236933797909407,116,237,353,37,18,62,137,226,849,2003_Eddy Curry
2003,Elden Campbell,C,34,234,590,0.39661016949152544,0,2,0.0,234,588,0.3979591836734694,218,272,0.8014705882352942,94,268,362,102,66,78,100,258,686,2003_Elden Campbell
2003,Grant Long,PF,36,27,70,0.38571428571428573,0,3,0.0,27,67,0.40298507462686567,18,23,0.782608695652174,24,59,83,25,9,1,19,62,72,2003_Grant Long
2003,Ira Newble,SF,28,231,467,0.49464668094218417,32,84,0.38095238095238093,199,383,0.5195822454308094,70,90,0.7777777777777778,86,185,271,99,50,26,69,174,564,2003_Ira Newble
2003,Jumaine Jones,SF,23,308,710,0.43380281690140843,111,314,0.3535031847133758,197,396,0.49747474747474746,57,83,0.6867469879518072,106,299,405,112,67,22,107,176,784,2003_Jumaine Jones
2003,Morris Peterson,SF,25,421,1073,0.3923578751164958,116,344,0.3372093023255814,305,729,0.41838134430727025,195,247,0.7894736842105263,97,266,363,188,88,32,128,232,1153,2003_Morris Peterson
2003,Robert Pack,PG,33,52,129,0.40310077519379844,0,5,0.0,52,124,0.41935483870967744,41,55,0.7454545454545455,11,40,51,81,25,0,40,35,145,2003_Robert Pack
2003,Ronald Murray,SG,23,22,62,0.3548387096774194,0,10,0.0,22,52,0.4230769230769231,10,16,0.625,0,8,8,10,8,0,16,0,54,2003_Ronald Murray
2003,Ruben Patterson,SF,27,254,516,0.49224806201550386,3,20,0.15,251,496,0.5060483870967742,138,220,0.6272727272727273,120,144,264,101,73,29,117,161,649,2003_Ruben Patterson
2003,Trenton Hassell,SG,23,144,392,0.3673469387755102,13,40,0.325,131,352,0.3721590909090909,41,55,0.7454545454545455,37,218,255,151,45,61,83,197,342,2003_Trenton Hassell
2003,Zendon Hamilton,C,27,2,5,0.4,0,0,NaN,2,5,0.4,2,2,1.0,1,3,4,0,1,0,1,2,6,2003_Zendon Hamilton
2004,Brent Barry,SG,32,215,427,0.5035128805620609,114,252,0.4523809523809524,101,175,0.5771428571428572,91,110,0.8272727272727273,21,183,204,342,85,16,139,121,635,2004_Brent Barry
2004,Calvin Booth,C,27,135,290,0.46551724137931033,0,2,0.0,135,288,0.46875,75,94,0.7978723404255319,86,194,280,28,17,101,45,150,345,2004_Calvin Booth
2004,Chris Andersen,PF,25,90,203,0.4433497536945813,0,1,0.0,90,202,0.44554455445544555,63,107,0.5887850467289719,89,209,298,35,34,114,48,119,243,2004_Chris Andersen
2004,Darko Milicic,C,18,17,65,0.26153846153846155,0,1,0.0,17,64,0.265625,14,24,0.5833333333333334,11,32,43,7,7,15,13,33,48,2004_Darko Milicic
2004,Dirk Nowitzki,C,25,605,1310,0.4618320610687023,99,290,0.3413793103448276,506,1020,0.49607843137254903,371,423,0.8770685579196218,90,580,670,207,92,104,135,216,1680,2004_Dirk Nowitzki
2004,Eddie Gill,PG,25,15,36,0.4166666666666667,3,8,0.375,12,28,0.42857142857142855,17,20,0.85,4,13,17,16,9,1,12,16,50,2004_Eddie Gill
2004,Jamal Crawford,SG,23,509,1318,0.38619119878603947,165,521,0.31669865642994244,344,797,0.4316185696361355,200,240,0.8333333333333334,46,237,283,405,111,29,193,161,1383,2004_Jamal Crawford
2004,Jelani McCoy,C,26,0,0,NaN,0,0,NaN,0,0,NaN,0,0,NaN,1,3,4,0,0,0,1,4,0,2004_Jelani McCoy
2004,Jumaine Jones,SG,24,33,96,0.34375,13,44,0.29545454545454547,20,52,0.38461538461538464,14,23,0.6086956521739131,24,44,68,14,12,9,19,48,93,2004_Jumaine Jones
2004,Kevin Willis,C,41,70,150,0.4666666666666667,0,1,0.0,70,149,0.4697986577181208,24,39,0.6153846153846154,37,61,98,11,21,9,32,61,164,2004_Kevin Willis
2004,Lamond Murray,SF,30,76,215,0.35348837209302325,21,60,0.35,55,155,0.3548387096774194,24,35,0.6857142857142857,14,76,90,28,15,7,38,47,197,2004_Lamond Murray
2004,Morris Peterson,SF,26,238,587,0.40545144804088584,126,340,0.37058823529411766,112,247,0.4534412955465587,76,94,0.8085106382978723,35,226,261,113,88,14,69,206,678,2004_Morris Peterson
2004,Robert Pack,PG,34,22,52,0.4230769230769231,0,0,NaN,22,52,0.4230769230769231,5,6,0.8333333333333334,4,14,18,27,12,1,16,20,49,2004_Robert Pack
2004,Ronald Murray,PG,24,389,915,0.42513661202185793,67,229,0.2925764192139738,322,686,0.46938775510204084,168,235,0.7148936170212766,45,159,204,205,81,28,149,158,1013,2004_Ronald Murray
2004,Ruben Patterson,SF,28,200,395,0.5063291139240507,2,12,0.16666666666666666,198,383,0.5169712793733682,105,190,0.5526315789473685,129,139,268,139,84,21,105,152,507,2004_Ruben Patterson
2004,Trenton Hassell,SG,24,177,381,0.4645669291338583,4,13,0.3076923076923077,173,368,0.4701086956521739,48,61,0.7868852459016393,68,189,257,133,36,54,46,200,406,2004_Trenton Hassell
2004,Zendon Hamilton,C,28,51,95,0.5368421052631579,0,0,NaN,51,95,0.5368421052631579,67,96,0.6979166666666666,49,97,146,13,8,8,27,74,169,2004_Zendon Hamilton
2005,Aaron Williams,C,33,58,126,0.4603174603174603,0,0,NaN,58,126,0.4603174603174603,30,34,0.8823529411764706,34,86,120,16,10,16,34,140,146,2005_Aaron Williams
2005,Ben Handlogten,C,31,43,83,0.5180722891566265,0,1,0.0,43,82,0.524390243902439,9,17,0.5294117647058824,23,42,65,13,7,5,18,55,95,2005_Ben Handlogten
2005,Brent Barry,SG,33,194,459,0.4226579520697168,100,280,0.35714285714285715,94,179,0.5251396648044693,113,135,0.837037037037037,29,161,190,178,39,20,64,123,601,2005_Brent Barry
2005,Darko Milicic,C,19,25,76,0.32894736842105265,0,0,NaN,25,76,0.32894736842105265,17,24,0.7083333333333334,3,40,43,7,2,17,16,31,67,2005_Darko Milicic
2005,Dirk Nowitzki,PF,26,663,1445,0.4588235294117647,91,228,0.3991228070175439,572,1217,0.47000821692686934,615,708,0.8686440677966102,96,661,757,240,97,119,176,219,2032,2005_Dirk Nowitzki
2005,Earl Boykins,PG,28,340,824,0.41262135922330095,56,166,0.3373493975903614,284,658,0.4316109422492401,279,303,0.9207920792079208,37,106,143,372,78,12,121,122,1015,2005_Earl Boykins
2005,Fred Jones,SG,25,275,647,0.4250386398763524,87,229,0.3799126637554585,188,418,0.44976076555023925,176,207,0.8502415458937198,34,208,242,196,61,31,114,171,813,2005_Fred Jones
2005,Jackie Butler,C,19,4,4,1.0,0,0,NaN,4,4,1.0,2,2,1.0,0,0,0,0,1,0,1,0,10,2005_Jackie Butler
2005,Jumaine Jones,SF,25,210,486,0.43209876543209874,102,261,0.39080459770114945,108,225,0.48,55,75,0.7333333333333333,107,291,398,65,44,24,49,165,577,2005_Jumaine Jones
2005,Lamond Murray,SF,31,132,310,0.4258064516129032,46,105,0.4380952380952381,86,205,0.4195121951219512,61,80,0.7625,44,120,164,47,32,16,54,85,371,2005_Lamond Murray
2005,Moochie Norris,PG,31,70,218,0.3211009174311927,0,24,0.0,70,194,0.36082474226804123,40,48,0.8333333333333334,20,72,92,78,36,4,54,88,180,2005_Moochie Norris
2005,Morris Peterson,SG,27,356,848,0.419811320754717,129,335,0.3850746268656716,227,513,0.442495126705653,188,226,0.831858407079646,71,269,340,169,91,18,93,219,1029,2005_Morris Peterson
2005,Rod Strickland,PG,38,9,43,0.20930232558139536,1,2,0.5,8,41,0.1951219512195122,9,10,0.9,3,24,27,39,3,2,16,15,28,2005_Rod Strickland
2005,Ron Mercer,SF,28,65,158,0.41139240506329117,0,3,0.0,65,155,0.41935483870967744,7,10,0.7,9,31,40,20,16,2,14,20,137,2005_Ron Mercer
2005,Ronald Murray,SG,25,131,363,0.3608815426997245,24,95,0.25263157894736843,107,268,0.39925373134328357,59,80,0.7375,15,83,98,65,30,11,57,59,345,2005_Ronald Murray
2005,Ruben Patterson,SF,29,319,601,0.5307820299500832,2,25,0.08,317,576,0.5503472222222222,169,282,0.599290780141844,126,147,273,138,106,21,143,164,809,2005_Ruben Patterson
2005,Tony Bobbitt,SG,25,2,5,0.4,1,2,0.5,1,3,0.3333333333333333,0,0,NaN,0,3,3,0,0,0,0,1,5,2005_Tony Bobbitt
2005,Trenton Hassell,SG,25,225,475,0.47368421052631576,1,11,0.09090909090909091,224,464,0.4827586206896552,90,114,0.7894736842105263,80,139,219,128,30,30,64,200,541,2005_Trenton Hassell
2005,Zendon Hamilton,C,29,11,32,0.34375,0,0,NaN,11,32,0.34375,29,48,0.6041666666666666,18,24,42,6,5,2,12,26,51,2005_Zendon Hamilton
2006,Andre Iguodala,SF,22,344,688,0.5,56,158,0.35443037974683544,288,530,0.5433962264150943,263,349,0.7535816618911175,117,364,481,255,135,21,153,198,1007,2006_Andre Iguodala
2006,Brent Barry,SG,34,156,345,0.45217391304347826,80,202,0.39603960396039606,76,143,0.5314685314685315,39,59,0.6610169491525424,29,130,159,123,39,27,52,99,431,2006_Brent Barry
2006,Dirk Nowitzki,PF,27,751,1564,0.48017902813299235,110,271,0.4059040590405904,641,1293,0.4957463263727765,539,598,0.9013377926421404,115,613,728,226,58,83,156,164,2151,2006_Dirk Nowitzki
2006,Donyell Marshall,PF,32,265,671,0.3949329359165425,128,395,0.3240506329113924,137,276,0.4963768115942029,92,123,0.7479674796747967,105,387,492,60,59,41,90,160,750,2006_Donyell Marshall
2006,Jumaine Jones,PF,26,298,736,0.4048913043478261,115,335,0.34328358208955223,183,401,0.456359102244389,88,121,0.7272727272727273,105,271,376,63,68,22,74,200,799,2006_Jumaine Jones
2006,Lamond Murray,SF,32,72,181,0.39779005524861877,27,78,0.34615384615384615,45,103,0.4368932038834951,25,40,0.625,29,103,132,13,17,7,22,66,196,2006_Lamond Murray
2006,Morris Peterson,SG,28,478,1096,0.43613138686131386,177,448,0.3950892857142857,301,648,0.4645061728395062,241,294,0.8197278911564626,65,316,381,190,104,15,126,223,1374,2006_Morris Peterson
2006,Rafer Alston,PG,29,280,738,0.3794037940379404,102,312,0.3269230769230769,178,426,0.41784037558685444,99,143,0.6923076923076923,36,219,255,425,101,15,157,194,761,2006_Rafer Alston
2006,Richard Hamilton,SG,27,649,1322,0.4909228441754917,55,120,0.4583333333333333,594,1202,0.49417637271214643,256,303,0.8448844884488449,84,172,256,275,52,16,173,207,1609,2006_Richard Hamilton
2006,Ronald Murray,SG,26,642,1536,0.41796875,74,282,0.2624113475177305,568,1254,0.4529505582137161,344,484,0.7107438016528925,66,240,306,394,136,22,270,266,1702,2006_Ronald Murray
2006,Ronny Turiaf,C,23,15,30,0.5,0,0,NaN,15,30,0.5,15,27,0.5555555555555556,11,26,37,8,3,10,7,30,45,2006_Ronny Turiaf
2006,Speedy Claxton,PG,27,304,736,0.41304347826086957,17,63,0.2698412698412698,287,673,0.4264487369985141,246,320,0.76875,39,154,193,339,108,6,154,177,871,2006_Speedy Claxton
2006,Trenton Hassell,SG,26,286,616,0.4642857142857143,7,23,0.30434782608695654,279,593,0.47048903878583476,131,176,0.7443181818181818,82,134,216,203,43,29,124,201,710,2006_Trenton Hassell
2006,Will Bynum,PG,23,21,52,0.40384615384615385,2,9,0.2222222222222222,19,43,0.4418604651162791,10,16,0.625,3,9,12,19,7,0,14,10,54,2006_Will Bynum
2007,Alvin Williams,PG,32,0,2,0.0,0,1,0.0,0,1,0.0,2,4,0.5,1,0,1,3,2,0,3,0,2,2007_Alvin Williams
2007,Antoine Walker,PF,30,265,668,0.3967065868263473,84,305,0.2754098360655738,181,363,0.4986225895316804,46,105,0.4380952380952381,92,247,339,130,48,17,141,173,660,2007_Antoine Walker
2007,Brent Barry,SG,35,202,425,0.4752941176470588,128,287,0.445993031358885,74,138,0.5362318840579711,103,117,0.8803418803418803,17,143,160,138,56,12,61,88,635,2007_Brent Barry
2007,Caron Butler,SF,26,451,975,0.4625641025641026,18,72,0.25,433,903,0.4795127353266888,283,328,0.8628048780487805,147,320,467,233,134,17,181,188,1203,2007_Caron Butler
2007,Dirk Nowitzki,PF,28,673,1341,0.5018642803877703,72,173,0.4161849710982659,601,1168,0.514554794520548,498,551,0.9038112522686026,122,571,693,263,52,62,167,171,1916,2007_Dirk Nowitzki
2007,Jumaine Jones,SF,27,14,51,0.27450980392156865,10,32,0.3125,4,19,0.21052631578947367,2,2,1.0,6,17,23,1,5,1,7,19,40,2007_Jumaine Jones
2007,Kevin Garnett,PF,30,638,1341,0.47576435495898584,12,56,0.21428571428571427,626,1285,0.48715953307392995,416,498,0.8353413654618473,183,792,975,313,89,126,205,184,1704,2007_Kevin Garnett
2007,Martell Webster,SF,20,195,492,0.39634146341463417,91,250,0.364,104,242,0.4297520661157025,93,132,0.7045454545454546,43,197,240,52,35,19,76,126,574,2007_Martell Webster
2007,Matt Carroll,SG,26,285,658,0.4331306990881459,111,267,0.4157303370786517,174,391,0.44501278772378516,188,208,0.9038461538461539,35,172,207,91,53,9,73,176,869,2007_Matt Carroll
2007,Morris Peterson,SF,29,222,517,0.42940038684719534,106,295,0.3593220338983051,116,222,0.5225225225225225,84,123,0.6829268292682927,32,205,237,47,45,12,53,126,634,2007_Morris Peterson
2007,Randolph Morris,C,21,1,6,0.16666666666666666,0,0,NaN,1,6,0.16666666666666666,2,6,0.3333333333333333,1,8,9,1,2,1,2,4,4,2007_Randolph Morris
2007,Rodney Carney,SF,22,182,392,0.4642857142857143,25,72,0.3472222222222222,157,320,0.490625,53,87,0.6091954022988506,39,89,128,26,38,23,43,118,442,2007_Rodney Carney
2007,Ronald Murray,SG,27,177,438,0.4041095890410959,24,83,0.2891566265060241,153,355,0.4309859154929577,87,120,0.725,26,87,113,187,49,13,90,96,465,2007_Ronald Murray
2007,Ronnie Price,PG,23,67,172,0.38953488372093026,21,65,0.3230769230769231,46,107,0.42990654205607476,37,55,0.6727272727272727,15,56,71,48,28,4,33,64,192,2007_Ronnie Price
2007,Scott Padgett,PF,30,32,112,0.2857142857142857,16,66,0.24242424242424243,16,46,0.34782608695652173,12,26,0.46153846153846156,32,76,108,16,10,6,18,70,92,2007_Scott Padgett
2007,Shareef Abdur-Rahim,C,30,310,654,0.4740061162079511,3,20,0.15,307,634,0.4842271293375394,170,234,0.7264957264957265,122,276,398,109,53,40,116,243,793,2007_Shareef Abdur-Rahim
2007,Shawn Marion,SF,28,561,1071,0.5238095238095238,80,252,0.31746031746031744,481,819,0.5873015873015873,201,248,0.8104838709677419,172,613,785,134,156,122,114,216,1403,2007_Shawn Marion
2007,Stromile Swift,C,27,161,346,0.4653179190751445,0,5,0.0,161,341,0.47214076246334313,97,134,0.7238805970149254,85,165,250,17,30,62,69,146,419,2007_Stromile Swift
2007,Trenton Hassell,SG,27,217,443,0.4898419864559819,6,25,0.24,211,418,0.5047846889952153,72,92,0.782608695652174,83,160,243,203,22,26,80,144,512,2007_Trenton Hassell
2008,Alando Tucker,SF,23,8,22,0.36363636363636365,1,4,0.25,7,18,0.3888888888888889,5,6,0.8333333333333334,4,4,8,0,0,1,0,2,22,2008_Alando Tucker
2008,Brent Barry,SF,36,77,160,0.48125,48,112,0.42857142857142855,29,48,0.6041666666666666,19,20,0.95,12,43,55,54,17,3,18,43,221,2008_Brent Barry
2008,Dirk Nowitzki,PF,29,630,1314,0.4794520547945205,79,220,0.35909090909090907,551,1094,0.5036563071297989,478,544,0.8786764705882353,95,564,659,266,51,71,160,198,1817,2008_Dirk Nowitzki
2008,Jared Jeffries,SF,26,108,270,0.4,4,25,0.16,104,245,0.42448979591836733,49,93,0.5268817204301075,118,125,243,66,36,23,64,132,269,2008_Jared Jeffries
2008,Jason Kidd,PG,34,610,1586,0.38461538461538464,238,624,0.3814102564102564,372,962,0.3866943866943867,270,330,0.8181818181818182,188,1012,1200,1612,272,52,532,330,1728,2008_Jason Kidd
2008,Joel Anthony,PF,25,28,60,0.4666666666666667,0,0,NaN,28,60,0.4666666666666667,29,49,0.5918367346938775,38,55,93,3,9,31,17,55,85,2008_Joel Anthony
2008,Julian Wright,SF,20,90,169,0.5325443786982249,10,24,0.4166666666666667,80,145,0.5517241379310345,33,52,0.6346153846153846,33,84,117,40,29,12,34,43,223,2008_Julian Wright
2008,Kevin Garnett,PF,31,534,990,0.5393939393939394,0,11,0.0,534,979,0.5454545454545454,269,336,0.8005952380952381,135,520,655,244,100,89,138,163,1337,2008_Kevin Garnett
2008,Luis Scola,PF,27,345,670,0.5149253731343284,0,3,0.0,345,667,0.5172413793103449,157,235,0.6680851063829787,174,351,525,106,60,19,105,235,847,2008_Luis Scola
2008,Marcin Gortat,C,23,8,17,0.47058823529411764,0,0,NaN,8,17,0.47058823529411764,2,3,0.6666666666666666,8,8,16,2,1,1,2,4,18,2008_Marcin Gortat
2008,Martell Webster,SF,21,277,656,0.4222560975609756,123,317,0.38801261829652994,154,339,0.45427728613569324,122,166,0.7349397590361446,54,242,296,90,42,28,83,159,799,2008_Martell Webster
2008,Michael Doleac,C,30,28,63,0.4444444444444444,0,0,NaN,28,63,0.4444444444444444,1,2,0.5,16,33,49,7,10,10,12,44,57,2008_Michael Doleac
2008,Nazr Mohammed,C,30,544,1056,0.5151515151515151,0,2,0.0,544,1054,0.5161290322580645,190,326,0.5828220858895705,388,600,988,144,90,120,202,460,1278,2008_Nazr Mohammed
2008,Randolph Morris,C,22,21,58,0.3620689655172414,0,0,NaN,21,58,0.3620689655172414,14,29,0.4827586206896552,12,25,37,2,4,2,9,37,56,2008_Randolph Morris
2008,Rodney Carney,SF,23,158,392,0.4030612244897959,38,120,0.31666666666666665,120,272,0.4411764705882353,55,81,0.6790123456790124,50,99,149,32,39,23,34,96,409,2008_Rodney Carney
2008,Ronald Murray,PG,28,308,734,0.4196185286103542,40,126,0.31746031746031744,268,608,0.4407894736842105,136,196,0.6938775510204082,46,120,166,288,76,8,168,100,792,2008_Ronald Murray
2008,Sean Williams,C,21,164,305,0.5377049180327869,0,0,NaN,164,305,0.5377049180327869,81,133,0.6090225563909775,115,207,322,28,28,106,70,193,409,2008_Sean Williams
2008,Shareef Abdur-Rahim,PF,31,3,14,0.21428571428571427,0,0,NaN,3,14,0.21428571428571427,4,4,1.0,6,4,10,4,1,0,1,9,10,2008_Shareef Abdur-Rahim
2008,Trenton Hassell,SG,28,114,270,0.4222222222222222,4,18,0.2222222222222222,110,252,0.4365079365079365,14,20,0.7,40,126,166,82,26,6,44,180,246,2008_Trenton Hassell
2009,Alando Tucker,SG,24,52,121,0.4297520661157025,8,23,0.34782608695652173,44,98,0.4489795918367347,26,33,0.7878787878787878,19,12,31,12,5,1,14,14,138,2009_Alando Tucker
2009,Brent Barry,SG,37,70,172,0.4069767441860465,49,131,0.37404580152671757,21,41,0.5121951219512195,19,20,0.95,17,77,94,78,24,3,48,45,208,2009_Brent Barry
2009,Cartier Martin,SF,24,28,77,0.36363636363636365,10,33,0.30303030303030304,18,44,0.4090909090909091,20,25,0.8,7,26,33,13,8,4,9,33,86,2009_Cartier Martin
2009,Chris Mihm,C,29,15,40,0.375,0,0,NaN,15,40,0.375,6,7,0.8571428571428571,15,19,34,10,1,6,10,23,36,2009_Chris Mihm
2009,Jason Hart,PG,30,60,188,0.3191489361702128,0,12,0.0,60,176,0.3409090909090909,36,46,0.782608695652174,26,66,92,96,24,8,44,78,156,2009_Jason Hart
2009,Julian Wright,SF,21,109,234,0.4658119658119658,2,21,0.09523809523809523,107,213,0.5023474178403756,17,30,0.5666666666666667,46,106,152,43,35,19,43,49,237,2009_Julian Wright
2009,Keith Bogans,SG,28,238,648,0.36728395061728397,148,436,0.3394495412844037,90,212,0.42452830188679247,104,114,0.9122807017543859,62,342,404,128,86,8,82,210,728,2009_Keith Bogans
2009,Kelenna Azubuike,SF,25,392,845,0.463905325443787,94,210,0.44761904761904764,298,635,0.4692913385826772,185,229,0.8078602620087336,112,258,370,117,57,50,95,183,1063,2009_Kelenna Azubuike
2009,Kevin Garnett,PF,32,393,740,0.5310810810810811,2,8,0.25,391,732,0.5341530054644809,111,132,0.8409090909090909,78,407,485,144,63,68,90,128,899,2009_Kevin Garnett
2009,Lamar Odom,PF,29,346,703,0.492176386913229,33,103,0.32038834951456313,313,600,0.5216666666666666,160,257,0.622568093385214,176,461,637,204,77,98,138,235,885,2009_Lamar Odom
2009,Linton Johnson,PF,28,8,22,0.36363636363636365,2,4,0.5,6,18,0.3333333333333333,0,0,NaN,6,10,16,4,2,0,4,14,18,2009_Linton Johnson
2009,Marcin Gortat,PF,24,106,187,0.5668449197860963,1,1,1.0,105,186,0.5645161290322581,26,45,0.5777777777777777,96,190,286,14,18,53,25,111,239,2009_Marcin Gortat
2009,Martell Webster,SF,22,0,1,0.0,0,1,0.0,0,0,NaN,0,0,NaN,0,0,0,0,0,0,0,0,0,2009_Martell Webster
2009,Nazr Mohammed,C,31,41,101,0.40594059405940597,0,0,NaN,41,101,0.40594059405940597,22,40,0.55,35,44,79,8,5,16,23,63,104,2009_Nazr Mohammed
2009,Randolph Morris,C,23,7,17,0.4117647058823529,0,0,NaN,7,17,0.4117647058823529,4,4,1.0,4,16,20,2,2,1,7,25,18,2009_Randolph Morris
2009,Rodney Carney,SG,24,176,423,0.4160756501182033,79,226,0.3495575221238938,97,197,0.49238578680203043,50,66,0.7575757575757576,36,90,126,26,45,29,43,94,481,2009_Rodney Carney
2009,Ronald Murray,SG,29,355,795,0.44654088050314467,87,242,0.359504132231405,268,553,0.484629294755877,177,233,0.759656652360515,22,146,168,158,88,17,128,173,974,2009_Ronald Murray
2009,Ryan Gomes,SF,26,420,974,0.43121149897330596,106,285,0.3719298245614035,314,689,0.45573294629898403,146,181,0.8066298342541437,106,286,392,135,63,22,128,183,1092,2009_Ryan Gomes
2009,Sean Williams,PF,22,30,72,0.4166666666666667,0,0,NaN,30,72,0.4166666666666667,20,32,0.625,34,45,79,13,7,29,20,72,80,2009_Sean Williams
2009,Shaun Livingston,PG,23,62,120,0.5166666666666667,0,0,NaN,62,120,0.5166666666666667,18,20,0.9,6,50,56,40,14,4,18,24,142,2009_Shaun Livingston
2009,Trenton Hassell,SF,29,86,191,0.450261780104712,2,8,0.25,84,183,0.45901639344262296,20,25,0.8,50,96,146,51,21,16,30,92,194,2009_Trenton Hassell
2010,A.J. Price,PG,23,145,354,0.4096045197740113,60,174,0.3448275862068966,85,180,0.4722222222222222,60,75,0.8,12,76,88,106,35,3,59,53,410,2010_A.J. Price
2010,Chris Douglas-Roberts,SF,23,255,573,0.44502617801047123,14,54,0.25925925925925924,241,519,0.464354527938343,133,157,0.8471337579617835,45,153,198,93,55,19,97,101,657,2010_Chris Douglas-Roberts
2010,DaJuan Summers,SF,22,46,130,0.35384615384615387,15,42,0.35714285714285715,31,88,0.3522727272727273,27,38,0.7105263157894737,14,31,45,16,8,7,16,52,134,2010_DaJuan Summers
2010,Darko Milicic,C,24,200,408,0.49019607843137253,0,2,0.0,200,406,0.49261083743842365,30,56,0.5357142857142857,94,208,302,94,44,68,70,164,430,2010_Darko Milicic
2010,Dirk Nowitzki,PF,31,720,1496,0.48128342245989303,51,121,0.4214876033057851,669,1375,0.48654545454545456,536,586,0.9146757679180887,80,540,620,218,70,79,149,208,2027,2010_Dirk Nowitzki
2010,Gerald Wallace,SF,27,456,943,0.4835630965005302,52,140,0.37142857142857144,404,803,0.5031133250311333,422,544,0.7757352941176471,150,612,762,161,117,83,178,194,1386,2010_Gerald Wallace
2010,Jason Richardson,SG,29,473,998,0.47394789579158314,157,400,0.3925,316,598,0.5284280936454849,136,184,0.7391304347826086,81,323,404,143,66,33,92,169,1239,2010_Jason Richardson
2010,Kirk Hinrich,SG,29,308,753,0.40903054448871184,104,280,0.37142857142857144,204,473,0.4312896405919662,85,113,0.7522123893805309,24,236,260,330,85,24,113,204,805,2010_Kirk Hinrich
2010,Marco Belinelli,SG,23,154,379,0.40633245382585753,60,158,0.379746835443038,94,221,0.4253393665158371,101,121,0.8347107438016529,14,81,95,89,42,5,60,80,469,2010_Marco Belinelli
2010,Marreese Speights,C,22,212,444,0.4774774774774775,0,5,0.0,212,439,0.48291571753986334,108,145,0.7448275862068966,85,167,252,36,29,34,51,152,532,2010_Marreese Speights
2010,Mike James,PG,34,6,20,0.3,2,6,0.3333333333333333,4,14,0.2857142857142857,4,8,0.5,1,2,3,5,3,0,5,3,18,2010_Mike James
2010,Morris Peterson,SG,32,116,301,0.3853820598006645,62,171,0.36257309941520466,54,130,0.4153846153846154,33,54,0.6111111111111112,17,109,126,41,25,5,27,81,327,2010_Morris Peterson
2010,Nick Young,SG,24,233,558,0.4175627240143369,69,170,0.40588235294117647,164,388,0.422680412371134,104,130,0.8,20,82,102,48,28,8,56,147,639,2010_Nick Young
2010,Ronald Murray,SG,30,536,1366,0.3923865300146413,138,442,0.31221719457013575,398,924,0.43073593073593075,282,388,0.7268041237113402,56,310,366,270,92,32,182,252,1492,2010_Ronald Murray
2010,Ryan Anderson,PF,21,169,388,0.43556701030927836,78,211,0.3696682464454976,91,177,0.5141242937853108,71,82,0.8658536585365854,70,132,202,37,25,14,56,81,487,2010_Ryan Anderson
2010,Trenton Hassell,SF,30,90,219,0.410958904109589,0,5,0.0,90,214,0.4205607476635514,52,69,0.7536231884057971,56,96,152,50,17,9,47,91,232,2010_Trenton Hassell
2010,Udonis Haslem,PF,29,312,632,0.4936708860759494,0,0,NaN,312,632,0.4936708860759494,147,193,0.7616580310880829,167,462,629,52,30,23,75,174,771,2010_Udonis Haslem
2010,Zydrunas Ilgauskas,C,34,194,438,0.4429223744292237,11,23,0.4782608695652174,183,415,0.44096385542168676,75,101,0.7425742574257426,114,231,345,48,14,50,63,183,474,2010_Zydrunas Ilgauskas
2011,Brian Cardinal,SF,33,43,100,0.43,42,87,0.4827586206896552,1,13,0.07692307692307693,17,18,0.9444444444444444,10,49,59,40,24,7,17,82,145,2011_Brian Cardinal
2011,Chris Douglas-Roberts,SF,24,117,273,0.42857142857142855,15,46,0.32608695652173914,102,227,0.44933920704845814,74,89,0.8314606741573034,7,81,88,50,29,13,35,73,323,2011_Chris Douglas-Roberts
2011,Cole Aldrich,C,22,8,15,0.5333333333333333,0,0,NaN,8,15,0.5333333333333333,2,4,0.5,13,22,35,4,5,7,8,30,18,2011_Cole Aldrich
2011,Darko Milicic,C,25,271,578,0.4688581314878893,0,0,NaN,271,578,0.4688581314878893,64,115,0.5565217391304348,133,227,360,104,54,140,151,229,606,2011_Darko Milicic
2011,Darrell Arthur,PF,22,310,624,0.4967948717948718,0,6,0.0,310,618,0.5016181229773463,109,134,0.8134328358208955,115,227,342,53,52,63,88,228,729,2011_Darrell Arthur
2011,DeJuan Blair,PF,21,292,583,0.5008576329331046,0,2,0.0,292,581,0.5025817555938038,90,137,0.656934306569343,215,350,565,77,95,42,113,213,674,2011_DeJuan Blair
2011,Dirk Nowitzki,PF,32,610,1179,0.5173876166242578,66,168,0.39285714285714285,544,1011,0.5380811078140455,395,443,0.891647855530474,50,463,513,190,38,47,137,172,1681,2011_Dirk Nowitzki
2011,Josh Smith,PF,25,497,1041,0.47742555235350626,51,154,0.33116883116883117,446,887,0.5028184892897407,229,316,0.7246835443037974,134,523,657,255,99,120,197,217,1274,2011_Josh Smith
2011,Marco Belinelli,SG,24,302,691,0.4370477568740955,134,324,0.41358024691358025,168,367,0.45776566757493187,98,125,0.784,17,134,151,92,38,6,77,146,836,2011_Marco Belinelli
2011,Marreese Speights,C,23,144,291,0.4948453608247423,1,4,0.25,143,287,0.49825783972125437,55,73,0.7534246575342466,64,146,210,30,8,19,40,120,344,2011_Marreese Speights
2011,Melvin Ely,C,32,28,51,0.5490196078431373,0,0,NaN,28,51,0.5490196078431373,13,21,0.6190476190476191,27,47,74,14,4,11,14,50,69,2011_Melvin Ely
2011,Morris Peterson,SG,33,2,5,0.4,0,1,0.0,2,4,0.5,0,0,NaN,0,3,3,1,0,0,0,5,4,2011_Morris Peterson
2011,Ryan Anderson,PF,22,226,525,0.43047619047619046,134,341,0.39296187683284456,92,184,0.5,95,117,0.811965811965812,129,226,355,52,30,38,49,137,681,2011_Ryan Anderson
2011,Shelden Williams,PF,27,206,440,0.4681818181818182,0,0,NaN,206,440,0.4681818181818182,116,150,0.7733333333333333,186,360,546,64,46,52,86,252,528,2011_Shelden Williams
2011,Tim Duncan,C,34,419,838,0.5,0,4,0.0,419,834,0.5023980815347722,184,257,0.7159533073929961,169,509,678,203,50,146,122,119,1022,2011_Tim Duncan
2012,Anthony Parker,SF,36,141,326,0.4325153374233129,50,138,0.36231884057971014,91,188,0.48404255319148937,35,56,0.625,10,128,138,120,38,7,50,65,367,2012_Anthony Parker
2012,Corey Maggette,SF,32,139,373,0.3726541554959786,24,66,0.36363636363636365,115,307,0.3745928338762215,178,208,0.8557692307692307,21,104,125,39,23,1,59,83,480,2012_Corey Maggette
2012,Darko Milicic,C,26,59,130,0.45384615384615384,0,0,NaN,59,130,0.45384615384615384,16,37,0.43243243243243246,35,62,97,17,9,25,32,59,134,2012_Darko Milicic
2012,DeAndre Liggins,SF,23,12,25,0.48,0,4,0.0,12,21,0.5714285714285714,9,19,0.47368421052631576,6,9,15,5,6,0,10,6,33,2012_DeAndre Liggins
2012,Deron Williams,PG,27,391,961,0.4068678459937565,115,342,0.3362573099415205,276,619,0.4458804523424879,257,305,0.8426229508196721,23,160,183,481,67,20,219,121,1154,2012_Deron Williams
2012,Dirk Nowitzki,PF,33,473,1034,0.4574468085106383,78,212,0.36792452830188677,395,822,0.4805352798053528,318,355,0.895774647887324,46,372,418,136,42,30,117,129,1342,2012_Dirk Nowitzki
2012,Jordan Hamilton,SF,21,48,111,0.43243243243243246,17,47,0.3617021276595745,31,64,0.484375,2,5,0.4,11,51,62,20,4,3,16,15,115,2012_Jordan Hamilton
2012,Lou Williams,PG,25,318,782,0.40664961636828645,83,229,0.3624454148471616,235,553,0.42495479204339964,237,292,0.8116438356164384,30,125,155,221,53,18,71,90,956,2012_Lou Williams
2012,Marco Belinelli,SG,25,286,686,0.41690962099125367,107,284,0.3767605633802817,179,402,0.44527363184079605,101,129,0.7829457364341085,19,153,172,101,48,5,69,115,780,2012_Marco Belinelli
2012,Marreese Speights,PF,24,221,488,0.45286885245901637,0,3,0.0,221,485,0.4556701030927835,84,109,0.7706422018348624,133,241,374,48,21,29,74,147,526,2012_Marreese Speights
2012,Mickell Gladness,PF,25,50,118,0.423728813559322,0,0,NaN,50,118,0.423728813559322,12,24,0.5,28,88,116,10,8,40,14,64,112,2012_Mickell Gladness
2012,Norris Cole,PG,23,177,450,0.3933333333333333,21,76,0.27631578947368424,156,374,0.41711229946524064,66,85,0.7764705882352941,21,70,91,133,44,2,105,124,441,2012_Norris Cole
2012,Randy Foye,SG,28,256,644,0.39751552795031053,127,329,0.3860182370820669,129,315,0.4095238095238095,73,85,0.8588235294117647,25,113,138,146,46,24,73,130,712,2012_Randy Foye
2012,Ryan Anderson,PF,23,332,757,0.4385733157199472,166,422,0.3933649289099526,166,335,0.4955223880597015,150,171,0.8771929824561403,224,247,471,54,50,26,57,146,980,2012_Ryan Anderson
2013,Andre Miller,PG,36,303,632,0.47943037974683544,17,64,0.265625,286,568,0.5035211267605634,163,194,0.8402061855670103,60,178,238,484,73,11,172,159,786,2013_Andre Miller
2013,Chris Douglas-Roberts,SG,26,5,14,0.35714285714285715,0,4,0.0,5,10,0.5,7,10,0.7,0,5,5,4,2,0,1,4,17,2013_Chris Douglas-Roberts
2013,Damian Lillard,PG,22,553,1288,0.42934782608695654,185,503,0.36779324055666,368,785,0.46878980891719746,271,321,0.8442367601246106,42,215,257,531,74,19,243,172,1562,2013_Damian Lillard
2013,Darko Milicic,C,27,0,1,0.0,0,0,NaN,0,1,0.0,0,0,NaN,0,1,1,0,0,0,2,1,0,2013_Darko Milicic
2013,David West,PF,32,502,1009,0.4975222993062438,4,19,0.21052631578947367,498,990,0.503030303030303,242,315,0.7682539682539683,145,418,563,213,74,69,157,149,1250,2013_David West
2013,DeAndre Liggins,SG,24,21,47,0.44680851063829785,7,19,0.3684210526315789,14,28,0.5,9,18,0.5,13,40,53,15,18,3,14,33,58,2013_DeAndre Liggins
2013,Dirk Nowitzki,PF,34,343,728,0.47115384615384615,65,157,0.4140127388535032,278,571,0.4868651488616462,166,193,0.8601036269430051,37,326,363,132,38,37,70,93,917,2013_Dirk Nowitzki
2013,Ersan Ilyasova,PF,25,371,803,0.46201743462017436,95,214,0.4439252336448598,276,589,0.4685908319185059,125,157,0.7961783439490446,154,366,520,117,68,36,75,185,962,2013_Ersan Ilyasova
2013,Jordan Hamilton,SF,22,84,201,0.417910447761194,27,73,0.3698630136986301,57,128,0.4453125,13,26,0.5,32,63,95,23,15,8,19,24,208,2013_Jordan Hamilton
2013,Kevin Seraphin,C,23,330,716,0.46089385474860334,0,0,NaN,330,716,0.46089385474860334,61,88,0.6931818181818182,107,239,346,57,24,59,130,211,721,2013_Kevin Seraphin
2013,Kosta Koufos,C,23,295,508,0.5807086614173228,0,1,0.0,295,507,0.5818540433925049,58,104,0.5576923076923077,211,351,562,32,44,103,53,246,648,2013_Kosta Koufos
2013,Marco Belinelli,SG,26,241,610,0.3950819672131147,79,221,0.3574660633484163,162,389,0.41645244215938304,141,168,0.8392857142857143,13,127,140,148,44,6,82,140,702,2013_Marco Belinelli
2013,Marreese Speights,C,25,520,1168,0.4452054794520548,6,20,0.3,514,1148,0.44773519163763065,270,350,0.7714285714285715,292,480,772,94,48,106,160,350,1316,2013_Marreese Speights
2013,Norris Cole,PG,24,179,425,0.4211764705882353,35,98,0.35714285714285715,144,327,0.44036697247706424,52,80,0.65,18,112,130,164,57,7,104,155,445,2013_Norris Cole
2013,Patrick Beverley,PG,24,79,189,0.41798941798941797,36,96,0.375,43,93,0.46236559139784944,34,41,0.8292682926829268,45,64,109,117,37,21,44,83,228,2013_Patrick Beverley
2013,Ramon Sessions,SG,26,276,676,0.40828402366863903,33,107,0.308411214953271,243,569,0.4270650263620387,291,347,0.8386167146974063,27,142,169,230,48,7,104,91,876,2013_Ramon Sessions
2013,Royal Ivey,SG,31,62,144,0.4305555555555556,37,88,0.42045454545454547,25,56,0.44642857142857145,9,16,0.5625,16,41,57,32,23,3,20,73,170,2013_Royal Ivey
2013,Ryan Anderson,PF,24,472,1115,0.4233183856502242,213,557,0.38240574506283664,259,558,0.46415770609318996,152,180,0.8444444444444444,191,328,519,97,42,31,97,179,1309,2013_Ryan Anderson
2013,Tristan Thompson,PF,21,390,799,0.4881101376720901,0,3,0.0,390,796,0.4899497487437186,177,291,0.6082474226804123,306,467,773,108,60,71,123,234,957,2013_Tristan Thompson
2013,Tyler Hansbrough,PF,27,176,407,0.43243243243243246,0,3,0.0,176,404,0.43564356435643564,216,300,0.72,161,212,373,36,29,18,78,152,568,2013_Tyler Hansbrough
2014,Chris Douglas-Roberts,SF,27,111,252,0.44047619047619047,51,132,0.38636363636363635,60,120,0.5,66,82,0.8048780487804879,16,103,119,51,29,16,36,61,339,2014_Chris Douglas-Roberts
2014,Courtney Lee,SG,28,590,1228,0.4804560260586319,144,388,0.3711340206185567,446,840,0.530952380952381,198,224,0.8839285714285714,58,316,374,230,130,56,146,254,1522,2014_Courtney Lee
2014,DeAndre Liggins,SG,25,1,1,1.0,0,0,NaN,1,1,1.0,0,0,NaN,1,0,1,0,0,0,0,0,2,2014_DeAndre Liggins
2014,Dirk Nowitzki,PF,35,633,1273,0.49725058915946585,131,329,0.3981762917933131,502,944,0.5317796610169492,338,376,0.898936170212766,40,458,498,216,73,45,117,165,1735,2014_Dirk Nowitzki
2014,Garrett Temple,SG,27,51,141,0.3617021276595745,6,29,0.20689655172413793,45,112,0.4017857142857143,30,43,0.6976744186046512,21,47,68,72,35,11,42,72,138,2014_Garrett Temple
2014,Giannis Antetokounmpo,SF,19,173,418,0.4138755980861244,41,118,0.3474576271186441,132,300,0.44,138,202,0.6831683168316832,78,261,339,150,60,61,122,173,525,2014_Giannis Antetokounmpo
2014,J.R. Smith,SF,28,396,955,0.41465968586387436,189,480,0.39375,207,475,0.4357894736842105,90,138,0.6521739130434783,35,261,296,219,65,20,108,196,1071,2014_J.R. Smith
2014,Jordan Hamilton,SF,23,294,752,0.39095744680851063,140,396,0.35353535353535354,154,356,0.43258426966292135,80,102,0.7843137254901961,64,324,388,104,88,40,92,134,808,2014_Jordan Hamilton
2014,Kendall Marshall,PG,22,170,419,0.40572792362768495,71,178,0.398876404494382,99,241,0.4107883817427386,19,36,0.5277777777777778,15,140,155,477,48,4,150,76,430,2014_Kendall Marshall
2014,Kevin Martin,SG,30,440,1023,0.43010752688172044,115,297,0.3872053872053872,325,726,0.4476584022038568,303,340,0.8911764705882353,34,169,203,121,66,6,106,123,1298,2014_Kevin Martin
2014,Kyle Lowry,PG,27,457,1080,0.42314814814814816,190,500,0.38,267,580,0.4603448275862069,313,385,0.812987012987013,88,281,369,586,121,15,194,267,1417,2014_Kyle Lowry
2014,Luc Mbah,SF_PF_PF-SF,27,174,386,0.45077720207253885,8,34,0.23529411764705882,166,352,0.4715909090909091,92,134,0.6865671641791045,112,180,292,72,60,28,80,136,448,2014_Luc Mbah
2014,Marco Belinelli,SF,27,337,695,0.4848920863309353,126,293,0.4300341296928328,211,402,0.5248756218905473,111,131,0.8473282442748091,18,208,226,179,50,7,95,130,911,2014_Marco Belinelli
2014,Marquis Teague,SG,20,76,238,0.31932773109243695,10,36,0.2777777777777778,66,202,0.32673267326732675,52,70,0.7428571428571429,2,78,80,116,20,10,78,92,214,2014_Marquis Teague
2014,Marreese Speights,C,26,195,442,0.4411764705882353,8,31,0.25806451612903225,187,411,0.45498783454987834,110,134,0.8208955223880597,101,189,290,32,10,34,66,148,508,2014_Marreese Speights
2014,Michael Carter-Williams,PG,22,427,1054,0.40512333965844405,55,208,0.2644230769230769,372,846,0.4397163120567376,258,367,0.7029972752043597,101,336,437,441,130,43,247,213,1167,2014_Michael Carter-Williams
2014,Norris Cole,PG,25,207,500,0.414,60,174,0.3448275862068966,147,326,0.450920245398773,53,68,0.7794117647058824,17,143,160,248,77,5,127,156,527,2014_Norris Cole
2014,Raymond Felton,PG,29,240,608,0.39473684210526316,62,195,0.31794871794871793,178,413,0.43099273607748184,88,122,0.7213114754098361,54,143,197,365,78,27,129,157,630,2014_Raymond Felton
2014,Ryan Anderson,PF,25,155,354,0.4378531073446328,67,164,0.40853658536585363,88,190,0.4631578947368421,59,62,0.9516129032258065,66,76,142,17,10,7,20,47,436,2014_Ryan Anderson
2014,Shane Edwards,SF,26,1,3,0.3333333333333333,0,0,NaN,1,3,0.3333333333333333,0,0,NaN,1,1,2,0,0,0,1,1,2,2014_Shane Edwards
2015,Chris Andersen,C,36,120,207,0.5797101449275363,4,13,0.3076923076923077,116,194,0.5979381443298969,76,114,0.6666666666666666,76,223,299,43,26,61,40,88,320,2015_Chris Andersen
2015,Chris Douglas-Roberts,SG,28,5,21,0.23809523809523808,1,7,0.14285714285714285,4,14,0.2857142857142857,8,8,1.0,1,11,12,4,1,0,0,14,19,2015_Chris Douglas-Roberts
2015,Dirk Nowitzki,PF,36,487,1062,0.4585687382297552,104,274,0.3795620437956204,383,788,0.4860406091370558,255,289,0.8823529411764706,44,413,457,143,39,33,82,160,1333,2015_Dirk Nowitzki
2015,Furkan Aldemir,PF,23,40,78,0.5128205128205128,0,5,0.0,40,73,0.547945205479452,13,27,0.48148148148148145,78,98,176,28,17,16,17,96,93,2015_Furkan Aldemir
2015,Jamal Crawford,SG,34,332,839,0.3957091775923719,119,364,0.3269230769230769,213,475,0.44842105263157894,227,252,0.9007936507936508,18,106,124,158,59,14,92,108,1010,2015_Jamal Crawford
2015,Jeff Ayres,PF,27,55,95,0.5789473684210527,0,0,NaN,55,95,0.5789473684210527,27,36,0.75,37,80,117,14,8,8,26,60,137,2015_Jeff Ayres
2015,Jordan Hamilton,SF,24,14,35,0.4,10,21,0.47619047619047616,4,14,0.2857142857142857,0,0,NaN,2,14,16,7,2,0,4,14,38,2015_Jordan Hamilton
2015,Marc Gasol,C,30,530,1072,0.4944029850746269,3,17,0.17647058823529413,527,1055,0.4995260663507109,350,440,0.7954545454545454,115,515,630,307,70,131,176,208,1413,2015_Marc Gasol
2015,Marcin Gortat,C,30,439,775,0.5664516129032258,0,3,0.0,439,772,0.5686528497409327,123,175,0.7028571428571428,180,537,717,97,49,110,100,191,1001,2015_Marcin Gortat
2015,Marco Belinelli,SG,28,199,470,0.42340425531914894,86,230,0.3739130434782609,113,240,0.4708333333333333,84,99,0.8484848484848485,26,131,157,94,31,3,61,85,568,2015_Marco Belinelli
2015,Marreese Speights,C,27,318,646,0.49226006191950467,5,18,0.2777777777777778,313,628,0.4984076433121019,150,178,0.8426966292134831,109,216,325,72,20,34,82,189,791,2015_Marreese Speights
2015,Michael Carter-Williams,PG,23,728,1838,0.39608269858541895,72,306,0.23529411764705882,656,1532,0.4281984334203655,404,582,0.6941580756013745,128,578,706,884,222,60,506,334,1932,2015_Michael Carter-Williams
2015,Norris Cole,PG,26,460,1116,0.4121863799283154,110,352,0.3125,350,764,0.4581151832460733,116,162,0.7160493827160493,26,292,318,510,114,30,198,248,1146,2015_Norris Cole
2015,Ryan Anderson,PF,26,291,729,0.3991769547325103,122,359,0.3398328690807799,169,370,0.45675675675675675,129,151,0.8543046357615894,108,187,295,55,33,20,62,113,833,2015_Ryan Anderson
2015,Ryan Hollins,C,30,53,82,0.6463414634146342,0,0,NaN,53,82,0.6463414634146342,31,54,0.5740740740740741,36,67,103,14,6,19,25,65,137,2015_Ryan Hollins
2015,T.J. Warren,SF,21,113,214,0.5280373831775701,5,21,0.23809523809523808,108,193,0.5595854922279793,14,19,0.7368421052631579,41,44,85,25,18,9,27,51,245,2015_T.J. Warren
2016,Anthony Tolliver,PF,30,128,332,0.3855421686746988,98,272,0.3602941176470588,30,60,0.5,29,47,0.6170212765957447,39,190,229,52,26,16,28,86,383,2016_Anthony Tolliver
2016,Axel Toupane,SF,23,25,70,0.35714285714285715,13,40,0.325,12,30,0.4,13,17,0.7647058823529411,8,23,31,15,7,6,6,40,76,2016_Axel Toupane
2016,Bryce Cotton,PG,23,8,20,0.4,0,6,0.0,8,14,0.5714285714285714,0,0,NaN,0,0,0,6,6,0,10,4,16,2016_Bryce Cotton
2016,Darrun Hilliard,SG,22,52,131,0.3969465648854962,19,50,0.38,33,81,0.4074074074074074,29,40,0.725,5,40,45,27,9,1,19,28,152,2016_Darrun Hilliard
2016,Dirk Nowitzki,PF,37,498,1112,0.447841726618705,126,342,0.3684210526315789,372,770,0.4831168831168831,250,280,0.8928571428571429,52,437,489,132,52,52,84,161,1372,2016_Dirk Nowitzki
2016,John Jenkins,SG,24,142,320,0.44375,32,102,0.3137254901960784,110,218,0.5045871559633027,40,48,0.8333333333333334,16,98,114,70,16,2,54,44,356,2016_John Jenkins
2016,Jordan Hamilton,SF,25,49,116,0.4224137931034483,13,45,0.28888888888888886,36,71,0.5070422535211268,14,21,0.6666666666666666,12,50,62,25,8,3,17,24,125,2016_Jordan Hamilton
2016,Jordan Mickey,PF,21,8,22,0.36363636363636365,0,0,NaN,8,22,0.36363636363636365,5,10,0.5,6,7,13,1,0,11,1,5,21,2016_Jordan Mickey
2016,Karl-Anthony Towns,C,20,625,1153,0.5420641803989592,30,88,0.3409090909090909,595,1065,0.5586854460093896,223,275,0.8109090909090909,229,629,858,161,58,138,183,245,1503,2016_Karl-Anthony Towns
2016,Marcin Gortat,C,31,433,764,0.5667539267015707,0,1,0.0,433,763,0.5674967234600262,146,207,0.7053140096618358,222,519,741,106,47,96,121,193,1012,2016_Marcin Gortat
2016,Marco Belinelli,SG,29,245,635,0.3858267716535433,91,297,0.3063973063973064,154,338,0.4556213017751479,115,138,0.8333333333333334,10,107,117,127,37,2,80,91,696,2016_Marco Belinelli
2016,Marreese Speights,C,28,197,456,0.43201754385964913,24,62,0.3870967741935484,173,394,0.43908629441624364,94,114,0.8245614035087719,77,162,239,61,19,34,66,117,512,2016_Marreese Speights
2016,Meyers Leonard,PF,23,195,435,0.4482758620689655,86,228,0.37719298245614036,109,207,0.5265700483091788,35,46,0.7608695652173914,51,263,314,92,8,18,77,183,511,2016_Meyers Leonard
2016,Michael Carter-Williams,PG,24,251,555,0.45225225225225224,15,55,0.2727272727272727,236,500,0.472,106,162,0.654320987654321,48,228,276,281,80,41,153,162,623,2016_Michael Carter-Williams
2016,Norris Cole,PG,27,196,484,0.4049586776859504,33,102,0.3235294117647059,163,382,0.42670157068062825,52,65,0.8,10,141,151,167,37,5,75,102,477,2016_Norris Cole
2016,Reggie Jackson,PG,25,540,1244,0.4340836012861736,118,334,0.3532934131736527,422,910,0.46373626373626375,291,337,0.8635014836795252,58,195,253,492,59,11,223,187,1489,2016_Reggie Jackson
2016,Ryan Anderson,PF,27,397,929,0.42734122712594186,131,358,0.3659217877094972,266,571,0.4658493870402802,199,228,0.8728070175438597,131,265,396,73,38,25,90,109,1124,2016_Ryan Anderson
2016,Steven Adams,C,22,261,426,0.6126760563380281,0,0,NaN,261,426,0.6126760563380281,114,196,0.5816326530612245,219,314,533,62,42,89,84,223,636,2016_Steven Adams
2016,T.J. Warren,SF,22,221,441,0.5011337868480725,28,70,0.4,193,371,0.5202156334231806,45,64,0.703125,57,90,147,44,37,16,32,94,515,2016_T.J. Warren
2016,Zach LaVine,SG,20,433,959,0.45151199165797706,123,316,0.38924050632911394,310,643,0.4821150855365474,161,203,0.7931034482758621,27,201,228,251,69,17,155,193,1150,2016_Zach LaVine
2017,Andre Iguodala,SF,33,219,415,0.5277108433734939,64,177,0.3615819209039548,155,238,0.6512605042016807,72,102,0.7058823529411765,51,253,304,262,76,39,58,97,574,2017_Andre Iguodala
2017,Bobby Portis,PF,21,183,375,0.488,32,96,0.3333333333333333,151,279,0.5412186379928315,39,59,0.6610169491525424,75,221,296,35,16,11,37,94,437,2017_Bobby Portis
2017,Bradley Beal,SG,23,637,1322,0.48184568835098335,223,552,0.40398550724637683,414,770,0.5376623376623376,282,342,0.8245614035087719,53,186,239,267,83,21,157,169,1779,2017_Bradley Beal
2017,Damjan Rudez,SF,30,31,88,0.3522727272727273,20,64,0.3125,11,24,0.4583333333333333,0,0,NaN,5,20,25,20,12,1,9,31,82,2017_Damjan Rudez
2017,Darrun Hilliard,SG,23,47,126,0.373015873015873,12,46,0.2608695652173913,35,80,0.4375,21,28,0.75,2,31,33,33,11,2,28,39,127,2017_Darrun Hilliard
2017,DeAndre Liggins,SG,28,110,284,0.3873239436619718,34,92,0.3695652173913043,76,192,0.3958333333333333,50,80,0.625,40,176,216,108,94,28,84,162,304,2017_DeAndre Liggins
2017,Dirk Nowitzki,PF,38,296,678,0.4365781710914454,79,209,0.37799043062200954,217,469,0.4626865671641791,98,112,0.875,23,330,353,82,30,38,51,113,769,2017_Dirk Nowitzki
2017,Joe Harris,SG,25,154,362,0.425414364640884,85,221,0.38461538461538464,69,141,0.48936170212765956,35,49,0.7142857142857143,16,131,147,54,30,8,55,121,428,2017_Joe Harris
2017,Jordan Mickey,PF,22,15,34,0.4411764705882353,0,1,0.0,15,33,0.45454545454545453,8,14,0.5714285714285714,13,21,34,7,3,6,9,12,38,2017_Jordan Mickey
2017,Kemba Walker,PG,26,643,1449,0.4437543133195307,240,602,0.39867109634551495,403,847,0.4757969303423849,304,359,0.8467966573816156,45,263,308,435,85,22,168,119,1830,2017_Kemba Walker
2017,Marcin Gortat,C,32,390,674,0.5786350148367952,0,2,0.0,390,672,0.5803571428571429,103,159,0.6477987421383647,238,611,849,121,40,65,118,213,883,2017_Marcin Gortat
2017,Marreese Speights,C,29,244,548,0.44525547445255476,103,277,0.37184115523465705,141,271,0.5202952029520295,120,137,0.8759124087591241,88,285,373,66,23,41,69,229,711,2017_Marreese Speights
2017,Michael Carter-Williams,PG,25,112,306,0.3660130718954248,15,64,0.234375,97,242,0.40082644628099173,58,77,0.7532467532467533,24,128,152,113,38,23,66,102,297,2017_Michael Carter-Williams
2017,Norris Cole,PG,28,16,52,0.3076923076923077,3,13,0.23076923076923078,13,39,0.3333333333333333,8,10,0.8,0,11,11,14,8,0,7,18,43,2017_Norris Cole
2017,Ryan Anderson,PF,28,323,773,0.4178525226390686,204,506,0.4031620553359684,119,267,0.44569288389513106,129,150,0.86,112,218,330,68,32,14,55,142,979,2017_Ryan Anderson
2017,T.J. Warren,SF,23,403,814,0.4950859950859951,26,98,0.2653061224489796,377,716,0.526536312849162,119,154,0.7727272727272727,125,214,339,75,76,39,57,175,951,2017_T.J. Warren
2017,Trey Lyles,PF,21,159,439,0.3621867881548975,65,204,0.31862745098039214,94,235,0.4,57,79,0.7215189873417721,48,187,235,70,26,20,64,97,440,2017_Trey Lyles
2017,Zach LaVine,SG,21,326,710,0.4591549295774648,120,310,0.3870967741935484,206,400,0.515,117,140,0.8357142857142857,18,141,159,139,41,10,85,104,889,2017_Zach LaVine
2003,Art Long,SF,30,56,150,0.37333333333333335,4,6,0.6666666666666666,52,144,0.3611111111111111,4,20,0.2,42,78,120,12,10,22,40,70,120,2003_Art Long
2003,Calbert Cheaney,SG,31,325,651,0.49923195084485406,10,25,0.4,315,626,0.5031948881789138,40,69,0.5797101449275363,73,211,284,163,65,13,108,225,700,2003_Calbert Cheaney
2003,Jason Kidd,PG,29,515,1244,0.4139871382636656,126,370,0.34054054054054056,389,874,0.4450800915331808,339,403,0.8411910669975186,110,394,504,711,179,25,296,127,1495,2003_Jason Kidd
2003,John Stockton,PG,40,309,640,0.4828125,29,80,0.3625,280,560,0.5,237,287,0.8257839721254355,51,150,201,629,137,16,182,184,884,2003_John Stockton
2003,Mark Jackson,PG,37,147,369,0.3983739837398374,27,95,0.28421052631578947,120,274,0.43795620437956206,61,80,0.7625,34,142,176,375,48,3,152,90,382,2003_Mark Jackson
2003,Michael Doleac,C,25,146,343,0.42565597667638483,0,0,NaN,146,343,0.42565597667638483,36,46,0.782608695652174,65,154,219,42,16,16,49,150,328,2003_Michael Doleac
2003,Qyntel Woods,PF,21,59,118,0.5,3,9,0.3333333333333333,56,109,0.5137614678899083,7,20,0.35,15,38,53,12,15,1,23,36,128,2003_Qyntel Woods
2003,Rashard Lewis,SF,23,519,1149,0.4516971279373368,75,217,0.3456221198156682,444,932,0.47639484978540775,283,345,0.8202898550724638,152,351,503,133,99,35,143,205,1396,2003_Rashard Lewis
2003,Reggie Miller,SG,37,281,637,0.4411302982731554,113,318,0.3553459119496855,168,319,0.5266457680250783,207,230,0.9,21,151,172,170,62,4,66,89,882,2003_Reggie Miller
2003,Stephen Jackson,SG,24,356,818,0.4352078239608802,95,297,0.31986531986531985,261,521,0.5009596928982726,139,183,0.7595628415300546,66,220,286,183,125,30,176,202,946,2003_Stephen Jackson
2003,Steve Smith,SG,33,113,291,0.38831615120274915,39,118,0.3305084745762712,74,173,0.4277456647398844,95,114,0.8333333333333334,21,78,99,70,28,9,43,79,360,2003_Steve Smith
2003,Tremaine Fowlkes,SF,26,56,128,0.4375,2,9,0.2222222222222222,54,119,0.453781512605042,50,59,0.847457627118644,41,62,103,23,25,2,20,63,164,2003_Tremaine Fowlkes
2003,Tyson Chandler,C,20,257,484,0.53099173553719,0,0,NaN,257,484,0.53099173553719,177,291,0.6082474226804123,169,345,514,76,37,106,135,220,691,2003_Tyson Chandler
2003,Vin Baker,C,31,99,207,0.4782608695652174,0,4,0.0,99,203,0.4876847290640394,72,107,0.6728971962616822,90,108,198,29,22,30,61,146,270,2003_Vin Baker
2003,Walter McCarty,SF,28,173,418,0.4138755980861244,91,248,0.36693548387096775,82,170,0.4823529411764706,61,98,0.6224489795918368,64,224,288,106,78,28,67,188,498,2003_Walter McCarty
2004,Calbert Cheaney,SF,32,278,578,0.4809688581314879,0,10,0.0,278,568,0.4894366197183099,47,77,0.6103896103896104,77,183,260,136,60,12,85,184,603,2004_Calbert Cheaney
2004,Darvin Ham,SF,30,37,75,0.49333333333333335,1,2,0.5,36,73,0.4931506849315068,21,35,0.6,47,46,93,16,13,8,31,63,96,2004_Darvin Ham
2004,Frank Williams,PG,23,80,208,0.38461538461538464,18,60,0.3,62,148,0.4189189189189189,41,48,0.8541666666666666,8,45,53,121,25,6,63,58,219,2004_Frank Williams
2004,Gilbert Arenas,PG,22,358,914,0.3916849015317287,125,333,0.37537537537537535,233,581,0.4010327022375215,237,317,0.7476340694006309,55,199,254,275,103,12,226,176,1078,2004_Gilbert Arenas
2004,Jason Hart,PG,25,71,159,0.44654088050314467,2,9,0.2222222222222222,69,150,0.46,33,43,0.7674418604651163,10,69,79,81,28,5,29,59,177,2004_Jason Hart
2004,John Wallace,SF,29,61,145,0.4206896551724138,5,13,0.38461538461538464,56,132,0.42424242424242425,31,40,0.775,12,47,59,14,5,8,24,38,158,2004_John Wallace
2004,Rashard Lewis,SF,24,535,1229,0.435313262815297,145,386,0.3756476683937824,390,843,0.4626334519572954,206,270,0.762962962962963,133,385,518,175,99,54,135,233,1421,2004_Rashard Lewis
2004,Reggie Miller,SG,38,260,594,0.4377104377104377,134,334,0.40119760479041916,126,260,0.4846153846153846,146,165,0.8848484848484849,18,170,188,249,65,11,68,96,800,2004_Reggie Miller
2004,Stephen Jackson,SF,25,536,1261,0.42505947660586835,145,427,0.3395784543325527,391,834,0.46882494004796166,233,297,0.7845117845117845,97,273,370,244,142,20,223,216,1450,2004_Stephen Jackson
2004,Steve Smith,SG,34,119,293,0.4061433447098976,43,107,0.40186915887850466,76,186,0.40860215053763443,77,83,0.927710843373494,27,54,81,56,15,6,42,91,358,2004_Steve Smith
2004,Vin Baker,PF,32,416,864,0.48148148148148145,2,6,0.3333333333333333,414,858,0.4825174825174825,228,314,0.7261146496815286,224,336,560,132,58,64,154,320,1062,2004_Vin Baker
2005,Bob Sura,PG,31,215,504,0.42658730158730157,55,155,0.3548387096774194,160,349,0.4584527220630373,141,188,0.75,79,258,337,317,65,7,147,168,626,2005_Bob Sura
2005,Calbert Cheaney,SG,33,113,265,0.42641509433962266,0,3,0.0,113,262,0.4312977099236641,24,37,0.6486486486486487,32,92,124,64,17,15,35,95,250,2005_Calbert Cheaney
2005,Donta Smith,SG,21,44,113,0.3893805309734513,6,22,0.2727272727272727,38,91,0.4175824175824176,33,48,0.6875,19,33,52,39,23,5,25,50,127,2005_Donta Smith
2005,Gerald Wallace,SF,22,286,637,0.4489795918367347,17,62,0.27419354838709675,269,575,0.4678260869565217,191,289,0.6608996539792388,118,268,386,137,117,91,159,182,780,2005_Gerald Wallace
2005,James Thomas,PF,24,24,40,0.6,0,0,NaN,24,40,0.6,4,12,0.3333333333333333,34,40,74,8,8,8,14,26,52,2005_James Thomas
2005,Jason Richardson,SG,24,610,1368,0.44590643274853803,125,370,0.33783783783783783,485,998,0.48597194388777554,214,309,0.6925566343042071,125,299,424,281,105,32,169,156,1559,2005_Jason Richardson
2005,Keith McLeod,PG,25,143,408,0.35049019607843135,18,72,0.25,125,336,0.37202380952380953,112,146,0.7671232876712328,20,93,113,236,63,12,99,138,416,2005_Keith McLeod
2005,Kirk Hinrich,PG,24,445,1122,0.3966131907308378,145,408,0.3553921568627451,300,714,0.42016806722689076,171,216,0.7916666666666666,32,272,304,494,122,21,176,244,1206,2005_Kirk Hinrich
2005,Rashard Lewis,SF,25,532,1151,0.4622067767158992,173,432,0.40046296296296297,359,719,0.4993045897079277,220,283,0.7773851590106007,110,278,388,94,75,62,123,158,1457,2005_Rashard Lewis
2005,Reggie Miller,SG,39,314,719,0.43671766342141866,96,298,0.3221476510067114,218,421,0.517814726840855,250,268,0.9328358208955224,18,138,156,146,50,5,77,109,974,2005_Reggie Miller
2005,Sean Marks,PF,29,27,80,0.3375,0,3,0.0,27,77,0.35064935064935066,22,28,0.7857142857142857,18,38,56,8,3,11,14,29,76,2005_Sean Marks
2005,Stephen Jackson,SF,26,330,819,0.40293040293040294,103,286,0.36013986013986016,227,533,0.425891181988743,190,229,0.8296943231441049,44,206,250,119,64,14,123,154,953,2005_Stephen Jackson
2005,Steve Smith,SG,35,204,496,0.4112903225806452,82,210,0.3904761904761905,122,286,0.42657342657342656,138,160,0.8625,30,100,130,142,28,14,54,164,628,2005_Steve Smith
2005,Tamar Slay,SG,24,13,39,0.3333333333333333,2,12,0.16666666666666666,11,27,0.4074074074074074,0,2,0.0,6,8,14,3,5,0,8,20,28,2005_Tamar Slay
2005,Vin Baker,C_PF_PF-C,33,26,84,0.30952380952380953,0,2,0.0,26,82,0.3170731707317073,18,34,0.5294117647058824,34,44,78,20,4,8,34,76,70,2005_Vin Baker
2005,Zoran Planinic,PG,22,78,174,0.4482758620689655,15,40,0.375,63,134,0.4701492537313433,46,66,0.696969696969697,19,50,69,44,25,0,41,76,217,2005_Zoran Planinic
2006,Brian Cook,PF,25,261,511,0.5107632093933464,36,84,0.42857142857142855,225,427,0.5269320843091335,84,101,0.8316831683168316,88,186,274,74,37,32,61,205,642,2006_Brian Cook
2006,Brian Scalabrine,PF,27,74,193,0.38341968911917096,31,87,0.3563218390804598,43,106,0.4056603773584906,26,36,0.7222222222222222,27,87,114,51,21,19,50,127,205,2006_Brian Scalabrine
2006,Calbert Cheaney,SF,34,42,108,0.3888888888888889,0,8,0.0,42,100,0.42,8,8,1.0,20,41,61,19,13,2,17,38,92,2006_Calbert Cheaney
2006,Donta Smith,SG,22,15,27,0.5555555555555556,2,4,0.5,13,23,0.5652173913043478,6,12,0.5,3,11,14,9,8,0,4,20,38,2006_Donta Smith
2006,Fabricio Oberto,C,30,44,93,0.4731182795698925,0,2,0.0,44,91,0.4835164835164835,15,27,0.5555555555555556,57,66,123,27,9,11,28,91,103,2006_Fabricio Oberto
2006,Josh Smith,SF,20,329,774,0.42506459948320413,34,110,0.3090909090909091,295,664,0.4442771084337349,210,292,0.7191780821917808,176,355,531,191,64,208,162,260,902,2006_Josh Smith
2006,Kenny Thomas,PF,28,305,604,0.5049668874172185,0,1,0.0,305,603,0.5058043117744611,138,204,0.6764705882352942,199,419,618,168,72,39,135,196,748,2006_Kenny Thomas
2006,Nikoloz Tskitishvili,SF-PF_SF_PF,22,26,74,0.35135135135135137,2,6,0.3333333333333333,24,68,0.35294117647058826,18,28,0.6428571428571429,18,26,44,6,2,4,12,16,72,2006_Nikoloz Tskitishvili
2006,Pape Sow,C,24,53,123,0.43089430894308944,0,0,NaN,53,123,0.43089430894308944,41,57,0.7192982456140351,54,92,146,8,21,19,30,118,147,2006_Pape Sow
2006,Rashard Lewis,SF,26,538,1151,0.46741963509991313,142,370,0.3837837837837838,396,781,0.5070422535211268,350,428,0.8177570093457944,111,279,390,182,102,50,141,191,1568,2006_Rashard Lewis
2006,Stephen Jackson,SG,27,472,1148,0.41114982578397213,117,339,0.34513274336283184,355,809,0.4388133498145859,268,341,0.7859237536656891,48,264,312,225,104,43,203,195,1329,2006_Stephen Jackson
2006,Vin Baker,C,34,7,15,0.4666666666666667,0,0,NaN,7,15,0.4666666666666667,13,18,0.7222222222222222,2,17,19,4,4,4,9,13,27,2006_Vin Baker
2007,Andrei Kirilenko,SF,25,197,418,0.47129186602870815,16,75,0.21333333333333335,181,343,0.5276967930029155,174,239,0.7280334728033473,88,241,329,202,74,144,135,172,584,2007_Andrei Kirilenko
2007,Anthony Parker,SG,31,328,687,0.4774381368267831,115,261,0.44061302681992337,213,426,0.5,132,158,0.8354430379746836,60,223,283,153,73,11,71,135,903,2007_Anthony Parker
2007,Craig Smith,PF,23,246,463,0.531317494600432,0,6,0.0,246,457,0.5382932166301969,116,186,0.6236559139784946,149,267,416,49,51,18,74,223,608,2007_Craig Smith
2007,Deron Williams,PG,22,494,1083,0.45614035087719296,82,255,0.3215686274509804,412,828,0.4975845410628019,227,296,0.7668918918918919,41,226,267,745,78,13,246,254,1297,2007_Deron Williams
2007,Fabricio Oberto,PF,31,158,281,0.5622775800711743,0,0,NaN,158,281,0.5622775800711743,33,51,0.6470588235294118,131,237,368,68,25,24,69,213,349,2007_Fabricio Oberto
2007,Francisco Garcia,SF,25,163,380,0.42894736842105263,53,149,0.35570469798657717,110,231,0.47619047619047616,95,114,0.8333333333333334,53,152,205,87,45,43,70,190,474,2007_Francisco Garcia
2007,Joel Przybilla,C,27,37,78,0.47435897435897434,0,0,NaN,37,78,0.47435897435897434,10,27,0.37037037037037035,59,109,168,12,10,67,40,124,84,2007_Joel Przybilla
2007,Julius Hodge,SG,23,12,24,0.5,0,0,NaN,12,24,0.5,6,8,0.75,4,12,16,24,8,0,6,12,30,2007_Julius Hodge
2007,Lou Williams,PG,20,93,211,0.44075829383886256,12,37,0.32432432432432434,81,174,0.46551724137931033,64,92,0.6956521739130435,17,53,70,110,22,1,46,42,262,2007_Lou Williams
2007,Quincy Douby,PG,22,48,126,0.38095238095238093,12,50,0.24,36,76,0.47368421052631576,11,15,0.7333333333333333,11,26,37,15,15,4,15,21,119,2007_Quincy Douby
2007,Randy Foye,PG,23,300,691,0.4341534008683068,68,185,0.3675675675675676,232,506,0.45849802371541504,164,192,0.8541666666666666,49,169,218,232,53,21,152,184,832,2007_Randy Foye
2007,Rashad McCants,SG,22,62,177,0.3502824858757062,20,75,0.26666666666666666,42,102,0.4117647058823529,40,58,0.6896551724137931,14,33,47,38,26,7,40,71,184,2007_Rashad McCants
2007,Rashard Lewis,SF,27,463,1005,0.4606965174129353,151,387,0.39018087855297157,312,618,0.5048543689320388,265,315,0.8412698412698413,91,305,396,145,68,39,118,143,1342,2007_Rashard Lewis
2007,Reggie Evans,PF,26,117,215,0.5441860465116279,0,0,NaN,117,215,0.5441860465116279,91,183,0.4972677595628415,156,304,460,45,42,16,95,144,325,2007_Reggie Evans
2007,Stephen Jackson,SF_SG_SF-SG,28,818,1888,0.4332627118644068,200,622,0.3215434083601286,618,1266,0.4881516587677725,486,598,0.8127090301003345,122,322,444,574,168,68,366,400,2322,2007_Stephen Jackson
2007,Theo Ratliff,C,33,1,3,0.3333333333333333,0,0,NaN,1,3,0.3333333333333333,3,4,0.75,2,5,7,0,1,3,1,6,5,2007_Theo Ratliff
2007,Vitaly Potapenko,C,31,0,4,0.0,0,0,NaN,0,4,0.0,0,0,NaN,0,2,2,0,0,0,2,3,0,2007_Vitaly Potapenko
2008,Andre Miller,PG,31,569,1156,0.4922145328719723,3,34,0.08823529411764706,566,1122,0.5044563279857398,257,333,0.7717717717717718,95,229,324,565,105,6,206,181,1398,2008_Andre Miller
2008,Craig Smith,PF,24,297,528,0.5625,0,9,0.0,297,519,0.5722543352601156,133,200,0.665,123,230,353,60,36,17,89,217,727,2008_Craig Smith
2008,Didier Ilunga-Mbenga,C,27,78,168,0.4642857142857143,0,0,NaN,78,168,0.4642857142857143,10,24,0.4166666666666667,56,88,144,20,14,52,24,140,166,2008_Didier Ilunga-Mbenga
2008,Fabricio Oberto,PF,32,180,296,0.6081081081081081,0,1,0.0,180,295,0.6101694915254238,37,61,0.6065573770491803,153,277,430,95,37,20,51,203,397,2008_Fabricio Oberto
2008,Mike Bibby,PG,29,496,1206,0.41127694859038144,186,496,0.375,310,710,0.43661971830985913,156,200,0.78,32,288,320,580,108,8,238,194,1334,2008_Mike Bibby
2008,Ramon Sessions,PG,21,51,117,0.4358974358974359,3,7,0.42857142857142855,48,110,0.43636363636363634,32,41,0.7804878048780488,8,50,58,127,17,3,36,26,137,2008_Ramon Sessions
2008,Rashard Lewis,PF,28,516,1135,0.45462555066079297,226,553,0.40867992766726946,290,582,0.49828178694158076,218,260,0.8384615384615385,97,340,437,196,99,38,140,214,1476,2008_Rashard Lewis
2008,Stephen Jackson,SF,29,488,1204,0.4053156146179402,182,501,0.36327345309381237,306,703,0.4352773826458037,308,370,0.8324324324324325,67,251,318,300,92,29,197,171,1466,2008_Stephen Jackson
2008,Tyronn Lue,PG,30,226,506,0.44664031620553357,78,172,0.45348837209302323,148,334,0.4431137724550898,50,64,0.78125,18,90,108,148,22,2,54,132,580,2008_Tyronn Lue
2008,Wilson Chandler,SF,20,106,242,0.4380165289256198,9,30,0.3,97,212,0.45754716981132076,34,54,0.6296296296296297,38,89,127,33,15,16,27,83,255,2008_Wilson Chandler
2009,Beno Udrih,PG,26,321,696,0.46120689655172414,35,113,0.30973451327433627,286,583,0.49056603773584906,123,150,0.82,46,174,220,342,81,12,158,192,800,2009_Beno Udrih
2009,Courtney Lee,SG,23,243,540,0.45,82,203,0.4039408866995074,161,337,0.47774480712166173,78,94,0.8297872340425532,18,160,178,91,76,14,69,157,646,2009_Courtney Lee
2009,Craig Smith,PF,25,289,514,0.5622568093385214,0,1,0.0,289,513,0.5633528265107213,168,248,0.6774193548387096,98,186,284,79,31,19,105,184,746,2009_Craig Smith
2009,Fabricio Oberto,C,33,61,104,0.5865384615384616,0,1,0.0,61,103,0.5922330097087378,20,35,0.5714285714285714,65,77,142,59,7,11,38,95,142,2009_Fabricio Oberto
2009,Grant Hill,SF,36,390,745,0.5234899328859061,24,76,0.3157894736842105,366,669,0.547085201793722,181,224,0.8080357142857143,64,341,405,186,90,54,126,182,985,2009_Grant Hill
2009,J.R. Smith,SG,23,424,950,0.4463157894736842,180,453,0.3973509933774834,244,497,0.4909456740442656,205,272,0.7536764705882353,43,254,297,227,78,14,150,190,1233,2009_J.R. Smith
2009,Kyle Lowry,PG,22,378,868,0.43548387096774194,50,196,0.25510204081632654,328,672,0.4880952380952381,362,452,0.8008849557522124,52,326,378,550,138,34,234,292,1168,2009_Kyle Lowry
2009,Luc Mbah,PF,22,227,491,0.4623217922606925,0,4,0.0,227,487,0.46611909650924027,140,192,0.7291666666666666,189,298,487,87,87,45,100,204,594,2009_Luc Mbah
2009,Michael Ruffin,PF,32,2,7,0.2857142857142857,0,0,NaN,2,7,0.2857142857142857,2,2,1.0,6,5,11,0,3,1,2,7,6,2009_Michael Ruffin
2009,Rashard Lewis,PF,29,478,1089,0.4389348025711662,220,554,0.3971119133574007,258,535,0.4822429906542056,225,269,0.8364312267657993,92,361,453,205,81,51,158,194,1401,2009_Rashard Lewis
2009,Raymond Felton,PG,24,442,1083,0.40812557710064634,59,207,0.28502415458937197,383,876,0.4372146118721461,219,272,0.8051470588235294,54,256,310,553,126,30,228,191,1162,2009_Raymond Felton
2009,Russell Westbrook,PG,20,436,1095,0.39817351598173517,35,129,0.2713178294573643,401,966,0.41511387163561075,349,428,0.8154205607476636,178,221,399,435,110,16,274,191,1256,2009_Russell Westbrook
2009,Sean May,PF,24,39,98,0.3979591836734694,1,1,1.0,38,97,0.3917525773195876,14,20,0.7,20,49,69,10,5,4,26,32,93,2009_Sean May
2009,Will Solomon,PG,30,210,490,0.42857142857142855,56,172,0.32558139534883723,154,318,0.48427672955974843,50,68,0.7352941176470589,24,104,128,266,54,8,108,142,526,2009_Will Solomon
2009,Wilson Chandler,SF,21,455,1054,0.4316888045540797,103,314,0.32802547770700635,352,740,0.4756756756756757,171,215,0.7953488372093023,91,354,445,170,71,75,139,250,1184,2009_Wilson Chandler
2010,D.J. Augustin,PG,22,168,435,0.38620689655172413,70,178,0.39325842696629215,98,257,0.38132295719844356,102,131,0.7786259541984732,11,86,97,193,45,5,74,127,508,2010_D.J. Augustin
2010,Dan Gadzuric,C,31,39,89,0.43820224719101125,0,0,NaN,39,89,0.43820224719101125,10,25,0.4,38,54,92,12,9,13,15,63,88,2010_Dan Gadzuric
2010,Hilton Armstrong,C_PF_PF-C,25,56,158,0.35443037974683544,0,2,0.0,56,156,0.358974358974359,30,64,0.46875,54,108,162,42,30,24,44,118,142,2010_Hilton Armstrong
2010,Jamal Crawford,SG,29,496,1105,0.448868778280543,163,427,0.38173302107728335,333,678,0.4911504424778761,270,315,0.8571428571428571,34,167,201,238,61,12,137,132,1425,2010_Jamal Crawford
2010,Jason Thompson,C,23,370,784,0.4719387755102041,1,10,0.1,369,774,0.47674418604651164,198,277,0.7148014440433214,224,413,637,124,41,73,139,279,939,2010_Jason Thompson
2010,Jerry Stackhouse,SG,35,129,316,0.40822784810126583,45,130,0.34615384615384615,84,186,0.45161290322580644,55,69,0.7971014492753623,19,81,100,70,21,9,66,56,358,2010_Jerry Stackhouse
2010,Kyrylo Fesenko,C,23,52,95,0.5473684210526316,0,1,0.0,52,94,0.5531914893617021,24,57,0.42105263157894735,33,57,90,15,6,19,24,78,128,2010_Kyrylo Fesenko
2010,Marc Gasol,C,25,378,651,0.5806451612903226,0,1,0.0,378,650,0.5815384615384616,252,376,0.6702127659574468,208,432,640,165,69,109,135,254,1008,2010_Marc Gasol
2010,Rashard Lewis,PF,30,350,805,0.43478260869565216,168,423,0.3971631205673759,182,382,0.47643979057591623,145,180,0.8055555555555556,62,256,318,107,78,28,108,180,1013,2010_Rashard Lewis
2010,Richard Jefferson,SF,29,362,775,0.4670967741935484,59,187,0.3155080213903743,303,588,0.5153061224489796,211,287,0.735191637630662,58,298,356,158,45,40,105,178,994,2010_Richard Jefferson
2010,Ryan Hollins,C,25,169,303,0.5577557755775577,0,1,0.0,169,302,0.5596026490066225,109,158,0.689873417721519,79,128,207,51,19,38,95,199,447,2010_Ryan Hollins
2010,Stephen Jackson,SG_PF_SG-PF,31,1200,2836,0.4231311706629055,258,786,0.3282442748091603,942,2050,0.45951219512195124,676,868,0.7788018433179723,156,646,802,600,264,86,518,394,3334,2010_Stephen Jackson
2010,Tyrus Thomas,C_PF_PF-C,23,388,840,0.46190476190476193,0,6,0.0,388,834,0.46522781774580335,240,350,0.6857142857142857,162,508,670,112,126,170,184,258,1016,2010_Tyrus Thomas
2011,Anthony Tolliver,SF,25,141,313,0.4504792332268371,47,115,0.40869565217391307,94,198,0.47474747474747475,105,131,0.8015267175572519,92,203,295,82,28,28,49,145,434,2011_Anthony Tolliver
2011,D.J. Augustin,PG,23,399,958,0.4164926931106472,111,333,0.3333333333333333,288,625,0.4608,269,297,0.9057239057239057,38,187,225,498,54,3,155,152,1178,2011_D.J. Augustin
2011,Devin Ebanks,SG,21,21,51,0.4117647058823529,2,5,0.4,19,46,0.41304347826086957,18,23,0.782608695652174,15,12,27,2,4,5,6,7,62,2011_Devin Ebanks
2011,Jarron Collins,C,32,12,42,0.2857142857142857,0,0,NaN,12,42,0.2857142857142857,14,20,0.7,28,20,48,4,8,2,14,58,38,2011_Jarron Collins
2011,Jerryd Bayless,PG,22,436,1034,0.42166344294003866,98,292,0.3356164383561644,338,742,0.4555256064690027,332,412,0.8058252427184466,52,278,330,532,76,10,254,298,1302,2011_Jerryd Bayless
2011,Paul George,SG,20,179,395,0.4531645569620253,41,138,0.2971014492753623,138,257,0.5369649805447471,77,101,0.7623762376237624,37,187,224,65,62,26,70,127,476,2011_Paul George
2011,Rashard Lewis,SF-PF_SF_PF,31,504,1164,0.4329896907216495,174,488,0.35655737704918034,330,676,0.4881656804733728,154,192,0.8020833333333334,142,438,580,184,104,60,174,318,1336,2011_Rashard Lewis
2011,Stephen Jackson,SG,32,435,1059,0.41076487252124644,121,359,0.3370473537604457,314,700,0.44857142857142857,249,305,0.8163934426229508,53,251,304,241,80,28,209,161,1240,2011_Stephen Jackson
2011,Xavier Henry,SG,19,65,160,0.40625,2,17,0.11764705882352941,63,143,0.4405594405594406,33,52,0.6346153846153846,9,28,37,18,11,3,13,48,165,2011_Xavier Henry
2012,Amir Johnson,PF,24,196,340,0.5764705882352941,2,5,0.4,194,335,0.5791044776119403,58,84,0.6904761904761905,149,259,408,79,33,69,94,209,452,2012_Amir Johnson
2012,Andre Iguodala,SF,28,287,632,0.4541139240506329,76,193,0.39378238341968913,211,439,0.4806378132118451,121,196,0.6173469387755102,56,325,381,339,107,30,115,92,771,2012_Andre Iguodala
2012,Andrew Bynum,C,24,444,796,0.5577889447236181,1,5,0.2,443,791,0.5600505689001264,234,338,0.6923076923076923,192,517,709,85,27,116,152,104,1123,2012_Andrew Bynum
2012,D.J. Augustin,PG,24,183,487,0.3757700205338809,61,179,0.3407821229050279,122,308,0.3961038961038961,105,120,0.875,24,85,109,307,36,1,110,65,532,2012_D.J. Augustin
2012,Damion James,SF,24,13,35,0.37142857142857144,0,1,0.0,13,34,0.38235294117647056,8,12,0.6666666666666666,7,26,33,3,7,7,12,17,34,2012_Damion James
2012,DeAndre Jordan,C,23,206,326,0.6319018404907976,0,1,0.0,206,325,0.6338461538461538,74,141,0.524822695035461,202,344,546,17,30,134,74,189,486,2012_DeAndre Jordan
2012,Lou Amundson,PF,29,89,207,0.42995169082125606,0,0,NaN,89,207,0.42995169082125606,35,82,0.4268292682926829,94,128,222,14,27,44,45,125,213,2012_Lou Amundson
2012,Paul George,SG,21,281,639,0.4397496087636933,90,234,0.38461538461538464,191,405,0.47160493827160493,146,182,0.8021978021978022,56,314,370,158,108,38,117,191,798,2012_Paul George
2012,Rashard Lewis,SF,32,85,221,0.38461538461538464,16,67,0.23880597014925373,69,154,0.44805194805194803,31,37,0.8378378378378378,34,75,109,27,23,10,32,49,217,2012_Rashard Lewis
2012,Ronny Turiaf,C,29,38,66,0.5757575757575758,0,2,0.0,38,64,0.59375,26,44,0.5909090909090909,40,100,140,20,28,34,28,78,102,2012_Ronny Turiaf
2012,Stephen Jackson,SF,33,318,850,0.37411764705882355,98,340,0.28823529411764703,220,510,0.43137254901960786,188,228,0.8245614035087719,44,282,326,236,108,26,206,198,922,2012_Stephen Jackson
2012,Will Bynum,PG,29,74,194,0.38144329896907214,7,29,0.2413793103448276,67,165,0.40606060606060607,49,64,0.765625,10,46,56,66,23,3,54,61,204,2012_Will Bynum
2013,D.J. Augustin,PG,25,103,294,0.35034013605442177,67,190,0.3526315789473684,36,104,0.34615384615384615,83,99,0.8383838383838383,20,71,91,170,34,3,68,64,356,2013_D.J. Augustin
2013,Darius Miller,SF,22,44,108,0.4074074074074074,22,56,0.39285714285714285,22,52,0.4230769230769231,8,8,1.0,8,70,78,44,17,12,23,89,118,2013_Darius Miller
2013,Ivan Johnson,PF,28,185,356,0.5196629213483146,1,13,0.07692307692307693,184,343,0.5364431486880467,81,131,0.6183206106870229,76,190,266,46,56,14,71,131,452,2013_Ivan Johnson
2013,Jamaal Tinsley,PG,34,86,234,0.36752136752136755,39,127,0.30708661417322836,47,107,0.4392523364485981,18,26,0.6923076923076923,17,98,115,290,64,14,106,106,229,2013_Jamaal Tinsley
2013,Kevin Jones,PF,23,43,107,0.40186915887850466,0,0,NaN,43,107,0.40186915887850466,9,15,0.6,38,40,78,10,9,5,8,25,95,2013_Kevin Jones
2013,Paul George,SF,22,493,1176,0.4192176870748299,170,469,0.3624733475479744,323,707,0.45685997171145687,221,274,0.8065693430656934,88,515,603,327,143,51,233,227,1377,2013_Paul George
2013,Rashard Lewis,PF,33,103,249,0.41365461847389556,51,131,0.3893129770992366,52,118,0.4406779661016949,28,45,0.6222222222222222,19,102,121,30,21,14,33,67,285,2013_Rashard Lewis
2013,Ronnie Price,PG,29,39,120,0.325,10,39,0.2564102564102564,29,81,0.35802469135802467,17,24,0.7083333333333334,13,31,44,73,26,3,34,61,105,2013_Ronnie Price
2013,Samuel Dalembert,C,31,137,253,0.541501976284585,1,1,1.0,136,252,0.5396825396825397,38,55,0.6909090909090909,105,171,276,21,17,53,51,90,313,2013_Samuel Dalembert
2013,Stephen Jackson,SF,34,123,330,0.37272727272727274,46,170,0.27058823529411763,77,160,0.48125,49,70,0.7,22,133,155,80,37,14,77,89,341,2013_Stephen Jackson
2014,Chris Smith,PG,26,0,0,NaN,0,0,NaN,0,0,NaN,0,0,NaN,0,0,0,0,0,0,0,0,0,2014_Chris Smith
2014,D.J. Augustin,PG,26,596,1436,0.415041782729805,266,664,0.4006024096385542,330,772,0.4274611398963731,402,454,0.8854625550660793,30,230,260,626,106,6,250,294,1860,2014_D.J. Augustin
2014,Darius Miller,SF,23,73,166,0.4397590361445783,25,77,0.3246753246753247,48,89,0.5393258426966292,29,36,0.8055555555555556,9,43,52,43,24,9,22,88,200,2014_Darius Miller
2014,Derrick Rose,PG,25,58,164,0.35365853658536583,16,47,0.3404255319148936,42,117,0.358974358974359,27,32,0.84375,9,23,32,43,5,1,34,15,159,2014_Derrick Rose
2014,Jimmy Butler,SG,24,275,693,0.3968253968253968,68,240,0.2833333333333333,207,453,0.45695364238410596,260,338,0.7692307692307693,87,243,330,175,127,36,102,106,878,2014_Jimmy Butler
2014,Malcolm Thomas,PF,25,14,32,0.4375,2,8,0.25,12,24,0.5,0,4,0.0,10,32,42,4,0,6,18,10,30,2014_Malcolm Thomas
2014,Manny Harris,SG,24,28,70,0.4,7,20,0.35,21,50,0.42,10,12,0.8333333333333334,7,27,34,11,4,1,9,10,73,2014_Manny Harris
2014,Paul George,SF,23,577,1362,0.4236417033773862,182,500,0.364,395,862,0.4582366589327146,401,464,0.8642241379310345,64,478,542,283,151,22,224,198,1737,2014_Paul George
2014,Rashard Lewis,SF,34,98,236,0.4152542372881356,46,134,0.34328358208955223,52,102,0.5098039215686274,26,33,0.7878787878787878,24,86,110,57,53,8,35,90,268,2014_Rashard Lewis
2014,Robert Covington,SF,23,6,14,0.42857142857142855,4,11,0.36363636363636365,2,3,0.6666666666666666,0,0,NaN,2,3,5,0,2,0,1,3,16,2014_Robert Covington
2014,Rudy Gobert,C,21,36,74,0.4864864864864865,0,0,NaN,36,74,0.4864864864864865,32,65,0.49230769230769234,51,104,155,7,8,41,32,57,104,2014_Rudy Gobert
2014,Sergey Karasev,SF,20,12,35,0.34285714285714286,4,19,0.21052631578947367,8,16,0.5,9,10,0.9,0,16,16,6,3,1,11,22,37,2014_Sergey Karasev
2014,Shelvin Mack,PG,23,209,501,0.4171656686626746,62,184,0.33695652173913043,147,317,0.4637223974763407,64,74,0.8648648648648649,21,139,160,271,50,2,89,100,544,2014_Shelvin Mack
2014,Stephen Jackson,SF,35,6,26,0.23076923076923078,1,14,0.07142857142857142,5,12,0.4166666666666667,2,4,0.5,2,8,10,5,6,1,6,11,15,2014_Stephen Jackson
2014,Troy Daniels,SG,22,15,31,0.4838709677419355,12,25,0.48,3,6,0.5,0,0,NaN,0,4,4,5,0,0,3,6,42,2014_Troy Daniels
2014,Tyson Chandler,C,31,191,322,0.593167701863354,0,1,0.0,191,321,0.5950155763239875,98,155,0.632258064516129,159,370,529,59,36,63,71,145,480,2014_Tyson Chandler
2015,D.J. Augustin,PG,27,516,1294,0.3987635239567233,166,492,0.33739837398373984,350,802,0.43640897755610975,356,410,0.8682926829268293,40,282,322,706,98,6,290,186,1554,2015_D.J. Augustin
2015,Dante Cunningham,PF,27,155,339,0.45722713864306785,1,10,0.1,154,329,0.46808510638297873,29,47,0.6170212765957447,70,186,256,50,46,37,35,101,340,2015_Dante Cunningham
2015,Darius Miller,SF,24,1,7,0.14285714285714285,0,1,0.0,1,6,0.16666666666666666,0,0,NaN,0,1,1,2,1,0,1,8,2,2015_Darius Miller
2015,Donatas Motiejunas,PF,24,353,700,0.5042857142857143,49,133,0.3684210526315789,304,567,0.5361552028218695,100,166,0.6024096385542169,137,284,421,130,56,34,123,203,855,2015_Donatas Motiejunas
2015,Patrick Christopher,SG,26,3,12,0.25,0,4,0.0,3,8,0.375,0,0,NaN,2,4,6,0,1,0,1,6,6,2015_Patrick Christopher
2015,Paul George,SF,24,18,49,0.3673469387755102,9,22,0.4090909090909091,9,27,0.3333333333333333,8,11,0.7272727272727273,4,18,22,6,5,1,12,11,53,2015_Paul George
2015,Rudy Gobert,C,22,258,427,0.6042154566744731,0,2,0.0,258,425,0.6070588235294118,170,273,0.6227106227106227,265,510,775,109,64,189,111,175,686,2015_Rudy Gobert
2015,Shaun Livingston,PG,29,198,396,0.5,0,2,0.0,198,394,0.5025380710659898,65,91,0.7142857142857143,43,140,183,259,49,20,102,110,461,2015_Shaun Livingston
2015,Wesley Johnson,SF,27,286,691,0.41389290882778584,91,259,0.35135135135135137,195,432,0.4513888888888889,90,112,0.8035714285714286,67,252,319,124,59,45,87,162,753,2015_Wesley Johnson
2016,Andrew Nicholson,PF,26,146,310,0.47096774193548385,41,114,0.35964912280701755,105,196,0.5357142857142857,51,65,0.7846153846153846,34,167,201,25,10,22,41,69,384,2016_Andrew Nicholson
2016,Cleanthony Early,SF,24,12,40,0.3,4,15,0.26666666666666666,8,25,0.32,3,4,0.75,4,22,26,6,2,3,9,16,31,2016_Cleanthony Early
2016,D.J. Augustin,PG,28,296,700,0.4228571428571429,136,336,0.40476190476190477,160,364,0.43956043956043955,206,256,0.8046875,16,174,190,396,76,8,168,170,934,2016_D.J. Augustin
2016,Damien Inglis,SF,20,13,37,0.35135135135135137,3,13,0.23076923076923078,10,24,0.4166666666666667,7,8,0.875,2,29,31,10,6,3,11,11,36,2016_Damien Inglis
2016,Derrick Williams,SF,24,254,565,0.4495575221238938,44,150,0.29333333333333333,210,415,0.5060240963855421,194,256,0.7578125,47,249,296,75,29,9,61,69,746,2016_Derrick Williams
2016,Draymond Green,PF,25,401,819,0.4896214896214896,100,258,0.3875968992248062,301,561,0.5365418894830659,229,329,0.6960486322188449,134,635,769,598,119,113,259,240,1131,2016_Draymond Green
2016,Ed Davis,PF,26,206,337,0.6112759643916914,0,0,NaN,206,337,0.6112759643916914,114,204,0.5588235294117647,224,375,599,88,57,72,64,202,526,2016_Ed Davis
2016,Kirk Hinrich,PG,35,98,258,0.3798449612403101,48,124,0.3870967741935484,50,134,0.373134328358209,30,32,0.9375,16,124,140,146,30,4,60,128,274,2016_Kirk Hinrich
2016,Mario Chalmers,PG,29,364,888,0.4099099099099099,92,298,0.3087248322147651,272,590,0.4610169491525424,436,524,0.8320610687022901,48,266,314,460,176,26,220,362,1256,2016_Mario Chalmers
2016,Nick Young,SG,30,126,372,0.3387096774193548,77,237,0.32489451476793246,49,135,0.362962962962963,63,76,0.8289473684210527,14,83,97,34,23,7,30,50,392,2016_Nick Young
2016,Noah Vonleh,PF,20,117,278,0.420863309352518,11,46,0.2391304347826087,106,232,0.45689655172413796,38,51,0.7450980392156863,91,214,305,30,27,26,50,152,283,2016_Noah Vonleh
2016,Pat Connaughton,SG,23,13,49,0.2653061224489796,5,21,0.23809523809523808,8,28,0.2857142857142857,5,5,1.0,11,21,32,10,2,0,10,6,36,2016_Pat Connaughton
2016,Paul George,SF,25,605,1449,0.41752933057280883,210,566,0.3710247349823322,395,883,0.44733861834654587,454,528,0.8598484848484849,79,484,563,329,152,29,265,230,1874,2016_Paul George
2016,Rashad Vaughn,SG,19,81,266,0.30451127819548873,43,147,0.2925170068027211,38,119,0.31932773109243695,12,15,0.8,11,77,88,39,29,16,28,73,217,2016_Rashad Vaughn
2016,Rudy Gobert,C,23,198,354,0.559322033898305,0,0,NaN,198,354,0.559322033898305,161,283,0.568904593639576,208,460,668,91,45,135,114,163,557,2016_Rudy Gobert
2017,Alonzo Gee,SF,29,3,14,0.21428571428571427,0,3,0.0,3,11,0.2727272727272727,5,9,0.5555555555555556,4,11,15,6,5,1,4,14,11,2017_Alonzo Gee
2017,D.J. Augustin,PG,29,195,517,0.3771760154738878,95,274,0.3467153284671533,100,243,0.411522633744856,131,161,0.8136645962732919,15,102,117,209,31,1,90,101,616,2017_D.J. Augustin
2017,Dewayne Dedmon,C,27,161,259,0.6216216216216216,0,0,NaN,161,259,0.6216216216216216,65,93,0.6989247311827957,129,366,495,44,37,61,61,180,387,2017_Dewayne Dedmon
2017,Kevin Durant,SF,28,551,1026,0.5370370370370371,117,312,0.375,434,714,0.6078431372549019,336,384,0.875,39,474,513,300,66,99,138,117,1555,2017_Kevin Durant
2017,Nikola Vucevic,C,26,483,1031,0.4684772065955383,23,75,0.30666666666666664,460,956,0.4811715481171548,107,160,0.66875,176,603,779,208,77,74,117,180,1096,2017_Nikola Vucevic
2017,Noah Vonleh,PF,21,130,270,0.48148148148148145,7,20,0.35,123,250,0.492,60,94,0.6382978723404256,131,256,387,31,30,27,64,154,327,2017_Noah Vonleh
2017,Pat Connaughton,SG,24,37,72,0.5138888888888888,17,33,0.5151515151515151,20,39,0.5128205128205128,7,9,0.7777777777777778,10,42,52,28,6,2,17,23,98,2017_Pat Connaughton
2017,Paul George,SF,26,622,1349,0.46108228317272054,195,496,0.39314516129032256,427,853,0.5005861664712778,336,374,0.8983957219251337,58,434,492,251,117,27,218,206,1775,2017_Paul George
2017,Rudy Gobert,C,24,413,624,0.6618589743589743,0,1,0.0,413,623,0.6629213483146067,311,476,0.6533613445378151,314,721,1035,97,49,214,148,246,1137,2017_Rudy Gobert
2017,T.J. McConnell,PG,24,236,512,0.4609375,11,55,0.2,225,457,0.4923413566739606,73,90,0.8111111111111111,39,212,251,534,134,10,159,139,556,2017_T.J. McConnell
2017,Tim Hardaway,SG,24,415,912,0.4550438596491228,149,417,0.35731414868105515,266,495,0.5373737373737374,164,214,0.7663551401869159,35,189,224,182,55,15,106,103,1143,2017_Tim Hardaway
2017,Tyler Zeller,C,27,78,158,0.4936708860759494,0,1,0.0,78,157,0.4968152866242038,22,39,0.5641025641025641,43,81,124,42,7,21,20,61,178,2017_Tyler Zeller
2003,A.J. Guyton,PG,24,0,4,0.0,0,1,0.0,0,3,0.0,0,0,NaN,0,0,0,2,1,0,1,0,0,2003_A.J. Guyton
2003,Andre Miller,PG,26,377,928,0.40625,23,108,0.21296296296296297,354,820,0.4317073170731707,311,391,0.7953964194373402,84,232,316,537,99,11,206,203,1088,2003_Andre Miller
2003,Dan Langhi,SF,25,81,202,0.400990099009901,9,31,0.2903225806451613,72,171,0.42105263157894735,12,20,0.6,19,68,87,21,15,6,16,58,183,2003_Dan Langhi
2003,Eric Snow,PG,29,361,799,0.4518147684605757,7,32,0.21875,354,767,0.46153846153846156,325,379,0.8575197889182058,71,230,301,544,133,11,194,235,1054,2003_Eric Snow
2003,Erick Dampier,C,27,259,522,0.49616858237547895,0,2,0.0,259,520,0.4980769230769231,155,222,0.6981981981981982,248,295,543,58,27,154,112,242,673,2003_Erick Dampier
2003,Kerry Kittles,SG,28,332,711,0.4669479606188467,78,219,0.3561643835616438,254,492,0.516260162601626,106,135,0.7851851851851852,52,200,252,170,101,30,55,110,848,2003_Kerry Kittles
2003,Kobe Bryant,SG,24,868,1924,0.45114345114345117,124,324,0.38271604938271603,744,1600,0.465,601,713,0.8429172510518934,106,458,564,481,181,67,288,218,2461,2003_Kobe Bryant
2003,Lorenzen Wright,C,27,325,716,0.45391061452513964,0,5,0.0,325,711,0.4571026722925457,147,223,0.6591928251121076,170,358,528,80,51,54,110,209,797,2003_Lorenzen Wright
2003,Marko Jaric,SF,24,179,446,0.4013452914798206,53,166,0.3192771084337349,126,280,0.45,79,105,0.7523809523809524,35,125,160,193,97,11,103,125,490,2003_Marko Jaric
2003,Pat Burke,C,29,113,296,0.38175675675675674,1,7,0.14285714285714285,112,289,0.3875432525951557,40,58,0.6896551724137931,57,89,146,23,19,25,47,99,267,2003_Pat Burke
2003,Roger Mason,SF,22,11,31,0.3548387096774194,6,18,0.3333333333333333,5,13,0.38461538461538464,2,2,1.0,2,10,12,12,4,0,5,20,30,2003_Roger Mason
2003,Tariq Abdul-Wahad,SG,28,27,58,0.46551724137931033,0,1,0.0,27,57,0.47368421052631576,3,6,0.5,14,26,40,21,6,3,7,26,57,2003_Tariq Abdul-Wahad
2003,Tyronn Lue,PG,25,248,573,0.4328097731239092,60,176,0.3409090909090909,188,397,0.473551637279597,91,104,0.875,22,127,149,263,47,1,77,151,647,2003_Tyronn Lue
2004,Alonzo Mourning,C,33,33,71,0.4647887323943662,0,0,NaN,33,71,0.4647887323943662,30,34,0.8823529411764706,8,19,27,8,2,6,10,32,96,2004_Alonzo Mourning
2004,Chris Wilcox,C,21,227,436,0.5206422018348624,0,1,0.0,227,435,0.5218390804597701,105,150,0.7,125,180,305,51,29,20,80,183,559,2004_Chris Wilcox
2004,Eddy Curry,PF,21,417,840,0.49642857142857144,1,1,1.0,416,839,0.4958283671036949,235,350,0.6714285714285714,143,308,451,68,24,83,177,258,1070,2004_Eddy Curry
2004,Elden Campbell,C,35,138,314,0.4394904458598726,0,0,NaN,138,314,0.4394904458598726,85,124,0.6854838709677419,52,157,209,45,21,50,63,137,361,2004_Elden Campbell
2004,Erick Dampier,C,28,348,650,0.5353846153846153,0,2,0.0,348,648,0.5370370370370371,217,332,0.6536144578313253,344,543,887,60,33,137,131,227,913,2004_Erick Dampier
2004,Ira Newble,SF,29,108,276,0.391304347826087,2,19,0.10526315789473684,106,257,0.41245136186770426,36,46,0.782608695652174,65,90,155,72,25,19,54,109,254,2004_Ira Newble
2004,Josh Davis,PF,23,2,5,0.4,0,2,0.0,2,3,0.6666666666666666,1,1,1.0,1,4,5,0,0,0,2,3,5,2004_Josh Davis
2004,Kerry Kittles,SG,29,434,959,0.45255474452554745,97,276,0.35144927536231885,337,683,0.493411420204978,107,136,0.7867647058823529,56,271,327,206,125,40,95,144,1072,2004_Kerry Kittles
2004,Kobe Bryant,SG,25,516,1178,0.4380305602716469,71,217,0.3271889400921659,445,961,0.4630593132154006,454,533,0.851782363977486,103,256,359,330,112,28,171,176,1557,2004_Kobe Bryant
2004,Lorenzen Wright,C,28,257,586,0.43856655290102387,0,5,0.0,257,581,0.4423407917383821,96,131,0.732824427480916,144,301,445,71,45,58,77,192,610,2004_Lorenzen Wright
2004,Marko Jaric,PG,25,185,477,0.38784067085953877,51,150,0.34,134,327,0.40978593272171254,74,101,0.7326732673267327,44,131,175,281,93,20,115,132,495,2004_Marko Jaric
2004,Matt Barnes,SF,23,63,138,0.45652173913043476,2,13,0.15384615384615385,61,125,0.488,43,61,0.7049180327868853,53,98,151,48,27,3,44,76,171,2004_Matt Barnes
2004,Michael Ruffin,PF,27,38,117,0.3247863247863248,0,0,NaN,38,117,0.3247863247863248,16,38,0.42105263157894735,78,129,207,41,22,21,42,103,92,2004_Michael Ruffin
2004,Roger Mason,SG,23,64,196,0.32653061224489793,26,78,0.3333333333333333,38,118,0.3220338983050847,38,44,0.8636363636363636,2,60,62,52,22,12,40,72,192,2004_Roger Mason
2004,Voshon Lenard,SG,30,394,933,0.42229367631296894,106,289,0.36678200692041524,288,644,0.4472049689440994,144,182,0.7912087912087912,46,154,200,151,61,12,101,177,1038,2004_Voshon Lenard
2005,Alonzo Mourning,C_PF_C-PF,34,200,424,0.4716981132075472,0,0,NaN,200,424,0.4716981132075472,164,282,0.5815602836879432,106,290,396,36,16,148,114,164,564,2005_Alonzo Mourning
2005,Calvin Booth,C,28,98,216,0.4537037037037037,0,2,0.0,98,214,0.45794392523364486,52,64,0.8125,58,156,214,16,30,56,32,156,248,2005_Calvin Booth
2005,Chris Andersen,C,26,191,358,0.5335195530726257,0,3,0.0,191,355,0.5380281690140845,131,190,0.6894736842105263,137,273,410,71,14,100,64,144,513,2005_Chris Andersen
2005,Eddie Gill,PG,26,81,242,0.3347107438016529,36,117,0.3076923076923077,45,125,0.36,71,81,0.8765432098765432,16,96,112,83,59,5,60,105,269,2005_Eddie Gill
2005,Erick Dampier,C,29,202,367,0.5504087193460491,0,3,0.0,202,364,0.554945054945055,138,228,0.6052631578947368,183,318,501,51,15,80,102,205,542,2005_Erick Dampier
2005,Jamal Crawford,SG,24,437,1097,0.398359161349134,185,512,0.361328125,252,585,0.4307692307692308,182,216,0.8425925925925926,33,170,203,302,92,19,148,135,1241,2005_Jamal Crawford
2005,Jelani McCoy,C,27,7,13,0.5384615384615384,0,0,NaN,7,13,0.5384615384615384,1,5,0.2,7,14,21,0,3,8,6,24,15,2005_Jelani McCoy
2005,Jerry Stackhouse,SG,30,274,662,0.41389728096676737,32,120,0.26666666666666666,242,542,0.44649446494464945,253,298,0.8489932885906041,38,145,183,127,53,10,106,104,833,2005_Jerry Stackhouse
2005,Kelvin Cato,C,30,160,297,0.5387205387205387,0,0,NaN,160,297,0.5387205387205387,112,143,0.7832167832167832,102,314,416,40,55,82,64,170,432,2005_Kelvin Cato
2005,Kevin Willis,C,42,35,90,0.3888888888888889,0,2,0.0,35,88,0.3977272727272727,17,23,0.7391304347826086,29,47,76,9,8,7,15,53,87,2005_Kevin Willis
2005,Kobe Bryant,SG,26,573,1324,0.43277945619335345,131,387,0.3385012919896641,442,937,0.47171824973319104,542,664,0.8162650602409639,95,297,392,398,86,53,270,174,1819,2005_Kobe Bryant
2005,Lorenzen Wright,C,29,320,683,0.4685212298682284,0,3,0.0,320,680,0.47058823529411764,131,198,0.6616161616161617,177,436,613,87,58,69,100,251,771,2005_Lorenzen Wright
2005,Mark Jones,SF,29,9,31,0.2903225806451613,0,4,0.0,9,27,0.3333333333333333,5,10,0.5,6,7,13,6,5,2,3,16,23,2005_Mark Jones
2005,Marko Jaric,PG,26,189,457,0.4135667396061269,56,151,0.3708609271523179,133,306,0.434640522875817,59,82,0.7195121951219512,20,141,161,303,84,17,98,107,493,2005_Marko Jaric
2005,Matt Barnes,SF,24,62,151,0.4105960264900662,5,22,0.22727272727272727,57,129,0.4418604651162791,35,58,0.603448275862069,49,84,133,57,30,7,45,80,164,2005_Matt Barnes
2005,Voshon Lenard,SG,31,10,26,0.38461538461538464,4,12,0.3333333333333333,6,14,0.42857142857142855,5,8,0.625,0,6,6,6,1,0,2,2,29,2005_Voshon Lenard
2006,Aaron Williams,C,34,182,352,0.5170454545454546,0,0,NaN,182,352,0.5170454545454546,80,116,0.6896551724137931,128,234,362,34,34,42,60,276,444,2006_Aaron Williams
2006,Alonzo Mourning,C,35,188,315,0.5968253968253968,0,1,0.0,188,314,0.5987261146496815,133,224,0.59375,125,234,359,11,13,173,79,177,509,2006_Alonzo Mourning
2006,Boniface N'Dong,C,28,22,53,0.41509433962264153,0,1,0.0,22,52,0.4230769230769231,6,9,0.6666666666666666,15,22,37,7,2,5,6,23,50,2006_Boniface N'Dong
2006,Channing Frye,C,22,305,640,0.4765625,3,9,0.3333333333333333,302,631,0.4786053882725832,189,229,0.8253275109170306,138,236,374,53,30,47,97,200,802,2006_Channing Frye
2006,Earl Boykins,PG,29,271,661,0.40998487140695916,62,179,0.3463687150837989,209,482,0.4336099585062241,152,174,0.8735632183908046,21,60,81,230,48,4,83,73,756,2006_Earl Boykins
2006,Fred Jones,SG,26,233,559,0.41681574239713776,63,187,0.33689839572192515,170,372,0.45698924731182794,122,160,0.7625,18,152,170,154,55,20,107,142,651,2006_Fred Jones
2006,Josh Powell,PF,23,37,81,0.4567901234567901,0,0,NaN,37,81,0.4567901234567901,36,45,0.8,28,53,81,9,7,4,22,52,110,2006_Josh Powell
2006,Kelvin Cato,C,31,72,168,0.42857142857142855,0,0,NaN,72,168,0.42857142857142855,52,70,0.7428571428571429,40,100,140,8,12,24,36,104,196,2006_Kelvin Cato
2006,Kobe Bryant,SG,27,978,2173,0.4500690289921767,180,518,0.3474903474903475,798,1655,0.48217522658610273,696,819,0.8498168498168498,71,354,425,360,147,30,250,233,2832,2006_Kobe Bryant
2006,Marko Jaric,PG,27,226,566,0.3992932862190813,40,133,0.3007518796992481,186,433,0.4295612009237875,95,138,0.6884057971014492,60,173,233,293,108,21,127,189,587,2006_Marko Jaric
2006,Matt Barnes,SF_PF_PF-SF,25,140,280,0.5,6,30,0.2,134,250,0.536,64,94,0.6808510638297872,96,146,242,56,40,14,60,200,350,2006_Matt Barnes
2006,Moochie Norris,PG,32,92,224,0.4107142857142857,8,28,0.2857142857142857,84,196,0.42857142857142855,58,84,0.6904761904761905,24,84,108,100,40,2,66,98,250,2006_Moochie Norris
2006,Voshon Lenard,SG,32,150,382,0.39267015706806285,50,156,0.32051282051282054,100,226,0.4424778761061947,32,62,0.5161290322580645,10,84,94,82,42,8,62,78,382,2006_Voshon Lenard
2007,Alonzo Mourning,C,36,238,425,0.56,0,0,NaN,238,425,0.56,185,308,0.6006493506493507,126,224,350,18,13,178,129,219,661,2007_Alonzo Mourning
2007,Andre Iguodala,SG,23,443,991,0.44702320887991925,48,155,0.3096774193548387,395,836,0.47248803827751196,452,551,0.8203266787658802,77,357,434,432,152,33,261,200,1386,2007_Andre Iguodala
2007,Channing Frye,PF,23,298,689,0.432510885341074,3,18,0.16666666666666666,295,671,0.4396423248882265,85,108,0.7870370370370371,91,304,395,67,36,42,100,216,684,2007_Channing Frye
2007,Donyell Marshall,PF,33,209,493,0.4239350912778905,95,271,0.3505535055350554,114,222,0.5135135135135135,53,80,0.6625,86,237,323,46,39,43,67,130,566,2007_Donyell Marshall
2007,Josh Powell,PF,24,86,186,0.46236559139784944,0,0,NaN,86,186,0.46236559139784944,60,84,0.7142857142857143,48,128,176,42,10,24,58,122,232,2007_Josh Powell
2007,Kelvin Cato,C,32,7,22,0.3181818181818182,0,0,NaN,7,22,0.3181818181818182,8,12,0.6666666666666666,12,19,31,0,3,10,6,10,22,2007_Kelvin Cato
2007,Kobe Bryant,SG,28,813,1757,0.46272054638588506,137,398,0.3442211055276382,676,1359,0.4974245768947756,667,768,0.8684895833333334,75,364,439,413,111,36,255,205,2430,2007_Kobe Bryant
2007,Lou Amundson,PF,24,12,30,0.4,0,0,NaN,12,30,0.4,8,20,0.4,26,30,56,2,2,16,10,30,32,2007_Lou Amundson
2007,Marko Jaric,SG,28,136,325,0.41846153846153844,32,85,0.3764705882352941,104,240,0.43333333333333335,67,88,0.7613636363636364,54,130,184,145,75,16,88,172,371,2007_Marko Jaric
2007,Matt Barnes,PF,26,275,628,0.43789808917197454,106,290,0.36551724137931035,169,338,0.5,90,123,0.7317073170731707,91,259,350,156,73,41,105,188,746,2007_Matt Barnes
2007,Richard Hamilton,SG,28,547,1170,0.4675213675213675,44,129,0.34108527131782945,503,1041,0.48318924111431316,347,403,0.8610421836228288,75,207,282,285,59,15,159,232,1485,2007_Richard Hamilton
2007,Roger Mason,SG,26,59,179,0.329608938547486,33,102,0.3235294117647059,26,77,0.33766233766233766,14,16,0.875,7,38,45,35,13,6,19,66,165,2007_Roger Mason
2007,Ronny Turiaf,C,24,147,268,0.5485074626865671,0,1,0.0,147,267,0.550561797752809,89,134,0.664179104477612,88,171,259,63,17,78,52,202,383,2007_Ronny Turiaf
2007,Speedy Claxton,PG,28,91,278,0.3273381294964029,6,28,0.21428571428571427,85,250,0.34,33,60,0.55,12,69,81,185,72,4,75,131,221,2007_Speedy Claxton
2007,Steve Novak,SF,23,18,50,0.36,13,39,0.3333333333333333,5,11,0.45454545454545453,2,2,1.0,4,22,26,6,5,0,4,21,51,2007_Steve Novak
2008,Alonzo Mourning,C,37,52,95,0.5473684210526316,0,0,NaN,52,95,0.5473684210526316,45,76,0.5921052631578947,34,59,93,7,4,42,25,56,149,2008_Alonzo Mourning
2008,Antoine Walker,PF,31,136,375,0.3626666666666667,61,188,0.324468085106383,75,187,0.40106951871657753,35,66,0.5303030303030303,56,112,168,45,33,8,46,80,368,2008_Antoine Walker
2008,Caron Butler,SF,27,439,943,0.46553552492046657,66,185,0.3567567567567568,373,758,0.4920844327176781,236,262,0.9007633587786259,93,295,388,284,128,20,150,160,1180,2008_Caron Butler
2008,Channing Frye,C,24,221,453,0.4878587196467991,3,10,0.3,218,443,0.49209932279909707,85,109,0.7798165137614679,107,247,354,57,29,27,55,208,530,2008_Channing Frye
2008,Josh Powell,C,25,145,315,0.4603174603174603,0,3,0.0,145,312,0.46474358974358976,63,87,0.7241379310344828,115,216,331,47,14,23,65,130,353,2008_Josh Powell
2008,Kobe Bryant,SG,29,775,1690,0.45857988165680474,150,415,0.3614457831325301,625,1275,0.49019607843137253,623,742,0.839622641509434,94,423,517,441,151,40,257,227,2323,2008_Kobe Bryant
2008,Marko Jaric,SG,29,227,528,0.42992424242424243,46,127,0.36220472440944884,181,401,0.4513715710723192,121,163,0.7423312883435583,38,184,222,311,97,32,128,180,621,2008_Marko Jaric
2008,Matt Barnes,PF,27,187,442,0.4230769230769231,53,181,0.292817679558011,134,261,0.5134099616858238,59,79,0.7468354430379747,94,230,324,139,48,36,85,159,486,2008_Matt Barnes
2008,Matt Carroll,SG,27,252,589,0.42784380305602715,105,241,0.43568464730290457,147,348,0.4224137931034483,111,138,0.8043478260869565,33,193,226,73,46,19,58,187,720,2008_Matt Carroll
2008,Roger Mason,PG,27,266,600,0.44333333333333336,130,327,0.39755351681957185,136,273,0.4981684981684982,62,71,0.8732394366197183,17,113,130,134,40,18,69,140,724,2008_Roger Mason
2008,Ronnie Price,PG,24,88,204,0.43137254901960786,26,75,0.3466666666666667,62,129,0.4806201550387597,26,38,0.6842105263157895,8,38,46,78,32,3,30,83,228,2008_Ronnie Price
2008,Shawn Marion,PF,29,800,1574,0.5082592121982211,132,396,0.3333333333333333,668,1178,0.567062818336163,212,300,0.7066666666666667,272,1014,1286,276,250,170,172,300,1944,2008_Shawn Marion
2008,Steve Novak,SF,24,49,102,0.4803921568627451,34,71,0.4788732394366197,15,31,0.4838709677419355,3,4,0.75,4,31,35,6,2,3,4,17,135,2008_Steve Novak
2008,Stromile Swift,PF,28,270,530,0.5094339622641509,0,4,0.0,270,526,0.5133079847908745,146,218,0.6697247706422018,128,270,398,52,30,108,102,226,686,2008_Stromile Swift
2009,Channing Frye,PF,25,113,267,0.4232209737827715,11,33,0.3333333333333333,102,234,0.4358974358974359,26,36,0.7222222222222222,41,99,140,24,17,16,29,106,263,2009_Channing Frye
2009,Derrick Rose,PG,20,574,1208,0.47516556291390727,16,72,0.2222222222222222,558,1136,0.49119718309859156,197,250,0.788,96,221,317,512,66,18,202,125,1361,2009_Derrick Rose
2009,Jared Jeffries,SF,27,120,273,0.43956043956043955,1,12,0.08333333333333333,119,261,0.4559386973180077,55,90,0.6111111111111112,128,103,231,80,47,33,65,153,296,2009_Jared Jeffries
2009,Jason Kidd,PG,35,257,618,0.41585760517799353,131,323,0.4055727554179567,126,295,0.4271186440677966,86,105,0.819047619047619,85,415,500,702,160,39,185,168,731,2009_Jason Kidd
2009,Joel Anthony,C,26,57,118,0.4830508474576271,0,0,NaN,57,118,0.4830508474576271,30,46,0.6521739130434783,89,108,197,27,20,93,41,139,144,2009_Joel Anthony
2009,Josh Powell,PF,26,106,239,0.4435146443514644,0,0,NaN,106,239,0.4435146443514644,38,50,0.76,71,105,176,27,9,17,51,98,250,2009_Josh Powell
2009,Luis Scola,PF,28,424,799,0.5306633291614519,0,3,0.0,424,796,0.5326633165829145,196,258,0.7596899224806202,200,520,720,123,68,11,123,261,1044,2009_Luis Scola
2009,Matt Barnes,PF,28,285,674,0.4228486646884273,117,341,0.34310850439882695,168,333,0.5045045045045045,101,136,0.7426470588235294,79,342,421,212,52,26,130,209,788,2009_Matt Barnes
2009,Roger Mason,SG,28,349,822,0.4245742092457421,166,394,0.4213197969543147,183,428,0.42757009345794394,105,118,0.8898305084745762,16,235,251,173,40,12,100,160,969,2009_Roger Mason
2009,Steve Novak,PF,25,176,396,0.4444444444444444,119,286,0.4160839160839161,57,110,0.5181818181818182,21,23,0.9130434782608695,19,106,125,40,20,5,23,71,492,2009_Steve Novak
2010,Adam Morrison,SF,25,32,85,0.3764705882352941,5,21,0.23809523809523808,27,64,0.421875,5,8,0.625,10,22,32,18,3,2,10,17,74,2010_Adam Morrison
2010,Brandon Bass,PF,24,119,233,0.5107296137339056,0,0,NaN,119,233,0.5107296137339056,52,63,0.8253968253968254,54,73,127,19,12,27,31,69,290,2010_Brandon Bass
2010,Dahntay Jones,SF,29,287,623,0.4606741573033708,4,32,0.125,283,591,0.47884940778341795,198,257,0.7704280155642024,48,181,229,150,40,39,129,237,776,2010_Dahntay Jones
2010,Erick Dampier,C,34,133,213,0.6244131455399061,1,3,0.3333333333333333,132,210,0.6285714285714286,61,101,0.6039603960396039,128,272,400,31,15,77,61,153,328,2010_Erick Dampier
2010,Gerald Henderson,SG,22,37,104,0.3557692307692308,4,19,0.21052631578947367,33,85,0.38823529411764707,35,47,0.7446808510638298,15,40,55,13,10,9,14,25,113,2010_Gerald Henderson
2010,Gilbert Arenas,PG,28,253,616,0.4107142857142857,63,181,0.34806629834254144,190,435,0.4367816091954023,153,207,0.7391304347826086,17,116,133,230,41,9,117,95,722,2010_Gilbert Arenas
2010,Kobe Bryant,SG,31,716,1569,0.45634161886551944,99,301,0.3289036544850498,617,1268,0.4865930599369085,439,541,0.8114602587800369,78,313,391,365,113,20,233,187,1970,2010_Kobe Bryant
2010,Marcus Thornton,SG,22,398,883,0.4507361268403171,117,313,0.3738019169329074,281,570,0.49298245614035086,144,177,0.8135593220338984,72,139,211,114,58,11,76,127,1057,2010_Marcus Thornton
2010,Marquis Daniels,SF,29,124,249,0.4979919678714859,6,28,0.21428571428571427,118,221,0.5339366515837104,34,56,0.6071428571428571,27,68,95,66,27,6,42,91,288,2010_Marquis Daniels
2010,Sonny Weems,SG,23,236,458,0.5152838427947598,2,15,0.13333333333333333,234,443,0.5282167042889391,44,64,0.6875,42,150,192,101,39,25,65,126,518,2010_Sonny Weems
2010,T.J. Ford,PG,26,186,418,0.4449760765550239,8,50,0.16,178,368,0.483695652173913,104,135,0.7703703703703704,41,108,149,180,44,11,90,102,484,2010_T.J. Ford
2010,Travis Diener,PG,27,4,20,0.2,2,14,0.14285714285714285,2,6,0.3333333333333333,2,8,0.25,0,6,6,16,8,0,0,4,12,2010_Travis Diener
2010,Vladimir Radmanovic,PF,29,206,546,0.3772893772893773,60,216,0.2777777777777778,146,330,0.44242424242424244,40,54,0.7407407407407407,102,254,356,90,58,14,88,194,512,2010_Vladimir Radmanovic
2011,A.J. Price,PG,24,114,320,0.35625,41,149,0.2751677852348993,73,171,0.4269005847953216,54,81,0.6666666666666666,16,56,72,111,29,1,53,61,323,2011_A.J. Price
2011,DaJuan Summers,SF,23,28,69,0.4057971014492754,9,21,0.42857142857142855,19,48,0.3958333333333333,9,20,0.45,2,10,12,2,3,1,13,21,74,2011_DaJuan Summers
2011,Erick Dampier,C,35,52,89,0.5842696629213483,0,1,0.0,52,88,0.5909090909090909,24,44,0.5454545454545454,53,124,177,22,14,47,32,82,128,2011_Erick Dampier
2011,Gerald Wallace,SF-PF_SF_PF,28,772,1702,0.4535840188014101,124,372,0.3333333333333333,648,1330,0.48721804511278194,558,748,0.7459893048128342,222,916,1138,346,210,126,304,366,2226,2011_Gerald Wallace
2011,Kobe Bryant,SG,32,740,1639,0.4514948139109213,115,356,0.32303370786516855,625,1283,0.48713951675759937,483,583,0.8284734133790738,83,336,419,388,99,12,243,172,2078,2011_Kobe Bryant
2011,Marcus Thornton,SG,23,700,1614,0.43370508054522927,176,480,0.36666666666666664,524,1134,0.4620811287477954,290,368,0.7880434782608695,122,394,516,270,128,18,186,220,1866,2011_Marcus Thornton
2011,Matt Barnes,SF,30,131,279,0.46953405017921146,34,107,0.3177570093457944,97,172,0.563953488372093,60,77,0.7792207792207793,73,155,228,71,39,22,58,127,356,2011_Matt Barnes
2011,Nick Young,SG,25,412,935,0.4406417112299465,105,271,0.3874538745387454,307,664,0.4623493975903614,186,228,0.8157894736842105,26,148,174,75,45,17,90,144,1115,2011_Nick Young
2011,Quincy Pondexter,SF,22,73,180,0.40555555555555556,18,50,0.36,55,130,0.4230769230769231,24,34,0.7058823529411765,23,65,88,28,17,10,16,63,188,2011_Quincy Pondexter
2011,Roger Mason,SG,30,26,77,0.33766233766233766,16,44,0.36363636363636365,10,33,0.30303030303030304,7,10,0.7,5,38,43,20,6,2,6,25,75,2011_Roger Mason
2011,Semih Erden,C,24,124,222,0.5585585585585585,0,0,NaN,124,222,0.5585585585585585,78,120,0.65,74,162,236,40,30,48,68,208,326,2011_Semih Erden
2011,Sonny Weems,SF,24,228,513,0.4444444444444444,17,61,0.2786885245901639,211,452,0.4668141592920354,72,94,0.7659574468085106,39,114,153,104,34,2,86,87,545,2011_Sonny Weems
2011,T.J. Ford,PG,27,91,236,0.3855932203389831,6,32,0.1875,85,204,0.4166666666666667,35,48,0.7291666666666666,17,64,81,141,35,8,63,69,223,2011_T.J. Ford
2011,Zydrunas Ilgauskas,C,35,162,319,0.5078369905956113,0,1,0.0,162,318,0.5094339622641509,36,46,0.782608695652174,108,179,287,26,23,58,52,185,360,2011_Zydrunas Ilgauskas
2012,Brian Cardinal,SF,34,14,55,0.2545454545454545,10,49,0.20408163265306123,4,6,0.6666666666666666,5,6,0.8333333333333334,4,30,34,16,8,2,8,38,43,2012_Brian Cardinal
2012,Carldell Johnson,PG,29,11,35,0.3142857142857143,4,15,0.26666666666666666,7,20,0.35,1,3,0.3333333333333333,1,8,9,22,8,0,7,11,27,2012_Carldell Johnson
2012,Cole Aldrich,C,23,22,42,0.5238095238095238,0,0,NaN,22,42,0.5238095238095238,13,14,0.9285714285714286,13,35,48,3,8,16,9,22,57,2012_Cole Aldrich
2012,DeJuan Blair,PF,22,269,504,0.5337301587301587,0,1,0.0,269,503,0.5347912524850894,73,119,0.6134453781512605,154,197,351,78,59,12,92,168,611,2012_DeJuan Blair
2012,Erick Dampier,C,36,1,8,0.125,0,0,NaN,1,8,0.125,0,0,NaN,10,15,25,4,1,4,3,9,2,2012_Erick Dampier
2012,Josh Smith,PF,26,504,1101,0.45776566757493187,28,109,0.25688073394495414,476,992,0.4798387096774194,203,322,0.6304347826086957,136,496,632,257,93,115,164,172,1239,2012_Josh Smith
2012,Kobe Bryant,SG,33,574,1336,0.4296407185628742,87,287,0.30313588850174217,487,1049,0.4642516682554814,381,451,0.844789356984479,66,247,313,264,69,18,204,105,1616,2012_Kobe Bryant
2012,Marcus Thornton,SG,24,352,803,0.4383561643835616,107,310,0.34516129032258064,245,493,0.4969574036511156,141,163,0.8650306748466258,84,104,188,98,71,12,84,111,952,2012_Marcus Thornton
2012,Matt Barnes,SF,31,175,387,0.45219638242894056,46,138,0.3333333333333333,129,249,0.5180722891566265,95,128,0.7421875,97,247,344,126,35,48,73,152,491,2012_Matt Barnes
2012,Roger Mason,SG,31,103,258,0.3992248062015504,59,154,0.38311688311688313,44,104,0.4230769230769231,21,27,0.7777777777777778,7,62,69,47,13,5,32,33,286,2012_Roger Mason
2012,Ryan Reid,PF,25,4,5,0.8,0,0,NaN,4,5,0.8,0,0,NaN,1,1,2,0,0,0,1,1,8,2012_Ryan Reid
2012,Semih Erden,C,25,39,74,0.527027027027027,0,0,NaN,39,74,0.527027027027027,21,41,0.5121951219512195,20,52,72,9,10,5,16,60,99,2012_Semih Erden
2012,Shelden Williams,C,28,96,201,0.47761194029850745,0,0,NaN,96,201,0.47761194029850745,76,104,0.7307692307692307,141,209,350,35,47,39,66,149,268,2012_Shelden Williams
2012,T.J. Ford,PG,28,19,43,0.4418604651162791,2,8,0.25,17,35,0.4857142857142857,11,14,0.7857142857142857,3,15,18,45,9,2,23,23,51,2012_T.J. Ford
2012,Tim Duncan,C,35,361,733,0.4924965893587995,0,4,0.0,361,729,0.49519890260631,173,249,0.6947791164658634,110,410,520,132,38,88,97,98,895,2012_Tim Duncan
2013,Corey Maggette,SF,33,27,76,0.35526315789473684,5,21,0.23809523809523808,22,55,0.4,36,48,0.75,5,20,25,19,6,2,17,42,95,2013_Corey Maggette
2013,Deron Williams,PG,28,495,1124,0.4403914590747331,169,447,0.378076062639821,326,677,0.4815361890694239,317,369,0.8590785907859079,29,203,232,604,75,30,218,194,1476,2013_Deron Williams
2013,Jeff Green,PF,26,376,806,0.4665012406947891,70,182,0.38461538461538464,306,624,0.49038461538461536,214,265,0.8075471698113208,55,263,318,128,56,68,132,175,1036,2013_Jeff Green
2013,John Henson,PF,22,162,336,0.48214285714285715,0,3,0.0,162,333,0.4864864864864865,56,105,0.5333333333333333,116,181,297,31,19,42,47,83,380,2013_John Henson
2013,John Lucas,PG,30,129,334,0.38622754491017963,57,151,0.37748344370860926,72,183,0.39344262295081966,18,25,0.72,8,57,65,105,23,1,26,50,333,2013_John Lucas
2013,Kobe Bryant,SG,34,738,1595,0.4626959247648903,132,407,0.32432432432432434,606,1188,0.51010101010101,525,626,0.8386581469648562,66,367,433,469,106,25,287,173,2133,2013_Kobe Bryant
2013,Lou Williams,SG,26,187,443,0.4221218961625282,72,196,0.3673469387755102,115,247,0.46558704453441296,105,121,0.8677685950413223,8,72,80,139,44,10,74,55,551,2013_Lou Williams
2013,Marcus Thornton,SG,25,332,774,0.4289405684754522,141,379,0.3720316622691293,191,395,0.4835443037974684,111,126,0.8809523809523809,50,131,181,91,61,4,68,105,916,2013_Marcus Thornton
2013,Matt Barnes,SF,32,312,675,0.4622222222222222,111,325,0.3415384615384615,201,350,0.5742857142857143,87,117,0.7435897435897436,111,255,366,123,82,63,90,233,822,2013_Matt Barnes
2013,Randy Foye,SG,29,293,738,0.3970189701897019,178,434,0.41013824884792627,115,304,0.3782894736842105,118,144,0.8194444444444444,17,110,127,167,66,27,92,190,882,2013_Randy Foye
2013,Roger Mason,SG,32,132,305,0.43278688524590164,66,159,0.41509433962264153,66,146,0.4520547945205479,39,43,0.9069767441860465,11,121,132,74,26,11,51,104,369,2013_Roger Mason
2014,Andre Miller,SG,37,212,462,0.4588744588744589,22,42,0.5238095238095238,190,420,0.4523809523809524,120,154,0.7792207792207793,56,204,260,394,68,18,122,150,566,2014_Andre Miller
2014,Ben McLemore,SG,20,255,679,0.3755522827687776,95,297,0.31986531986531985,160,382,0.418848167539267,115,143,0.8041958041958042,53,182,235,82,45,18,96,201,720,2014_Ben McLemore
2014,Channing Frye,PF,30,336,778,0.4318766066838046,160,432,0.37037037037037035,176,346,0.5086705202312138,78,95,0.8210526315789474,73,343,416,98,60,63,89,245,910,2014_Channing Frye
2014,Damian Lillard,PG,23,553,1304,0.424079754601227,218,554,0.3935018050541516,335,750,0.44666666666666666,371,426,0.8708920187793427,35,253,288,457,64,22,193,197,1695,2014_Damian Lillard
2014,David West,PF,33,458,939,0.48775292864749736,4,15,0.26666666666666666,454,924,0.49134199134199136,198,251,0.7888446215139442,120,422,542,223,61,74,133,186,1118,2014_David West
2014,Ersan Ilyasova,PF,26,237,579,0.40932642487046633,37,131,0.2824427480916031,200,448,0.44642857142857145,107,130,0.823076923076923,107,235,342,72,46,8,61,135,618,2014_Ersan Ilyasova
2014,John Henson,PF,23,344,639,0.5383411580594679,0,1,0.0,344,638,0.5391849529780565,91,177,0.5141242937853108,171,326,497,113,41,116,114,185,779,2014_John Henson
2014,Josh Powell,PF,31,2,6,0.3333333333333333,0,0,NaN,2,6,0.3333333333333333,0,0,NaN,0,5,5,0,0,1,1,1,4,2014_Josh Powell
2014,Kevin Seraphin,C,24,111,220,0.5045454545454545,0,0,NaN,111,220,0.5045454545454545,27,31,0.8709677419354839,53,75,128,17,3,26,41,103,249,2014_Kevin Seraphin
2014,Kobe Bryant,SG,35,31,73,0.4246575342465753,3,16,0.1875,28,57,0.49122807017543857,18,21,0.8571428571428571,2,24,26,38,7,1,34,9,83,2014_Kobe Bryant
2014,Kosta Koufos,C,24,227,459,0.49455337690631807,0,0,NaN,227,459,0.49455337690631807,60,93,0.6451612903225806,160,258,418,39,32,71,67,182,514,2014_Kosta Koufos
2014,Marcus Thornton,SG,26,504,1278,0.39436619718309857,218,632,0.3449367088607595,286,646,0.44272445820433437,180,224,0.8035714285714286,114,282,396,154,116,22,134,220,1406,2014_Marcus Thornton
2014,Mason Plumlee,C,23,199,302,0.6589403973509934,0,3,0.0,199,299,0.6655518394648829,122,195,0.6256410256410256,99,209,308,60,49,55,77,171,520,2014_Mason Plumlee
2014,Matt Barnes,SF,33,231,527,0.43833017077798864,97,283,0.34275618374558303,134,244,0.5491803278688525,66,90,0.7333333333333333,60,232,292,125,56,28,85,185,625,2014_Matt Barnes
2014,Patrick Beverley,PG,25,199,481,0.41372141372141374,92,255,0.3607843137254902,107,226,0.47345132743362833,83,102,0.8137254901960784,72,124,196,151,77,23,66,174,573,2014_Patrick Beverley
2014,Ramon Sessions,PG,27,660,1538,0.42912873862158646,70,248,0.28225806451612906,590,1290,0.4573643410852713,652,808,0.806930693069307,76,330,406,680,98,18,296,180,2042,2014_Ramon Sessions
2014,Roger Mason,SG,33,25,67,0.373134328358209,17,48,0.3541666666666667,8,19,0.42105263157894735,7,7,1.0,1,21,22,19,6,1,9,26,74,2014_Roger Mason
2014,Royal Ivey,SG,32,0,2,0.0,0,1,0.0,0,1,0.0,0,0,NaN,0,1,1,0,0,0,0,1,0,2014_Royal Ivey
2014,Steve Novak,PF,30,60,146,0.410958904109589,52,122,0.4262295081967213,8,24,0.3333333333333333,6,6,1.0,8,50,58,13,12,4,5,44,178,2014_Steve Novak
2014,Tristan Thompson,PF,22,363,761,0.47700394218134035,0,1,0.0,363,760,0.4776315789473684,235,339,0.6932153392330384,269,485,754,72,42,35,108,188,961,2014_Tristan Thompson
2014,Tyler Hansbrough,PF,28,93,196,0.4744897959183674,0,2,0.0,93,194,0.4793814432989691,126,185,0.6810810810810811,120,167,287,17,28,19,47,132,312,2014_Tyler Hansbrough
2015,Channing Frye,PF,31,191,487,0.3921971252566735,136,346,0.3930635838150289,55,141,0.3900709219858156,31,35,0.8857142857142857,27,266,293,94,47,39,78,191,549,2015_Channing Frye
2015,Courtney Lee,SG,29,288,643,0.447900466562986,90,224,0.4017857142857143,198,419,0.47255369928400953,111,129,0.8604651162790697,21,157,178,151,75,12,78,129,777,2015_Courtney Lee
2015,Garrett Temple,SG,28,68,170,0.4,33,88,0.375,35,82,0.4268292682926829,35,48,0.7291666666666666,24,66,90,56,42,9,34,76,204,2015_Garrett Temple
2015,J.R. Smith,SG,29,630,1510,0.41721854304635764,326,852,0.3826291079812207,304,658,0.46200607902735563,108,144,0.75,60,376,436,390,164,44,194,326,1694,2015_J.R. Smith
2015,James Young,SG,19,36,102,0.35294117647058826,17,66,0.25757575757575757,19,36,0.5277777777777778,16,29,0.5517241379310345,9,33,42,13,8,2,5,22,105,2015_James Young
2015,John Henson,C,24,196,346,0.5664739884393064,0,0,NaN,196,346,0.5664739884393064,78,137,0.5693430656934306,124,188,312,59,28,135,87,152,470,2015_John Henson
2015,Kendall Marshall,PG,23,46,101,0.45544554455445546,18,46,0.391304347826087,28,55,0.509090909090909,8,9,0.8888888888888888,2,26,28,86,21,0,35,26,118,2015_Kendall Marshall
2015,Kevin Martin,SG,31,267,625,0.4272,75,191,0.39267015706806285,192,434,0.4423963133640553,170,193,0.8808290155440415,19,123,142,89,33,1,76,76,779,2015_Kevin Martin
2015,Kobe Bryant,SG,36,266,713,0.37307152875175315,54,184,0.29347826086956524,212,529,0.4007561436672968,196,241,0.8132780082987552,26,173,199,197,47,7,128,65,782,2015_Kobe Bryant
2015,Kyle Lowry,PG,28,430,1043,0.41227229146692235,132,391,0.3375959079283887,298,652,0.4570552147239264,252,312,0.8076923076923077,54,274,328,473,109,13,173,212,1244,2015_Kyle Lowry
2015,Luc Mbah,PF,28,251,636,0.3946540880503145,62,202,0.3069306930693069,189,434,0.43548387096774194,96,163,0.588957055214724,82,246,328,106,81,21,99,104,660,2015_Luc Mbah
2015,Marcus Thornton,SG,27,280,690,0.4057971014492754,108,286,0.3776223776223776,172,404,0.42574257425742573,92,112,0.8214285714285714,46,126,172,72,54,14,54,76,760,2015_Marcus Thornton
2015,Mason Plumlee,C,24,280,489,0.5725971370143149,0,3,0.0,280,486,0.5761316872427984,157,317,0.4952681388012618,175,337,512,74,65,63,106,207,717,2015_Mason Plumlee
2015,Matt Barnes,SF,34,277,624,0.4439102564102564,136,376,0.3617021276595745,141,248,0.5685483870967742,74,95,0.7789473684210526,51,251,302,114,67,50,87,240,764,2015_Matt Barnes
2015,Steve Novak,SF-PF_SF_PF,31,44,112,0.39285714285714285,38,96,0.3958333333333333,6,16,0.375,0,4,0.0,4,40,44,22,0,4,10,46,126,2015_Steve Novak
2016,Channing Frye,C_PF_PF-C,32,304,694,0.43804034582132567,182,470,0.3872340425531915,122,224,0.5446428571428571,60,70,0.8571428571428571,70,398,468,142,58,56,86,254,850,2016_Channing Frye
2016,Chris Andersen,C,37,76,144,0.5277777777777778,8,28,0.2857142857142857,68,116,0.5862068965517241,50,72,0.6944444444444444,72,124,196,24,30,26,18,58,210,2016_Chris Andersen
2016,Emmanuel Mudiay,PG,19,329,905,0.36353591160220994,74,232,0.31896551724137934,255,673,0.3789004457652303,140,209,0.6698564593301436,32,200,232,372,65,35,217,141,872,2016_Emmanuel Mudiay
2016,Jamal Crawford,SG,35,379,939,0.4036208732694356,117,344,0.34011627906976744,262,595,0.4403361344537815,245,271,0.9040590405904059,20,125,145,183,52,12,113,122,1120,2016_Jamal Crawford
2016,Jeff Ayres,C,28,12,23,0.5217391304347826,0,1,0.0,12,22,0.5454545454545454,6,6,1.0,4,18,22,5,0,3,6,18,30,2016_Jeff Ayres
2016,John Henson,C,25,164,291,0.563573883161512,0,1,0.0,164,290,0.5655172413793104,69,117,0.5897435897435898,87,134,221,54,18,109,64,131,397,2016_John Henson
2016,Kobe Bryant,SF,37,398,1113,0.35759209344115006,133,467,0.284796573875803,265,646,0.4102167182662539,232,281,0.8256227758007118,41,206,247,184,62,13,129,115,1161,2016_Kobe Bryant
2016,Marc Gasol,C,31,328,707,0.4639321074964639,2,3,0.6666666666666666,326,704,0.4630681818181818,203,245,0.8285714285714286,58,304,362,196,50,70,118,141,861,2016_Marc Gasol
2016,Marcus Thornton,SG,28,432,1084,0.3985239852398524,182,540,0.337037037037037,250,544,0.45955882352941174,134,158,0.8481012658227848,76,224,300,170,94,8,102,180,1180,2016_Marcus Thornton
2016,Mason Plumlee,C,25,267,517,0.5164410058027079,0,4,0.0,267,513,0.52046783625731,215,335,0.6417910447761194,201,427,628,226,68,85,154,253,749,2016_Mason Plumlee
2016,Matt Barnes,SF,35,264,693,0.38095238095238093,119,370,0.3216216216216216,145,323,0.44891640866873067,111,138,0.8043478260869565,84,336,420,163,78,57,121,234,758,2016_Matt Barnes
2016,Ryan Hollins,C,31,98,158,0.620253164556962,0,0,NaN,98,158,0.620253164556962,52,84,0.6190476190476191,94,102,196,20,12,42,48,124,248,2016_Ryan Hollins
2016,Sonny Weems,SF_SG_SG-SF,29,84,220,0.38181818181818183,30,82,0.36585365853658536,54,138,0.391304347826087,16,30,0.5333333333333333,14,92,106,98,20,2,82,94,214,2016_Sonny Weems
2016,Steve Novak,PF,32,16,36,0.4444444444444444,14,30,0.4666666666666667,2,6,0.3333333333333333,2,2,1.0,0,10,10,0,0,0,2,6,48,2016_Steve Novak
2017,Alex Poythress,PF,23,25,54,0.46296296296296297,6,19,0.3157894736842105,19,35,0.5428571428571428,8,10,0.8,11,18,29,5,3,2,3,14,64,2017_Alex Poythress
2017,Anthony Tolliver,PF,31,155,351,0.4415954415954416,90,230,0.391304347826087,65,121,0.5371900826446281,61,82,0.7439024390243902,51,188,239,77,33,20,56,109,461,2017_Anthony Tolliver
2017,Axel Toupane,SF,24,10,18,0.5555555555555556,2,8,0.25,8,10,0.8,0,0,NaN,0,2,2,0,2,2,0,12,22,2017_Axel Toupane
2017,Channing Frye,C,33,238,520,0.4576923076923077,137,335,0.408955223880597,101,185,0.5459459459459459,63,74,0.8513513513513513,37,253,290,45,33,37,53,138,676,2017_Channing Frye
2017,Damian Jones,C,21,8,16,0.5,0,0,NaN,8,16,0.5,3,10,0.3,9,14,23,0,1,4,6,15,19,2017_Damian Jones
2017,Dejounte Murray,PG,20,50,116,0.43103448275862066,9,23,0.391304347826087,41,93,0.44086021505376344,21,30,0.7,6,36,42,48,8,6,38,29,130,2017_Dejounte Murray
2017,Devin Booker,SG,20,606,1431,0.42348008385744235,147,405,0.362962962962963,459,1026,0.4473684210526316,367,441,0.8321995464852607,46,203,249,268,72,21,241,242,1726,2017_Devin Booker
2017,Georges Niang,PF,23,9,36,0.25,1,12,0.08333333333333333,8,24,0.3333333333333333,2,2,1.0,2,15,17,5,3,0,5,6,21,2017_Georges Niang
2017,John Henson,C,26,159,309,0.5145631067961165,0,1,0.0,159,308,0.5162337662337663,74,107,0.6915887850467289,92,203,295,57,29,78,53,151,392,2017_John Henson
2017,John Jenkins,SG,25,2,5,0.4,1,2,0.5,1,3,0.3333333333333333,2,2,1.0,0,1,1,1,0,0,0,0,7,2017_John Jenkins
2017,Jonathan Gibson,PG,29,35,95,0.3684210526315789,15,45,0.3333333333333333,20,50,0.4,21,29,0.7241379310344828,1,21,22,26,8,0,21,21,106,2017_Jonathan Gibson
2017,Karl-Anthony Towns,C,21,802,1479,0.5422582826233941,101,275,0.36727272727272725,701,1204,0.5822259136212624,356,428,0.8317757009345794,296,711,1007,220,57,103,212,241,2061,2017_Karl-Anthony Towns
2017,Marcus Thornton,SG,29,84,210,0.4,28,80,0.35,56,130,0.4307692307692308,23,27,0.8518518518518519,22,54,76,41,19,3,25,48,219,2017_Marcus Thornton
2017,Mason Plumlee,C,26,668,1246,0.536115569823435,0,12,0.0,668,1234,0.5413290113452188,348,600,0.58,340,872,1212,568,138,184,270,452,1684,2017_Mason Plumlee
2017,Matt Barnes,SF,36,370,946,0.39112050739957716,174,526,0.33079847908745247,196,420,0.4666666666666667,140,178,0.7865168539325843,140,634,774,388,96,52,214,370,1054,2017_Matt Barnes
2017,Meyers Leonard,PF,24,146,378,0.3862433862433862,74,213,0.3474178403755869,72,165,0.43636363636363634,35,40,0.875,27,209,236,71,13,28,35,172,401,2017_Meyers Leonard
2017,Myles Turner,C,20,444,869,0.5109321058688148,40,115,0.34782608695652173,404,754,0.5358090185676393,245,303,0.8085808580858086,139,448,587,106,74,173,105,262,1173,2017_Myles Turner
2017,Reggie Jackson,PG,26,284,677,0.4194977843426883,66,184,0.358695652173913,218,493,0.4421906693711968,118,136,0.8676470588235294,21,92,113,270,35,5,114,129,752,2017_Reggie Jackson
2017,Steve Novak,PF,33,2,7,0.2857142857142857,1,6,0.16666666666666666,1,1,1.0,0,0,NaN,0,3,3,0,0,0,0,1,5,2017_Steve Novak
2017,Steven Adams,C,23,374,655,0.5709923664122137,0,1,0.0,374,654,0.5718654434250765,157,257,0.6108949416342413,282,333,615,86,88,78,146,195,905,2017_Steven Adams
2003,Alvin Williams,PG,28,396,905,0.4375690607734807,48,146,0.3287671232876712,348,759,0.45849802371541504,187,239,0.7824267782426778,55,190,245,416,111,21,128,170,1027,2003_Alvin Williams
2003,Anthony Mason,C,36,191,393,0.4860050890585242,0,1,0.0,191,392,0.4872448979591837,84,117,0.717948717948718,90,326,416,209,32,12,79,147,466,2003_Anthony Mason
2003,Antoine Walker,PF,26,603,1554,0.38803088803088803,188,582,0.3230240549828179,415,972,0.4269547325102881,176,286,0.6153846153846154,99,464,563,373,116,31,260,221,1570,2003_Antoine Walker
2003,Baron Davis,PG,23,332,798,0.41604010025062654,99,283,0.3498233215547703,233,515,0.4524271844660194,93,131,0.7099236641221374,56,130,186,320,91,22,140,148,856,2003_Baron Davis
2003,Cherokee Parks,PF,30,82,163,0.5030674846625767,1,2,0.5,81,161,0.5031055900621118,23,38,0.6052631578947368,46,86,132,21,16,20,18,52,188,2003_Cherokee Parks
2003,Courtney Alexander,PG,25,193,505,0.3821782178217822,19,57,0.3333333333333333,174,448,0.38839285714285715,118,146,0.8082191780821918,39,79,118,79,31,6,68,125,523,2003_Courtney Alexander
2003,Igor Rakocevic,PG,24,22,58,0.3793103448275862,5,12,0.4166666666666667,17,46,0.3695652173913043,29,36,0.8055555555555556,4,13,17,33,4,0,23,25,78,2003_Igor Rakocevic
2003,Jamaal Tinsley,PG,24,220,556,0.39568345323741005,46,166,0.27710843373493976,174,390,0.4461538461538462,80,112,0.7142857142857143,58,202,260,548,125,18,192,201,566,2003_Jamaal Tinsley
2003,Jamal Mashburn,SF,30,670,1586,0.4224464060529634,119,306,0.3888888888888889,551,1280,0.43046875,313,369,0.8482384823848238,66,432,498,462,83,17,230,196,1772,2003_Jamal Mashburn
2003,Kenyon Martin,PF,25,509,1082,0.4704251386321627,9,43,0.20930232558139536,500,1039,0.48123195380173245,256,392,0.6530612244897959,164,476,640,185,98,70,192,294,1283,2003_Kenyon Martin
2003,Shawn Kemp,C,33,211,505,0.4178217821782178,0,1,0.0,211,504,0.41865079365079366,115,155,0.7419354838709677,147,304,451,55,66,33,102,239,537,2003_Shawn Kemp
2004,Baron Davis,PG,24,554,1402,0.39514978601997147,187,582,0.32130584192439865,367,820,0.4475609756097561,237,352,0.6732954545454546,66,221,287,501,158,27,215,178,1532,2004_Baron Davis
2004,Doug Overton,PG,34,198,490,0.40408163265306124,6,46,0.13043478260869565,192,444,0.43243243243243246,46,62,0.7419354838709677,32,140,172,276,52,4,116,178,448,2004_Doug Overton
2004,Greg Ostertag,C,30,208,437,0.4759725400457666,0,1,0.0,208,436,0.47706422018348627,113,195,0.5794871794871795,221,357,578,123,30,139,99,228,529,2004_Greg Ostertag
2004,Ime Udoka,SF,26,3,9,0.3333333333333333,0,1,0.0,3,8,0.375,2,4,0.5,1,4,5,2,2,1,3,3,8,2004_Ime Udoka
2004,Jason Kapono,SF,22,52,129,0.40310077519379844,21,44,0.4772727272727273,31,85,0.36470588235294116,20,24,0.8333333333333334,19,36,55,14,13,2,21,41,145,2004_Jason Kapono
2004,Kenyon Martin,PF,26,439,900,0.48777777777777775,7,25,0.28,432,875,0.4937142857142857,201,294,0.6836734693877551,133,484,617,160,95,82,168,230,1086,2004_Kenyon Martin
2004,Mark Jackson,PG,38,34,100,0.34,7,41,0.17073170731707318,27,59,0.4576271186440678,28,39,0.717948717948718,10,60,70,119,17,1,53,41,103,2004_Mark Jackson
2004,Michael Doleac,C,26,280,644,0.43478260869565216,0,0,NaN,280,644,0.43478260869565216,90,104,0.8653846153846154,176,354,530,88,46,72,96,284,650,2004_Michael Doleac
2004,Qyntel Woods,SF,22,88,237,0.37130801687763715,10,29,0.3448275862068966,78,208,0.375,38,60,0.6333333333333333,46,90,136,46,20,14,52,88,224,2004_Qyntel Woods
2004,Tremaine Fowlkes,SF,27,15,48,0.3125,1,8,0.125,14,40,0.35,13,18,0.7222222222222222,18,35,53,14,9,3,12,37,44,2004_Tremaine Fowlkes
2004,Tyson Chandler,PF,21,67,158,0.4240506329113924,0,1,0.0,67,157,0.4267515923566879,79,118,0.6694915254237288,82,188,270,23,17,43,38,87,213,2004_Tyson Chandler
2004,Walter McCarty,PF,29,203,523,0.3881453154875717,137,366,0.3743169398907104,66,157,0.42038216560509556,62,82,0.7560975609756098,28,211,239,124,72,22,91,179,605,2004_Walter McCarty
2005,Baron Davis,PG,25,582,1504,0.386968085106383,236,708,0.3333333333333333,346,796,0.43467336683417085,370,486,0.7613168724279835,64,286,350,724,162,28,262,252,1770,2005_Baron Davis
2005,Damien Wilkins,SF,25,73,168,0.43452380952380953,16,59,0.2711864406779661,57,109,0.5229357798165137,21,34,0.6176470588235294,29,37,66,26,22,10,16,55,183,2005_Damien Wilkins
2005,Darvin Ham,SF,31,17,37,0.4594594594594595,0,0,NaN,17,37,0.4594594594594595,12,31,0.3870967741935484,19,16,35,5,6,7,8,39,46,2005_Darvin Ham
2005,Frank Williams,SG,24,3,20,0.15,0,4,0.0,3,16,0.1875,0,0,NaN,2,4,6,11,2,3,3,9,6,2005_Frank Williams
2005,Gilbert Arenas,PG,23,656,1523,0.4307288246881156,205,562,0.36476868327402134,451,961,0.46930280957336107,521,640,0.8140625,83,295,378,411,139,23,242,245,2038,2005_Gilbert Arenas
2005,Greg Ostertag,C,31,37,84,0.44047619047619047,0,2,0.0,37,82,0.45121951219512196,13,38,0.34210526315789475,55,112,167,37,7,40,24,88,87,2005_Greg Ostertag
2005,Jason Hart,PG,26,257,573,0.44851657940663175,35,95,0.3684210526315789,222,478,0.46443514644351463,157,200,0.785,18,185,203,367,99,14,102,167,706,2005_Jason Hart
2005,John Thomas,C,29,42,86,0.4883720930232558,0,0,NaN,42,86,0.4883720930232558,27,46,0.5869565217391305,39,58,97,17,15,13,18,82,111,2005_John Thomas
2005,Kenyon Martin,PF,27,444,907,0.4895259095920617,0,12,0.0,444,895,0.4960893854748603,199,308,0.6461038961038961,146,365,511,170,100,78,149,228,1087,2005_Kenyon Martin
2005,Ndudi Ebi,SG,20,11,21,0.5238095238095238,0,1,0.0,11,20,0.55,5,9,0.5555555555555556,6,10,16,1,1,1,3,7,27,2005_Ndudi Ebi
2005,Shaun Livingston,PG,19,89,215,0.413953488372093,0,2,0.0,89,213,0.41784037558685444,44,59,0.7457627118644068,22,67,89,151,32,11,75,82,222,2005_Shaun Livingston
2006,Baron Davis,PG,26,335,861,0.389082462253194,102,324,0.3148148148148148,233,537,0.4338919925512104,195,289,0.6747404844290658,45,191,236,480,89,14,159,165,967,2006_Baron Davis
2006,Gerald Wallace,SF,23,317,589,0.5382003395585738,14,50,0.28,303,539,0.562152133580705,188,306,0.6143790849673203,123,289,412,96,138,115,99,150,836,2006_Gerald Wallace
2006,Greg Ostertag,C,32,61,124,0.49193548387096775,0,0,NaN,61,124,0.49193548387096775,24,48,0.5,82,143,225,58,6,66,46,129,146,2006_Greg Ostertag
2006,Ime Udoka,SF,28,9,24,0.375,1,3,0.3333333333333333,8,21,0.38095238095238093,3,6,0.5,3,14,17,6,1,0,2,8,22,2006_Ime Udoka
2006,Jacque Vaughn,SG,30,107,245,0.43673469387755104,1,6,0.16666666666666666,106,239,0.4435146443514644,59,81,0.7283950617283951,16,75,91,123,42,1,52,140,274,2006_Jacque Vaughn
2006,James Thomas,PF,25,20,38,0.5263157894736842,0,0,NaN,20,38,0.5263157894736842,16,28,0.5714285714285714,24,54,78,2,0,6,14,70,56,2006_James Thomas
2006,Jason Richardson,SG,25,641,1438,0.44575799721835885,183,477,0.3836477987421384,458,961,0.47658688865764826,276,410,0.6731707317073171,105,333,438,232,97,37,167,206,1741,2006_Jason Richardson
2006,Keith McLeod,PG,26,120,340,0.35294117647058826,24,82,0.2926829268292683,96,258,0.37209302325581395,106,133,0.7969924812030075,11,67,78,151,42,9,76,131,370,2006_Keith McLeod
2006,Kenyon Martin,PF,28,297,600,0.495,5,22,0.22727272727272727,292,578,0.5051903114186851,121,170,0.711764705882353,93,260,353,79,43,52,72,171,720,2006_Kenyon Martin
2006,Kirk Hinrich,PG,25,451,1078,0.41836734693877553,126,341,0.36950146627565983,325,737,0.44097693351424694,256,314,0.8152866242038217,29,259,288,514,94,21,188,251,1284,2006_Kirk Hinrich
2006,Mike James,PG,30,576,1228,0.46905537459283386,169,382,0.4424083769633508,407,846,0.48108747044917255,283,338,0.8372781065088757,45,217,262,460,72,3,206,214,1604,2006_Mike James
2006,Zoran Planinic,PG,23,66,183,0.36065573770491804,13,56,0.23214285714285715,53,127,0.41732283464566927,46,66,0.696969696969697,14,60,74,53,20,4,43,91,191,2006_Zoran Planinic
2006,Zydrunas Ilgauskas,C,30,450,889,0.5061867266591676,0,5,0.0,450,884,0.5090497737556561,317,380,0.8342105263157895,245,346,591,91,38,136,155,280,1217,2006_Zydrunas Ilgauskas
2007,Baron Davis,PG,27,452,1030,0.4388349514563107,85,280,0.30357142857142855,367,750,0.48933333333333334,275,369,0.7452574525745257,51,225,276,509,135,29,193,181,1264,2007_Baron Davis
2007,Brian Cook,PF,26,185,408,0.4534313725490196,46,115,0.4,139,293,0.47440273037542663,34,47,0.723404255319149,61,154,215,65,25,27,51,134,450,2007_Brian Cook
2007,Brian Scalabrine,PF,28,77,191,0.4031413612565445,44,110,0.4,33,81,0.4074074074074074,18,23,0.782608695652174,24,81,105,59,23,18,44,130,216,2007_Brian Scalabrine
2007,Ime Udoka,SF,29,237,514,0.46108949416342415,89,219,0.4063926940639269,148,295,0.5016949152542373,66,89,0.7415730337078652,95,184,279,112,71,17,73,207,629,2007_Ime Udoka
2007,Jacque Vaughn,PG,31,71,167,0.4251497005988024,1,2,0.5,70,165,0.42424242424242425,49,65,0.7538461538461538,8,60,68,131,24,2,40,74,192,2007_Jacque Vaughn
2007,Josh Smith,SF,21,436,993,0.4390735146022155,38,152,0.25,398,841,0.47324613555291317,268,387,0.6925064599483204,165,456,621,236,101,207,227,241,1178,2007_Josh Smith
2007,Kenny Thomas,PF,29,146,303,0.48184818481848185,0,1,0.0,146,302,0.48344370860927155,39,76,0.5131578947368421,134,243,377,76,43,16,90,141,331,2007_Kenny Thomas
2007,Kenyon Martin,PF,29,8,16,0.5,0,1,0.0,8,15,0.5333333333333333,3,12,0.25,6,14,20,1,0,0,5,10,19,2007_Kenyon Martin
2007,Pape Sow,C,25,3,9,0.3333333333333333,0,0,NaN,3,9,0.3333333333333333,4,6,0.6666666666666666,6,5,11,2,1,1,1,2,10,2007_Pape Sow
2007,Rasho Nesterovic,C,30,230,421,0.5463182897862233,0,1,0.0,230,420,0.5476190476190477,34,50,0.68,115,245,360,74,37,84,56,193,494,2007_Rasho Nesterovic
2007,Shawne Williams,SG,20,75,160,0.46875,19,52,0.36538461538461536,56,108,0.5185185185185185,11,20,0.55,33,50,83,22,6,8,24,69,180,2007_Shawne Williams
2007,Shelden Williams,PF,23,166,365,0.4547945205479452,2,4,0.5,164,361,0.45429362880886426,110,144,0.7638888888888888,131,304,435,44,52,39,96,199,444,2007_Shelden Williams
2007,Tim Duncan,C,30,618,1131,0.5464190981432361,1,9,0.1111111111111111,617,1122,0.5499108734402852,362,568,0.6373239436619719,213,633,846,273,66,190,224,203,1599,2007_Tim Duncan
2008,Acie Law,PG,23,95,237,0.4008438818565401,7,34,0.20588235294117646,88,203,0.43349753694581283,38,48,0.7916666666666666,12,45,57,113,29,0,56,73,235,2008_Acie Law
2008,Al Thornton,PF,24,374,871,0.4293915040183697,43,130,0.33076923076923076,331,741,0.446693657219973,214,288,0.7430555555555556,98,260,358,98,46,43,128,195,1005,2008_Al Thornton
2008,Andrei Kirilenko,SF,26,275,544,0.5055147058823529,44,116,0.3793103448275862,231,428,0.5397196261682243,198,257,0.7704280155642024,121,218,339,285,86,109,140,165,792,2008_Andrei Kirilenko
2008,Anthony Parker,SG,32,395,829,0.4764776839565742,133,304,0.4375,262,525,0.4990476190476191,102,125,0.816,50,284,334,183,79,17,87,157,1025,2008_Anthony Parker
2008,Baron Davis,PG,28,650,1526,0.4259501965923984,173,525,0.3295238095238095,477,1001,0.47652347652347654,318,424,0.75,96,289,385,623,191,43,232,247,1791,2008_Baron Davis
2008,Deron Williams,PG,23,566,1117,0.5067144136078783,83,210,0.3952380952380952,483,907,0.5325248070562293,330,411,0.8029197080291971,34,209,243,862,90,23,279,200,1545,2008_Deron Williams
2008,Francisco Garcia,SF,26,348,752,0.4627659574468085,113,289,0.39100346020761245,235,463,0.5075593952483801,162,208,0.7788461538461539,52,212,264,128,96,50,128,232,971,2008_Francisco Garcia
2008,Jacque Vaughn,PG,32,121,283,0.4275618374558304,3,10,0.3,118,273,0.43223443223443225,61,80,0.7625,13,61,74,159,23,1,54,97,306,2008_Jacque Vaughn
2008,Jeff Green,SF,21,320,749,0.4272363150867824,21,76,0.27631578947368424,299,673,0.4442793462109955,177,238,0.7436974789915967,101,278,379,119,46,49,158,198,838,2008_Jeff Green
2008,Joel Przybilla,C,28,144,250,0.576,0,1,0.0,144,249,0.5783132530120482,83,122,0.680327868852459,195,454,649,27,13,93,95,234,371,2008_Joel Przybilla
2008,Lou Williams,PG,21,319,752,0.4242021276595745,55,153,0.35947712418300654,264,599,0.44073455759599334,227,290,0.7827586206896552,41,126,167,253,81,13,125,130,920,2008_Lou Williams
2008,Manu Ginobili,SG,30,453,984,0.4603658536585366,156,389,0.40102827763496146,297,595,0.4991596638655462,380,442,0.8597285067873304,63,291,354,332,109,33,200,173,1442,2008_Manu Ginobili
2008,Quincy Douby,PG,23,132,335,0.3940298507462687,42,122,0.3442622950819672,90,213,0.4225352112676056,48,52,0.9230769230769231,17,66,83,53,30,12,59,80,354,2008_Quincy Douby
2008,Randy Foye,PG,24,198,462,0.42857142857142855,61,148,0.41216216216216217,137,314,0.43630573248407645,53,65,0.8153846153846154,13,115,128,164,36,3,79,102,510,2008_Randy Foye
2008,Rashad McCants,SG,23,428,944,0.4533898305084746,142,349,0.4068767908309456,286,595,0.48067226890756304,116,155,0.7483870967741936,50,156,206,162,66,18,172,234,1114,2008_Rashad McCants
2008,Reggie Evans,PF,27,152,346,0.4393063583815029,1,1,1.0,151,345,0.43768115942028984,120,257,0.4669260700389105,224,387,611,65,86,8,108,213,425,2008_Reggie Evans
2008,Shawne Williams,SF,21,159,372,0.4274193548387097,43,137,0.31386861313868614,116,235,0.49361702127659574,76,106,0.7169811320754716,54,122,176,59,26,26,58,132,437,2008_Shawne Williams
2008,Theo Ratliff,C_PF_C-PF,34,82,170,0.4823529411764706,0,2,0.0,82,168,0.4880952380952381,58,86,0.6744186046511628,64,114,178,28,14,74,42,118,222,2008_Theo Ratliff
2009,Al Thornton,SF,25,469,1051,0.4462416745956232,20,79,0.25316455696202533,449,972,0.4619341563786008,236,313,0.7539936102236422,122,246,368,103,59,62,130,227,1194,2009_Al Thornton
2009,Andre Miller,PG,32,492,1041,0.47262247838616717,15,53,0.2830188679245283,477,988,0.48279352226720645,338,409,0.8264058679706602,123,245,368,534,109,14,199,196,1337,2009_Andre Miller
2009,Baron Davis,PG,29,355,959,0.37017726798748696,99,328,0.3018292682926829,256,631,0.40570522979397783,159,210,0.7571428571428571,46,192,238,501,108,35,193,193,968,2009_Baron Davis
2009,Didier Ilunga-Mbenga,C,28,27,57,0.47368421052631576,0,1,0.0,27,56,0.48214285714285715,7,8,0.875,9,22,31,9,10,24,13,33,61,2009_Didier Ilunga-Mbenga
2009,Jacque Vaughn,PG,33,24,75,0.32,1,1,1.0,23,74,0.3108108108108108,16,18,0.8888888888888888,4,18,22,55,6,0,15,26,65,2009_Jacque Vaughn
2009,Joe Crawford,SF,22,3,10,0.3,1,4,0.25,2,6,0.3333333333333333,2,2,1.0,1,3,4,1,1,0,0,2,9,2009_Joe Crawford
2009,Manu Ginobili,SG,31,223,491,0.45417515274949083,69,209,0.33014354066985646,154,282,0.5460992907801419,168,190,0.8842105263157894,24,174,198,157,64,16,88,90,683,2009_Manu Ginobili
2009,Ramon Sessions,PG,22,345,775,0.44516129032258067,6,34,0.17647058823529413,339,741,0.4574898785425101,281,354,0.7937853107344632,64,205,269,452,83,7,152,158,977,2009_Ramon Sessions
2009,Robin Lopez,C,20,71,137,0.5182481751824818,0,1,0.0,71,136,0.5220588235294118,47,68,0.6911764705882353,52,66,118,8,11,41,28,97,189,2009_Robin Lopez
2009,Shawne Williams,SF,22,16,56,0.2857142857142857,1,17,0.058823529411764705,15,39,0.38461538461538464,9,11,0.8181818181818182,19,27,46,2,2,9,5,19,42,2009_Shawne Williams
2009,Tyronn Lue,PG,31,142,324,0.4382716049382716,54,124,0.43548387096774194,88,200,0.44,28,38,0.7368421052631579,12,80,92,120,16,0,46,108,366,2009_Tyronn Lue
2010,Al Harrington,PF,29,448,1030,0.4349514563106796,140,409,0.3422982885085575,308,621,0.49597423510466987,240,317,0.7570977917981072,88,317,405,110,62,26,132,209,1276,2010_Al Harrington
2010,Baron Davis,PG,30,412,1015,0.4059113300492611,82,296,0.27702702702702703,330,719,0.45897079276773295,239,291,0.8213058419243986,52,214,266,598,126,43,211,210,1145,2010_Baron Davis
2010,Chris Quinn,PG,26,20,56,0.35714285714285715,10,32,0.3125,10,24,0.4166666666666667,6,6,1.0,1,15,16,29,9,1,10,15,56,2010_Chris Quinn
2010,Chris Wilcox,PF,27,63,120,0.525,0,0,NaN,63,120,0.525,26,52,0.5,44,73,117,13,13,12,38,64,152,2010_Chris Wilcox
2010,D.J. White,PF,23,25,41,0.6097560975609756,0,0,NaN,25,41,0.6097560975609756,9,10,0.9,10,13,23,4,5,3,3,12,59,2010_D.J. White
2010,Eddy Curry,C,27,8,21,0.38095238095238093,0,0,NaN,8,21,0.38095238095238093,10,17,0.5882352941176471,4,9,13,0,0,1,13,13,26,2010_Eddy Curry
2010,Goran Dragic,PG,23,222,491,0.45213849287169044,74,188,0.39361702127659576,148,303,0.4884488448844885,117,159,0.7358490566037735,38,133,171,241,48,8,126,131,635,2010_Goran Dragic
2010,Hakim Warrick,PF,27,530,1100,0.4818181818181818,2,14,0.14285714285714285,528,1086,0.4861878453038674,404,548,0.7372262773722628,254,374,628,104,48,36,160,252,1466,2010_Hakim Warrick
2010,Ime Udoka,SG,32,91,241,0.3775933609958506,26,91,0.2857142857142857,65,150,0.43333333333333335,42,57,0.7368421052631579,51,140,191,58,34,6,42,83,250,2010_Ime Udoka
2010,Kenyon Martin,PF,32,283,620,0.45645161290322583,8,29,0.27586206896551724,275,591,0.4653130287648054,93,167,0.5568862275449101,142,404,546,109,72,61,91,186,667,2010_Kenyon Martin
2010,Kevin Martin,SG,26,578,1386,0.417027417027417,140,420,0.3333333333333333,438,966,0.453416149068323,596,680,0.8764705882352941,58,270,328,222,92,12,184,192,1892,2010_Kevin Martin
2010,LaMarcus Aldridge,PF,24,579,1169,0.49529512403763903,5,16,0.3125,574,1153,0.4978317432784042,230,304,0.756578947368421,192,435,627,160,67,48,104,231,1393,2010_LaMarcus Aldridge
2010,Rudy Gay,SF,23,600,1288,0.4658385093167702,66,202,0.32673267326732675,534,1086,0.49171270718232046,301,400,0.7525,115,357,472,153,118,64,169,201,1567,2010_Rudy Gay
2011,Baron Davis,PG,31,578,1386,0.417027417027417,162,478,0.3389121338912134,416,908,0.4581497797356828,202,262,0.7709923664122137,70,242,312,782,156,56,292,286,1520,2011_Baron Davis
2011,Chris Quinn,PG,27,33,91,0.3626373626373626,11,37,0.2972972972972973,22,54,0.4074074074074074,4,8,0.5,3,22,25,42,5,1,12,29,81,2011_Chris Quinn
2011,Dan Gadzuric,C_PF_C-PF,32,108,258,0.4186046511627907,0,2,0.0,108,256,0.421875,20,54,0.37037037037037035,142,128,270,28,26,58,58,182,236,2011_Dan Gadzuric
2011,Gordon Hayward,SF,20,142,293,0.48464163822525597,35,74,0.47297297297297297,107,219,0.4885844748858447,69,97,0.711340206185567,41,98,139,81,30,19,70,106,388,2011_Gordon Hayward
2011,Hakim Warrick,PF,28,228,446,0.5112107623318386,1,11,0.09090909090909091,227,435,0.5218390804597701,212,294,0.7210884353741497,88,208,296,69,32,9,79,100,669,2011_Hakim Warrick
2011,Hilton Armstrong,C,26,74,152,0.4868421052631579,4,8,0.5,70,144,0.4861111111111111,32,66,0.48484848484848486,84,178,262,28,36,42,56,168,184,2011_Hilton Armstrong
2011,Ime Udoka,SF,33,5,21,0.23809523809523808,0,8,0.0,5,13,0.38461538461538464,4,8,0.5,5,14,19,13,8,1,5,14,14,2011_Ime Udoka
2011,Jamario Moon,SF,30,202,496,0.40725806451612906,76,246,0.3089430894308943,126,250,0.504,30,34,0.8823529411764706,46,284,330,104,56,66,44,130,510,2011_Jamario Moon
2011,Jason Thompson,PF,24,271,534,0.5074906367041199,0,3,0.0,271,531,0.5103578154425612,121,200,0.605,144,310,454,88,28,44,99,212,663,2011_Jason Thompson
2011,Jerry Stackhouse,SG,36,3,12,0.25,1,4,0.25,2,8,0.25,5,7,0.7142857142857143,1,6,7,3,0,2,2,3,12,2011_Jerry Stackhouse
2011,Kenyon Martin,PF,33,185,362,0.511049723756906,2,9,0.2222222222222222,183,353,0.5184135977337111,42,72,0.5833333333333334,67,230,297,109,43,35,59,136,414,2011_Kenyon Martin
2011,Kyrylo Fesenko,C,24,44,100,0.44,0,1,0.0,44,99,0.4444444444444444,18,46,0.391304347826087,34,74,108,18,4,16,25,90,106,2011_Kyrylo Fesenko
2011,LaMarcus Aldridge,PF,25,707,1415,0.49964664310954066,4,23,0.17391304347826086,703,1392,0.5050287356321839,351,444,0.7905405405405406,278,431,709,170,82,94,153,220,1769,2011_LaMarcus Aldridge
2011,Marc Gasol,C,26,364,691,0.5267727930535456,3,7,0.42857142857142855,361,684,0.5277777777777778,220,294,0.7482993197278912,154,415,569,200,74,136,146,265,951,2011_Marc Gasol
2011,Patrick Patterson,PF,21,149,267,0.5580524344569289,0,2,0.0,149,265,0.5622641509433962,30,42,0.7142857142857143,86,114,200,41,17,37,31,77,328,2011_Patrick Patterson
2011,Ryan Hollins,C,26,131,219,0.5981735159817352,0,0,NaN,131,219,0.5981735159817352,111,163,0.6809815950920245,70,116,186,26,22,42,67,199,373,2011_Ryan Hollins
2011,Tyrus Thomas,C,24,156,331,0.47129909365558914,0,3,0.0,156,328,0.47560975609756095,107,136,0.7867647058823529,65,159,224,29,30,66,65,113,419,2011_Tyrus Thomas
2012,Anthony Tolliver,SF,26,71,182,0.3901098901098901,25,101,0.24752475247524752,46,81,0.5679012345679012,41,55,0.7454545454545455,50,103,153,22,18,19,35,86,208,2012_Anthony Tolliver
2012,Baron Davis,PG,32,68,184,0.3695652173913043,26,85,0.3058823529411765,42,99,0.42424242424242425,16,24,0.6666666666666666,13,43,56,135,34,3,76,61,178,2012_Baron Davis
2012,Darryl Watkins,C,27,7,14,0.5,0,0,NaN,7,14,0.5,9,18,0.5,8,19,27,3,5,4,8,14,23,2012_Darryl Watkins
2012,Derrick Byars,PF,27,3,11,0.2727272727272727,0,6,0.0,3,5,0.6,4,4,1.0,6,5,11,1,2,0,0,2,10,2012_Derrick Byars
2012,Devin Ebanks,SG,22,37,89,0.4157303370786517,0,9,0.0,37,80,0.4625,23,35,0.6571428571428571,26,28,54,12,11,6,18,26,97,2012_Devin Ebanks
2012,Hakim Warrick,PF,29,74,180,0.4111111111111111,1,10,0.1,73,170,0.4294117647058823,76,99,0.7676767676767676,31,61,92,30,8,3,36,35,225,2012_Hakim Warrick
2012,Jan Vesely,PF,21,117,218,0.536697247706422,0,1,0.0,117,217,0.5391705069124424,33,62,0.532258064516129,101,148,249,47,39,32,60,156,267,2012_Jan Vesely
2012,Jerryd Bayless,PG,23,117,276,0.42391304347826086,44,104,0.4230769230769231,73,172,0.42441860465116277,75,88,0.8522727272727273,8,58,66,118,24,4,53,70,353,2012_Jerryd Bayless
2012,Kenyon Martin,PF,34,97,220,0.4409090909090909,3,13,0.23076923076923078,94,207,0.45410628019323673,20,54,0.37037037037037035,49,132,181,18,44,43,32,103,217,2012_Kenyon Martin
2012,LaMarcus Aldridge,PF,26,483,943,0.5121951219512195,2,11,0.18181818181818182,481,932,0.5160944206008584,223,274,0.8138686131386861,150,292,442,134,51,45,111,153,1191,2012_LaMarcus Aldridge
2012,Larry Hughes,PG,33,5,22,0.22727272727272727,1,7,0.14285714285714285,4,15,0.26666666666666666,1,2,0.5,1,4,5,7,2,0,12,10,12,2012_Larry Hughes
2012,Patrick Patterson,PF,22,225,511,0.44031311154598823,0,3,0.0,225,508,0.44291338582677164,40,57,0.7017543859649122,112,174,286,53,27,36,49,113,490,2012_Patrick Patterson
2013,Amir Johnson,PF,25,336,606,0.5544554455445545,5,13,0.38461538461538464,331,593,0.5581787521079258,136,187,0.7272727272727273,227,384,611,122,81,110,117,301,813,2013_Amir Johnson
2013,Andre Iguodala,SG,29,396,879,0.45051194539249145,91,287,0.3170731707317073,305,592,0.5152027027027027,155,270,0.5740740740740741,82,341,423,433,139,52,206,127,1038,2013_Andre Iguodala
2013,Bradley Beal,SG,19,282,687,0.4104803493449782,91,236,0.3855932203389831,191,451,0.42350332594235035,125,159,0.7861635220125787,43,168,211,137,50,29,90,113,780,2013_Bradley Beal
2013,Chris Quinn,SG,29,4,16,0.25,0,5,0.0,4,11,0.36363636363636365,2,2,1.0,1,1,2,9,3,0,6,4,10,2013_Chris Quinn
2013,Damion James,SF,25,0,0,NaN,0,0,NaN,0,0,NaN,0,0,NaN,0,1,1,0,0,0,0,0,0,2013_Damion James
2013,DeAndre Jordan,C,24,314,488,0.6434426229508197,0,0,NaN,314,488,0.6434426229508197,96,249,0.3855421686746988,210,384,594,28,48,112,100,192,724,2013_DeAndre Jordan
2013,Kenyon Martin,C,35,56,93,0.6021505376344086,0,0,NaN,56,93,0.6021505376344086,17,40,0.425,34,61,95,8,16,17,16,64,129,2013_Kenyon Martin
2013,LaMarcus Aldridge,PF,27,638,1318,0.48406676783004554,2,14,0.14285714285714285,636,1304,0.48773006134969327,282,348,0.8103448275862069,175,495,670,192,62,91,143,187,1560,2013_LaMarcus Aldridge
2013,Patrick Patterson,PF,23,638,1246,0.5120385232744783,102,264,0.38636363636363635,536,982,0.5458248472505092,96,126,0.7619047619047619,226,448,674,162,62,80,122,276,1474,2013_Patrick Patterson
2013,Tornike Shengelia,SF,21,10,23,0.43478260869565216,1,2,0.5,9,21,0.42857142857142855,9,16,0.5625,9,14,23,3,3,1,11,11,30,2013_Tornike Shengelia
2014,Jamaal Tinsley,PG,35,4,20,0.2,1,15,0.06666666666666667,3,5,0.6,0,0,NaN,2,9,11,23,2,0,9,10,9,2014_Jamaal Tinsley
2014,James Nunnally,SF,23,30,92,0.32608695652173914,16,50,0.32,14,42,0.3333333333333333,12,18,0.6666666666666666,2,36,38,16,12,4,14,22,88,2014_James Nunnally
2014,Kenyon Martin,PF,36,63,123,0.5121951219512195,0,1,0.0,63,122,0.5163934426229508,11,19,0.5789473684210527,36,98,134,50,25,27,26,85,137,2014_Kenyon Martin
2014,LaMarcus Aldridge,PF,28,652,1423,0.45818692902319047,3,15,0.2,649,1408,0.4609375,296,360,0.8222222222222222,166,599,765,178,63,68,123,147,1603,2014_LaMarcus Aldridge
2014,Patrick Patterson,PF,24,450,978,0.4601226993865031,110,302,0.36423841059602646,340,676,0.5029585798816568,100,142,0.704225352112676,234,450,684,156,110,74,130,318,1110,2014_Patrick Patterson
2014,Samuel Dalembert,C,32,214,377,0.5676392572944297,0,1,0.0,214,376,0.5691489361702128,101,137,0.7372262773722628,200,341,541,38,41,94,90,210,529,2014_Samuel Dalembert
2014,Shabazz Muhammad,SG,21,57,124,0.4596774193548387,3,11,0.2727272727272727,54,113,0.4778761061946903,26,40,0.65,24,29,53,6,8,1,16,24,143,2014_Shabazz Muhammad
2014,Tornike Shengelia,SF,22,26,56,0.4642857142857143,0,12,0.0,26,44,0.5909090909090909,6,16,0.375,8,24,32,28,6,2,24,36,58,2014_Tornike Shengelia
2015,Cory Jefferson,PF,24,75,167,0.4491017964071856,2,15,0.13333333333333333,73,152,0.48026315789473684,31,54,0.5740740740740741,47,98,145,16,10,21,20,61,183,2015_Cory Jefferson
2015,Derrick Rose,PG,26,338,835,0.40479041916167663,76,271,0.28044280442804426,262,564,0.4645390070921986,152,187,0.8128342245989305,35,126,161,251,36,16,161,63,904,2015_Derrick Rose
2015,Jimmy Butler,SG,25,421,912,0.4616228070175439,73,193,0.37823834196891193,348,719,0.48400556328233657,386,463,0.8336933045356372,114,265,379,212,114,36,93,108,1301,2015_Jimmy Butler
2015,Kenyon Martin,PF,37,9,22,0.4090909090909091,0,0,NaN,9,22,0.4090909090909091,2,2,1.0,6,13,19,5,5,6,3,13,20,2015_Kenyon Martin
2015,LaMarcus Aldridge,PF,29,659,1415,0.4657243816254417,37,105,0.3523809523809524,622,1310,0.47480916030534354,306,362,0.8453038674033149,177,549,726,124,48,68,122,125,1661,2015_LaMarcus Aldridge
2015,Malcolm Thomas,PF,26,18,40,0.45,0,7,0.0,18,33,0.5454545454545454,9,13,0.6923076923076923,16,40,56,7,3,1,13,17,45,2015_Malcolm Thomas
2015,Patrick Patterson,PF,25,240,535,0.4485981308411215,105,283,0.3710247349823322,135,252,0.5357142857142857,63,80,0.7875,127,306,433,155,60,44,54,149,648,2015_Patrick Patterson
2015,Robert Covington,SF,24,299,756,0.3955026455026455,167,446,0.3744394618834081,132,310,0.4258064516129032,178,217,0.8202764976958525,65,251,316,105,97,31,128,189,943,2015_Robert Covington
2015,Sergey Karasev,SG,21,54,134,0.40298507462686567,16,54,0.2962962962962963,38,80,0.475,29,38,0.7631578947368421,22,44,66,46,23,1,24,45,153,2015_Sergey Karasev
2015,Shelvin Mack,PG,24,117,292,0.4006849315068493,40,127,0.31496062992125984,77,165,0.4666666666666667,25,31,0.8064516129032258,8,71,79,155,30,2,49,32,299,2015_Shelvin Mack
2015,Troy Daniels,SG,23,122,330,0.3696969696969697,86,236,0.3644067796610169,36,94,0.3829787234042553,22,26,0.8461538461538461,16,50,66,44,12,2,40,80,352,2015_Troy Daniels
2015,Tyson Chandler,C,32,293,440,0.6659090909090909,0,0,NaN,293,440,0.6659090909090909,185,257,0.7198443579766537,294,570,864,84,42,91,105,169,771,2015_Tyson Chandler
2016,Brandon Bass,PF,30,174,317,0.5488958990536278,0,2,0.0,174,315,0.5523809523809524,125,148,0.8445945945945946,104,181,285,74,33,55,42,125,473,2016_Brandon Bass
2016,Dante Cunningham,SF,28,186,412,0.45145631067961167,55,174,0.3160919540229885,131,238,0.5504201680672269,57,82,0.6951219512195121,57,179,236,77,42,33,41,173,484,2016_Dante Cunningham
2016,Donatas Motiejunas,PF,25,90,205,0.43902439024390244,16,57,0.2807017543859649,74,148,0.5,34,53,0.6415094339622641,37,72,109,41,17,5,44,69,230,2016_Donatas Motiejunas
2016,Jarell Martin,PF,21,54,116,0.46551724137931033,0,2,0.0,54,114,0.47368421052631576,45,62,0.7258064516129032,39,47,86,15,8,7,19,58,153,2016_Jarell Martin
2016,Patrick Patterson,PF,26,204,493,0.41379310344827586,106,293,0.36177474402730375,98,200,0.49,29,34,0.8529411764705882,77,265,342,94,53,32,65,128,543,2016_Patrick Patterson
2016,Wesley Johnson,SF,28,208,515,0.40388349514563104,103,309,0.3333333333333333,105,206,0.5097087378640777,30,46,0.6521739130434783,37,211,248,49,89,56,54,173,549,2016_Wesley Johnson
2017,Andrew Nicholson,PF,27,86,222,0.38738738738738737,10,54,0.18518518518518517,76,168,0.4523809523809524,18,28,0.6428571428571429,30,92,122,20,32,12,34,110,200,2017_Andrew Nicholson
2017,Derrick Williams,PF,25,216,488,0.4426229508196721,60,194,0.30927835051546393,156,294,0.5306122448979592,116,178,0.651685393258427,38,222,260,56,28,14,56,120,608,2017_Derrick Williams
2017,Diamond Stone,C,19,3,13,0.23076923076923078,0,0,NaN,3,13,0.23076923076923078,4,4,1.0,1,5,6,0,0,1,2,5,10,2017_Diamond Stone
2017,Draymond Green,PF,26,272,650,0.41846153846153844,81,263,0.30798479087452474,191,387,0.4935400516795866,151,213,0.7089201877934272,98,501,599,533,154,106,184,217,776,2017_Draymond Green
2017,Ed Davis,PF,27,75,142,0.528169014084507,0,0,NaN,75,142,0.528169014084507,50,81,0.6172839506172839,96,147,243,27,15,22,37,137,200,2017_Ed Davis
2017,Jarell Martin,PF,22,58,151,0.3841059602649007,9,25,0.36,49,126,0.3888888888888889,40,50,0.8,42,120,162,8,17,9,28,91,165,2017_Jarell Martin
2017,Kevon Looney,C,20,56,107,0.5233644859813084,2,9,0.2222222222222222,54,98,0.5510204081632653,21,34,0.6176470588235294,44,80,124,29,14,17,17,64,135,2017_Kevon Looney
2017,Nick Young,SG,31,272,633,0.4296998420221169,170,421,0.40380047505938244,102,212,0.4811320754716981,77,90,0.8555555555555555,25,112,137,58,37,14,36,137,791,2017_Nick Young
2017,Nicolas Laprovittola,PG,27,20,47,0.425531914893617,10,27,0.37037037037037035,10,20,0.5,9,9,1.0,1,9,10,28,4,1,19,19,59,2017_Nicolas Laprovittola
2017,Patrick Patterson,PF,27,154,384,0.4010416666666667,94,253,0.3715415019762846,60,131,0.4580152671755725,43,60,0.7166666666666667,62,229,291,76,40,23,38,120,445,2017_Patrick Patterson
2017,Salah Mejri,C,30,88,137,0.6423357664233577,1,3,0.3333333333333333,87,134,0.6492537313432836,36,61,0.5901639344262295,97,211,308,14,32,61,40,152,213,2017_Salah Mejri
2017,Yogi Ferrell,PG,23,320,788,0.40609137055837563,136,352,0.38636363636363635,184,436,0.42201834862385323,148,178,0.8314606741573034,40,182,222,344,84,18,140,180,924,2017_Yogi Ferrell
2003,Anfernee Hardaway,SG,31,256,573,0.4467713787085515,26,73,0.3561643835616438,230,500,0.46,77,97,0.7938144329896907,66,192,258,235,66,26,145,150,615,2003_Anfernee Hardaway
2003,Antoine Rigaudeau,SG,31,8,35,0.22857142857142856,1,5,0.2,7,30,0.23333333333333334,0,0,NaN,4,4,8,6,3,0,6,11,17,2003_Antoine Rigaudeau
2003,Bruno Sundov,C,22,14,56,0.25,4,16,0.25,10,40,0.25,0,2,0.0,8,20,28,7,6,3,9,24,32,2003_Bruno Sundov
2003,Corey Maggette,SG,23,343,773,0.44372574385511,62,177,0.3502824858757062,281,596,0.4714765100671141,325,405,0.8024691358024691,77,245,322,123,55,16,147,194,1073,2003_Corey Maggette
2003,Dale Davis,C,33,237,438,0.541095890410959,0,0,NaN,237,438,0.541095890410959,105,166,0.6325301204819277,233,331,564,94,51,70,71,189,579,2003_Dale Davis
2003,Danny Ferry,SF,36,44,124,0.3548387096774194,21,60,0.35,23,64,0.359375,10,13,0.7692307692307693,20,55,75,21,7,9,27,55,119,2003_Danny Ferry
2003,Dion Glover,SG,24,277,648,0.42746913580246915,56,158,0.35443037974683544,221,490,0.45102040816326533,127,162,0.7839506172839507,62,220,282,141,71,15,108,146,737,2003_Dion Glover
2003,Ervin Johnson,C,35,61,135,0.45185185185185184,0,0,NaN,61,135,0.45185185185185184,30,44,0.6818181818181818,117,177,294,24,34,63,34,178,152,2003_Ervin Johnson
2003,Jannero Pargo,PG,23,37,93,0.3978494623655914,7,24,0.2916666666666667,30,69,0.43478260869565216,4,4,1.0,9,28,37,39,13,2,23,45,85,2003_Jannero Pargo
2003,Michael Bradley,PF,23,151,314,0.48089171974522293,1,6,0.16666666666666666,150,308,0.487012987012987,35,67,0.5223880597014925,162,247,409,67,16,32,76,125,338,2003_Michael Bradley
2003,Mike Miller,SF,22,746,1718,0.4342258440046566,218,600,0.36333333333333334,528,1118,0.47227191413237923,312,372,0.8387096774193549,92,590,682,340,84,42,250,346,2022,2003_Mike Miller
2003,Pat Garrity,PF,26,312,744,0.41935483870967744,161,407,0.3955773955773956,151,337,0.44807121661721067,83,100,0.83,72,234,306,121,62,20,77,255,868,2003_Pat Garrity
2003,Rasheed Wallace,PF,28,515,1094,0.47074954296160876,110,307,0.3583061889250814,405,787,0.5146124523506989,200,272,0.7352941176470589,113,435,548,153,70,77,140,223,1340,2003_Rasheed Wallace
2003,Sean Rooks,C,33,125,297,0.4208754208754209,0,1,0.0,125,296,0.4222972972972973,47,58,0.8103448275862069,53,163,216,69,34,44,66,174,297,2003_Sean Rooks
2003,Shawn Bradley,C,30,201,375,0.536,0,1,0.0,201,374,0.5374331550802139,141,175,0.8057142857142857,151,325,476,54,65,170,67,242,543,2003_Shawn Bradley
2003,Theo Ratliff,C,29,276,595,0.4638655462184874,0,0,NaN,276,595,0.4638655462184874,154,214,0.719626168224299,154,453,607,73,56,262,137,271,706,2003_Theo Ratliff
2003,Todd MacCulloch,C,27,123,238,0.5168067226890757,0,0,NaN,123,238,0.5168067226890757,53,79,0.6708860759493671,66,130,196,20,19,32,35,107,299,2003_Todd MacCulloch
2003,Tony Delk,PG,29,233,560,0.4160714285714286,120,304,0.39473684210526316,113,256,0.44140625,68,87,0.7816091954022989,41,191,232,146,72,10,69,124,654,2003_Tony Delk
2003,Tony Parker,PG,20,484,1043,0.46404602109300097,82,243,0.3374485596707819,402,800,0.5025,219,290,0.7551724137931034,33,183,216,432,71,4,198,174,1269,2003_Tony Parker
2003,Vitaly Potapenko,C,27,41,93,0.44086021505376344,0,0,NaN,41,93,0.44086021505376344,22,29,0.7586206896551724,25,64,89,4,9,8,25,46,104,2003_Vitaly Potapenko
2004,Andre Miller,PG,27,430,941,0.4569606801275239,12,65,0.18461538461538463,418,876,0.4771689497716895,342,411,0.8321167883211679,127,239,366,501,142,25,215,194,1214,2004_Andre Miller
2004,Anfernee Hardaway,SG,32,558,1358,0.4108983799705449,60,158,0.379746835443038,498,1200,0.415,222,276,0.8043478260869565,138,436,574,352,140,40,214,292,1398,2004_Anfernee Hardaway
2004,Dan Langhi,SF,26,10,28,0.35714285714285715,2,4,0.5,8,24,0.3333333333333333,4,4,1.0,0,8,8,0,0,0,4,14,26,2004_Dan Langhi
2004,David West,PF,23,108,228,0.47368421052631576,0,2,0.0,108,226,0.4778761061946903,57,80,0.7125,117,180,297,60,27,28,48,117,273,2004_David West
2004,Derrick Dial,SG,28,9,28,0.32142857142857145,2,9,0.2222222222222222,7,19,0.3684210526315789,6,8,0.75,5,8,13,2,6,0,1,6,26,2004_Derrick Dial
2004,Desmond Penigar,PF,22,14,28,0.5,0,0,NaN,14,28,0.5,4,4,1.0,6,18,24,3,2,2,6,14,32,2004_Desmond Penigar
2004,Dion Glover,SG,25,460,1178,0.3904923599320883,80,238,0.33613445378151263,380,940,0.40425531914893614,240,312,0.7692307692307693,116,416,532,260,100,38,204,246,1240,2004_Dion Glover
2004,Ervin Johnson,C,36,55,103,0.5339805825242718,0,1,0.0,55,102,0.5392156862745098,17,28,0.6071428571428571,61,171,232,24,27,43,30,156,127,2004_Ervin Johnson
2004,Jannero Pargo,PG,24,162,398,0.40703517587939697,44,124,0.3548387096774194,118,274,0.4306569343065693,46,54,0.8518518518518519,16,58,74,140,26,12,94,100,414,2004_Jannero Pargo
2004,Jerome Beasley,PF,23,1,3,0.3333333333333333,0,0,NaN,1,3,0.3333333333333333,0,0,NaN,0,1,1,0,0,0,0,0,2,2004_Jerome Beasley
2004,Leon Smith,C,23,1,2,0.5,0,0,NaN,1,2,0.5,0,0,NaN,1,1,2,0,0,0,0,1,2,2004_Leon Smith
2004,Marcus Banks,PG,22,177,442,0.4004524886877828,27,86,0.313953488372093,150,356,0.42134831460674155,99,131,0.7557251908396947,30,103,133,175,88,13,125,171,480,2004_Marcus Banks
2004,Michael Bradley,C_PF_C-PF,24,14,30,0.4666666666666667,0,0,NaN,14,30,0.4666666666666667,2,4,0.5,12,34,46,2,6,0,14,28,30,2004_Michael Bradley
2004,Mike Miller,SF,23,270,616,0.4383116883116883,80,215,0.37209302325581395,190,401,0.47381546134663344,102,141,0.723404255319149,42,174,216,232,59,14,107,162,722,2004_Mike Miller
2004,Oliver Miller,C,33,53,100,0.53,0,1,0.0,53,99,0.5353535353535354,15,23,0.6521739130434783,46,84,130,36,19,26,33,91,121,2004_Oliver Miller
2004,Pat Garrity,PF,27,1,3,0.3333333333333333,0,0,NaN,1,3,0.3333333333333333,0,0,NaN,0,0,0,1,0,0,0,2,2,2004_Pat Garrity
2004,Rasheed Wallace,PF,29,850,1948,0.43634496919917864,164,496,0.33064516129032256,686,1452,0.4724517906336088,312,424,0.7358490566037735,204,714,918,312,122,244,238,380,2176,2004_Rasheed Wallace
2004,Shawn Bradley,C,31,89,188,0.4734042553191489,0,1,0.0,89,187,0.47593582887700536,41,49,0.8367346938775511,72,101,173,20,33,74,17,130,219,2004_Shawn Bradley
2004,Tony Parker,PG,21,423,946,0.44714587737843553,62,199,0.31155778894472363,361,747,0.48326639892904955,191,272,0.7022058823529411,43,194,237,411,61,7,179,148,1099,2004_Tony Parker
2004,Tyronn Lue,PG,26,309,714,0.4327731092436975,80,209,0.3827751196172249,229,505,0.4534653465346535,101,131,0.7709923664122137,26,161,187,317,61,5,124,185,799,2004_Tyronn Lue
2005,Aleksandar Radojevic,C,28,6,19,0.3157894736842105,0,0,NaN,6,19,0.3157894736842105,7,10,0.7,9,19,28,6,0,2,15,32,19,2005_Aleksandar Radojevic
2005,Anfernee Hardaway,SF,33,110,260,0.4230769230769231,15,50,0.3,95,210,0.4523809523809524,34,46,0.7391304347826086,19,70,89,74,28,3,50,79,269,2005_Anfernee Hardaway
2005,Antonio Burks,PG,24,28,60,0.4666666666666667,3,11,0.2727272727272727,25,49,0.5102040816326531,14,19,0.7368421052631579,1,11,12,28,13,1,12,25,73,2005_Antonio Burks
2005,Chris Wilcox,C,22,169,329,0.513677811550152,0,0,NaN,169,329,0.513677811550152,88,144,0.6111111111111112,63,165,228,38,26,24,77,129,426,2005_Chris Wilcox
2005,Cory Alexander,SG,31,16,49,0.32653061224489793,8,19,0.42105263157894735,8,30,0.26666666666666666,9,12,0.75,8,21,29,37,9,1,19,29,49,2005_Cory Alexander
2005,Dion Glover,SG,26,8,22,0.36363636363636365,1,8,0.125,7,14,0.5,8,10,0.8,3,8,11,4,3,3,2,9,25,2005_Dion Glover
2005,Eddy Curry,C,22,393,730,0.5383561643835616,0,0,NaN,393,730,0.5383561643835616,226,314,0.7197452229299363,116,222,338,37,21,58,163,202,1012,2005_Eddy Curry
2005,Elden Campbell,C,36,78,246,0.3170731707317073,0,4,0.0,78,242,0.32231404958677684,84,110,0.7636363636363637,56,130,186,38,16,14,58,114,240,2005_Elden Campbell
2005,Ervin Johnson,C,37,28,54,0.5185185185185185,1,1,1.0,27,53,0.5094339622641509,16,25,0.64,43,70,113,6,7,13,18,86,73,2005_Ervin Johnson
2005,J.R. Smith,SG,19,295,748,0.39438502673796794,81,281,0.28825622775800713,214,467,0.4582441113490364,111,161,0.6894409937888198,39,113,152,142,55,11,109,135,782,2005_J.R. Smith
2005,Jannero Pargo,PG,25,82,213,0.38497652582159625,23,66,0.3484848484848485,59,147,0.4013605442176871,17,23,0.7391304347826086,12,35,47,76,16,1,45,53,204,2005_Jannero Pargo
2005,Jeff McInnis,PG,30,377,915,0.41202185792349727,91,264,0.3446969696969697,286,651,0.4393241167434716,130,160,0.8125,32,125,157,391,56,1,117,177,975,2005_Jeff McInnis
2005,Josh Davis,PF,24,42,111,0.3783783783783784,19,53,0.3584905660377358,23,58,0.39655172413793105,14,17,0.8235294117647058,29,50,79,12,8,4,15,45,117,2005_Josh Davis
2005,Kevin Martin,PG,21,45,117,0.38461538461538464,5,25,0.2,40,92,0.43478260869565216,36,55,0.6545454545454545,29,29,58,22,16,3,24,35,131,2005_Kevin Martin
2005,Marc Jackson,C,30,340,731,0.46511627906976744,0,2,0.0,340,729,0.4663923182441701,289,349,0.828080229226361,184,222,406,81,32,18,131,171,969,2005_Marc Jackson
2005,Michael Bradley,PF,25,30,48,0.625,0,2,0.0,30,46,0.6521739130434783,6,16,0.375,16,40,56,10,2,4,10,24,66,2005_Michael Bradley
2005,Michael Ruffin,C,28,41,99,0.41414141414141414,0,1,0.0,41,98,0.41836734693877553,29,67,0.43283582089552236,157,175,332,64,43,41,44,193,111,2005_Michael Ruffin
2005,Mike Miller,SF,24,387,766,0.5052219321148825,140,323,0.43343653250773995,247,443,0.5575620767494357,108,150,0.72,36,264,300,220,54,23,127,197,1022,2005_Mike Miller
2005,Pat Garrity,PF,28,123,306,0.4019607843137255,49,147,0.3333333333333333,74,159,0.46540880503144655,29,33,0.8787878787878788,21,103,124,30,19,9,30,107,324,2005_Pat Garrity
2005,Shawn Bradley,C,32,84,186,0.45161290322580644,0,0,NaN,84,186,0.45161290322580644,43,63,0.6825396825396826,70,144,214,15,25,63,33,153,211,2005_Shawn Bradley
2005,Tony Parker,PG,22,539,1118,0.4821109123434705,43,156,0.27564102564102566,496,962,0.5155925155925156,210,323,0.6501547987616099,47,251,298,491,98,4,215,167,1331,2005_Tony Parker
2006,Anfernee Hardaway,SF,34,4,14,0.2857142857142857,0,1,0.0,4,13,0.3076923076923077,2,2,1.0,0,10,10,8,2,0,6,7,10,2006_Anfernee Hardaway
2006,Anthony Grundy,SG,26,19,38,0.5,5,15,0.3333333333333333,14,23,0.6086956521739131,9,14,0.6428571428571429,1,16,17,9,7,0,9,14,52,2006_Anthony Grundy
2006,Antonio Burks,PG,25,51,144,0.3541666666666667,1,6,0.16666666666666666,50,138,0.36231884057971014,10,23,0.43478260869565216,4,33,37,76,20,0,36,45,113,2006_Antonio Burks
2006,Calvin Booth,C,29,20,47,0.425531914893617,1,2,0.5,19,45,0.4222222222222222,5,9,0.5555555555555556,19,33,52,12,9,9,8,44,46,2006_Calvin Booth
2006,Chris Andersen,C,27,56,98,0.5714285714285714,0,0,NaN,56,98,0.5714285714285714,49,103,0.47572815533980584,61,94,155,6,8,41,26,84,161,2006_Chris Andersen
2006,Eddie Gill,PG,27,10,45,0.2222222222222222,7,23,0.30434782608695654,3,22,0.13636363636363635,18,23,0.782608695652174,0,15,15,12,11,1,9,13,45,2006_Eddie Gill
2006,Ervin Johnson,C,38,7,17,0.4117647058823529,0,0,NaN,7,17,0.4117647058823529,1,2,0.5,5,19,24,2,1,2,5,23,15,2006_Ervin Johnson
2006,Jamal Crawford,SG,25,366,879,0.41638225255972694,101,293,0.3447098976109215,265,586,0.4522184300341297,295,357,0.8263305322128851,36,212,248,301,87,15,175,150,1128,2006_Jamal Crawford
2006,Jannero Pargo,PG,26,109,292,0.3732876712328767,39,103,0.3786407766990291,70,189,0.37037037037037035,17,21,0.8095238095238095,8,53,61,94,24,2,61,57,274,2006_Jannero Pargo
2006,Jerry Stackhouse,SG,31,242,603,0.4013266998341625,36,130,0.27692307692307694,206,473,0.4355179704016913,195,221,0.8823529411764706,32,121,153,160,37,10,121,96,715,2006_Jerry Stackhouse
2006,Michael Bradley,PF,26,32,79,0.4050632911392405,1,5,0.2,31,74,0.4189189189189189,2,3,0.6666666666666666,40,67,107,17,5,7,19,39,67,2006_Michael Bradley
2006,Mike Miller,SG,25,354,760,0.46578947368421053,138,339,0.40707964601769914,216,421,0.5130641330166271,168,210,0.8,42,355,397,200,52,27,140,173,1014,2006_Mike Miller
2006,Mikki Moore,C,30,54,124,0.43548387096774194,0,2,0.0,54,122,0.4426229508196721,46,62,0.7419354838709677,44,86,130,27,7,15,40,92,154,2006_Mikki Moore
2006,Pat Garrity,PF,29,101,242,0.41735537190082644,50,129,0.3875968992248062,51,113,0.45132743362831856,30,37,0.8108108108108109,31,77,108,38,12,9,38,108,282,2006_Pat Garrity
2006,Tony Parker,PG,23,623,1136,0.5484154929577465,11,36,0.3055555555555556,612,1100,0.5563636363636364,253,358,0.7067039106145251,38,223,261,460,83,4,249,161,1510,2006_Tony Parker
2007,Aaron Williams,PF,35,29,53,0.5471698113207547,0,1,0.0,29,52,0.5576923076923077,18,22,0.8181818181818182,27,58,85,7,7,14,18,56,76,2007_Aaron Williams
2007,Fred Jones,SG,27,278,722,0.3850415512465374,78,256,0.3046875,200,466,0.4291845493562232,190,228,0.8333333333333334,46,184,230,216,96,32,134,242,824,2007_Fred Jones
2007,James Posey,SF,30,186,432,0.4305555555555556,97,259,0.3745173745173745,89,173,0.5144508670520231,81,98,0.826530612244898,66,291,357,94,71,23,55,193,550,2007_James Posey
2007,Jannero Pargo,PG,27,283,692,0.40895953757225434,81,209,0.3875598086124402,202,483,0.41821946169772256,104,122,0.8524590163934426,20,160,180,203,53,4,122,121,751,2007_Jannero Pargo
2007,Marcus Vinicius,SF,22,7,15,0.4666666666666667,3,7,0.42857142857142855,4,8,0.5,5,7,0.7142857142857143,2,9,11,5,2,1,6,10,22,2007_Marcus Vinicius
2007,Mike Miller,SG,26,465,1010,0.4603960396039604,202,498,0.40562248995983935,263,512,0.513671875,161,203,0.7931034482758621,52,326,378,298,54,18,179,138,1293,2007_Mike Miller
2007,Mikki Moore,C,31,308,506,0.6086956521739131,0,1,0.0,308,505,0.6099009900990099,160,235,0.6808510638297872,145,258,403,74,46,60,113,261,776,2007_Mikki Moore
2007,Robert Hite,SG,23,19,60,0.31666666666666665,5,23,0.21739130434782608,14,37,0.3783783783783784,8,12,0.6666666666666666,4,12,16,8,3,2,6,8,51,2007_Robert Hite
2007,Steven Smith,PF,23,2,8,0.25,0,0,NaN,2,8,0.25,1,2,0.5,1,5,6,0,1,0,2,4,5,2007_Steven Smith
2007,Tony Parker,PG,24,570,1096,0.5200729927007299,15,38,0.39473684210526316,555,1058,0.5245746691871456,274,350,0.7828571428571428,34,216,250,420,82,6,191,137,1429,2007_Tony Parker
2007,Yakhouba Diawara,SG,24,100,292,0.3424657534246575,49,170,0.28823529411764703,51,122,0.4180327868852459,35,53,0.660377358490566,27,83,110,55,30,7,37,132,284,2007_Yakhouba Diawara
2008,Amir Johnson,PF,20,92,165,0.5575757575757576,0,0,NaN,92,165,0.5575757575757576,37,55,0.6727272727272727,87,148,235,29,24,82,39,141,221,2008_Amir Johnson
2008,Andre Iguodala,SF,24,582,1277,0.4557556773688332,101,307,0.3289902280130293,481,970,0.49587628865979383,365,506,0.7213438735177866,85,361,446,391,171,49,214,187,1630,2008_Andre Iguodala
2008,Andrew Bynum,C,20,189,297,0.6363636363636364,0,0,NaN,189,297,0.6363636363636364,82,118,0.6949152542372882,105,251,356,61,12,72,52,98,460,2008_Andrew Bynum
2008,Anfernee Hardaway,SF,36,22,60,0.36666666666666664,8,19,0.42105263157894735,14,41,0.34146341463414637,8,9,0.8888888888888888,3,32,35,35,19,1,13,24,60,2008_Anfernee Hardaway
2008,Donyell Marshall,PF,34,64,196,0.32653061224489793,30,106,0.2830188679245283,34,90,0.37777777777777777,38,44,0.8636363636363636,48,104,152,20,12,32,30,62,196,2008_Donyell Marshall
2008,James Posey,PF,31,173,414,0.4178743961352657,106,279,0.37992831541218636,67,135,0.4962962962962963,93,115,0.808695652173913,30,292,322,114,72,19,65,182,545,2008_James Posey
2008,Jannero Pargo,SG,28,254,652,0.3895705521472393,65,186,0.34946236559139787,189,466,0.4055793991416309,71,81,0.8765432098765432,26,104,130,192,50,5,93,123,644,2008_Jannero Pargo
2008,Lou Amundson,PF,25,8,16,0.5,0,0,NaN,8,16,0.5,2,7,0.2857142857142857,7,5,12,0,1,1,2,13,18,2008_Lou Amundson
2008,Marcus Vinicius,SF,23,9,20,0.45,5,12,0.4166666666666667,4,8,0.5,5,11,0.45454545454545453,1,7,8,2,1,1,3,4,28,2008_Marcus Vinicius
2008,Marcus Williams,SF_PF_PF-SF,21,10,40,0.25,0,0,NaN,10,40,0.25,0,0,NaN,8,16,24,6,2,2,0,6,20,2008_Marcus Williams
2008,Mike Miller,SG,27,414,824,0.5024271844660194,155,359,0.43175487465181056,259,465,0.556989247311828,164,212,0.7735849056603774,51,416,467,240,35,16,182,145,1147,2008_Mike Miller
2008,Mikki Moore,PF,32,282,489,0.5766871165644172,0,2,0.0,282,487,0.5790554414784395,134,182,0.7362637362637363,160,334,494,84,35,46,110,310,698,2008_Mikki Moore
2008,Richard Hamilton,SG,29,499,1030,0.48446601941747575,62,141,0.4397163120567376,437,889,0.4915635545556805,184,221,0.832579185520362,75,160,235,299,73,10,132,171,1244,2008_Richard Hamilton
2008,Ronny Turiaf,C,25,188,397,0.473551637279597,0,1,0.0,188,396,0.47474747474747475,140,186,0.7526881720430108,95,211,306,128,28,108,72,199,516,2008_Ronny Turiaf
2008,Spencer Hawes,C,19,146,318,0.4591194968553459,4,21,0.19047619047619047,142,297,0.4781144781144781,38,58,0.6551724137931034,68,162,230,44,14,40,56,128,334,2008_Spencer Hawes
2008,Tony Parker,PG,25,515,1043,0.4937679769894535,17,66,0.25757575757575757,498,977,0.5097236438075742,248,347,0.7146974063400576,30,191,221,411,55,8,164,93,1295,2008_Tony Parker
2009,Caron Butler,SG,28,491,1085,0.4525345622119816,65,210,0.30952380952380953,426,875,0.4868571428571429,345,402,0.8582089552238806,118,296,414,290,106,20,210,165,1392,2009_Caron Butler
2009,Henry Walker,SF,21,36,58,0.6206896551724138,0,1,0.0,36,57,0.631578947368421,16,23,0.6956521739130435,8,21,29,13,6,2,18,51,88,2009_Henry Walker
2009,James Posey,SG,32,216,524,0.4122137404580153,116,314,0.36942675159235666,100,210,0.47619047619047616,120,146,0.821917808219178,38,324,362,82,58,21,79,216,668,2009_James Posey
2009,Marcus Williams,PF,22,2,2,1.0,0,0,NaN,2,2,1.0,0,0,NaN,0,0,0,0,0,0,0,1,4,2009_Marcus Williams
2009,Matt Carroll,SG,28,130,342,0.38011695906432746,26,106,0.24528301886792453,104,236,0.4406779661016949,42,50,0.84,14,124,138,54,42,12,66,134,328,2009_Matt Carroll
2009,Mike Miller,SF,28,264,548,0.48175182481751827,85,225,0.37777777777777777,179,323,0.5541795665634675,109,149,0.7315436241610739,73,410,483,326,30,31,145,139,722,2009_Mike Miller
2009,Mikki Moore,C_PF_PF-C,33,228,412,0.5533980582524272,0,0,NaN,228,412,0.5533980582524272,96,122,0.7868852459016393,152,364,516,106,34,38,96,416,552,2009_Mikki Moore
2009,Roko Ukic,PG,24,123,324,0.37962962962962965,11,62,0.1774193548387097,112,262,0.42748091603053434,44,60,0.7333333333333333,27,48,75,153,30,2,60,77,301,2009_Roko Ukic
2009,Ronnie Price,PG,25,77,203,0.3793103448275862,19,61,0.3114754098360656,58,142,0.4084507042253521,34,45,0.7555555555555555,12,57,69,108,39,5,61,74,207,2009_Ronnie Price
2009,Stromile Swift,PF,29,48,112,0.42857142857142855,2,2,1.0,46,110,0.41818181818181815,26,52,0.5,32,60,92,6,8,16,32,80,124,2009_Stromile Swift
2009,Tony Parker,PG,26,639,1263,0.505938242280285,19,65,0.2923076923076923,620,1198,0.5175292153589316,284,363,0.7823691460055097,27,196,223,496,67,4,186,110,1581,2009_Tony Parker
2010,Amar'e Stoudemire,PF,27,704,1264,0.5569620253164557,1,6,0.16666666666666666,703,1258,0.5588235294117647,487,632,0.7705696202531646,230,502,732,82,52,83,213,281,1896,2010_Amar'e Stoudemire
2010,Andray Blatche,PF,23,478,999,0.47847847847847846,13,44,0.29545454545454547,465,955,0.4869109947643979,174,234,0.7435897435897436,158,351,509,170,85,71,182,218,1143,2010_Andray Blatche
2010,Arron Afflalo,SG,24,272,585,0.46495726495726497,108,249,0.43373493975903615,164,336,0.4880952380952381,72,98,0.7346938775510204,59,193,252,138,46,30,74,225,724,2010_Arron Afflalo
2010,Danilo Gallinari,SF,21,392,927,0.4228694714131607,186,488,0.38114754098360654,206,439,0.46924829157175396,251,307,0.8175895765472313,65,333,398,135,75,58,110,191,1221,2010_Danilo Gallinari
2010,Dominic McGuire,SF,24,38,104,0.36538461538461536,0,0,NaN,38,104,0.36538461538461536,0,14,0.0,46,112,158,22,10,8,34,70,76,2010_Dominic McGuire
2010,Dwayne Jones,PF,26,0,0,NaN,0,0,NaN,0,0,NaN,0,0,NaN,0,2,2,0,0,0,0,1,0,2010_Dwayne Jones
2010,Jannero Pargo,PG,30,132,381,0.3464566929133858,38,138,0.2753623188405797,94,243,0.3868312757201646,42,45,0.9333333333333333,9,69,78,89,29,2,50,68,344,2010_Jannero Pargo
2010,Jason Kapono,SF,28,126,301,0.4186046511627907,63,171,0.3684210526315789,63,130,0.4846153846153846,9,15,0.6,14,52,66,39,21,6,34,80,324,2010_Jason Kapono
2010,Jason Maxiell,C,26,212,415,0.5108433734939759,0,1,0.0,212,414,0.5120772946859904,89,155,0.5741935483870968,161,240,401,39,36,38,68,175,513,2010_Jason Maxiell
2010,Josh McRoberts,C,22,76,146,0.5205479452054794,8,23,0.34782608695652173,68,123,0.5528455284552846,19,38,0.5,40,87,127,44,17,16,19,74,179,2010_Josh McRoberts
2010,Rasheed Wallace,C,35,266,650,0.40923076923076923,82,290,0.2827586206896552,184,360,0.5111111111111111,96,125,0.768,42,283,325,80,80,70,63,222,710,2010_Rasheed Wallace
2010,Spencer Hawes,C,21,312,666,0.46846846846846846,26,87,0.2988505747126437,286,579,0.4939550949913644,73,106,0.6886792452830188,145,291,436,158,32,83,131,200,723,2010_Spencer Hawes
2010,Tyson Chandler,C,27,109,190,0.5736842105263158,0,0,NaN,109,190,0.5736842105263158,115,157,0.732484076433121,114,206,320,16,17,55,91,138,333,2010_Tyson Chandler
2011,Amar'e Stoudemire,C,28,744,1482,0.5020242914979757,10,23,0.43478260869565216,734,1459,0.5030843043180261,473,597,0.7922948073701842,198,438,636,202,71,150,250,274,1971,2011_Amar'e Stoudemire
2011,Arron Afflalo,SG,25,312,627,0.49760765550239233,105,248,0.42338709677419356,207,379,0.5461741424802111,138,163,0.8466257668711656,45,206,251,168,34,31,71,153,867,2011_Arron Afflalo
2011,Brandon Bass,PF,25,332,645,0.5147286821705427,0,2,0.0,332,643,0.5163297045101088,190,233,0.8154506437768241,134,290,424,57,27,52,97,159,854,2011_Brandon Bass
2011,Dominic McGuire,SF,25,72,182,0.3956043956043956,0,2,0.0,72,180,0.4,30,39,0.7692307692307693,63,136,199,43,10,33,25,94,174,2011_Dominic McGuire
2011,Dominique Jones,SG,22,14,45,0.3111111111111111,0,4,0.0,14,41,0.34146341463414637,14,17,0.8235294117647058,6,19,25,19,5,3,10,7,42,2011_Dominique Jones
2011,Gerald Henderson,SG,23,259,570,0.4543859649122807,7,36,0.19444444444444445,252,534,0.47191011235955055,128,163,0.7852760736196319,49,158,207,101,50,32,64,118,653,2011_Gerald Henderson
2011,Gilbert Arenas,PG,29,538,1468,0.36648501362397823,194,654,0.2966360856269113,344,814,0.4226044226044226,240,306,0.7843137254901961,44,334,378,548,148,42,354,376,1510,2011_Gilbert Arenas
2011,Ike Diogu,PF,27,83,148,0.5608108108108109,0,0,NaN,83,148,0.5608108108108109,41,62,0.6612903225806451,41,74,115,2,3,3,22,72,207,2011_Ike Diogu
2011,Jason Maxiell,PF,27,93,189,0.49206349206349204,0,0,NaN,93,189,0.49206349206349204,51,99,0.5151515151515151,66,107,173,17,24,21,44,92,237,2011_Jason Maxiell
2011,Mike Miller,SG,30,81,202,0.400990099009901,43,118,0.3644067796610169,38,84,0.4523809523809524,23,34,0.6764705882352942,38,146,184,51,20,2,41,88,228,2011_Mike Miller
2011,Spencer Hawes,C,22,264,568,0.4647887323943662,9,37,0.24324324324324326,255,531,0.480225988700565,47,88,0.5340909090909091,129,336,465,121,29,71,97,201,584,2011_Spencer Hawes
2012,A.J. Price,PG,25,59,174,0.3390804597701149,26,88,0.29545454545454547,33,86,0.38372093023255816,28,35,0.8,13,48,61,86,20,2,32,30,172,2012_A.J. Price
2012,Amar'e Stoudemire,PF,29,316,654,0.4831804281345566,5,21,0.23809523809523808,311,633,0.4913112164296998,186,243,0.7654320987654321,106,261,367,52,38,45,112,138,823,2012_Amar'e Stoudemire
2012,Arron Afflalo,SG,26,329,699,0.47067238912732473,88,221,0.39819004524886875,241,478,0.50418410041841,197,247,0.7975708502024291,40,157,197,149,36,13,85,134,943,2012_Arron Afflalo
2012,DaJuan Summers,SF,24,28,65,0.4307692307692308,5,16,0.3125,23,49,0.46938775510204084,7,9,0.7777777777777778,8,15,23,10,7,0,8,31,68,2012_DaJuan Summers
2012,Dominic McGuire,PF,26,94,210,0.44761904761904764,0,4,0.0,94,206,0.4563106796116505,39,53,0.7358490566037735,73,173,246,110,44,36,56,104,227,2012_Dominic McGuire
2012,Dominique Jones,SG,23,29,73,0.3972602739726027,1,8,0.125,28,65,0.4307692307692308,29,37,0.7837837837837838,9,35,44,42,10,5,28,28,88,2012_Dominique Jones
2012,Donald Sloan,PG,24,158,396,0.398989898989899,4,50,0.08,154,346,0.44508670520231214,46,60,0.7666666666666667,36,98,134,210,26,6,98,74,366,2012_Donald Sloan
2012,E'Twaun Moore,PG,22,43,113,0.3805309734513274,17,45,0.37777777777777777,26,68,0.38235294117647056,7,7,1.0,4,29,33,34,11,3,21,33,110,2012_E'Twaun Moore
2012,Gerald Wallace,SF,29,574,1264,0.4541139240506329,92,300,0.30666666666666664,482,964,0.5,360,450,0.8,174,598,772,328,170,72,222,290,1600,2012_Gerald Wallace
2012,Ike Diogu,PF,28,0,2,0.0,0,0,NaN,0,2,0.0,2,2,1.0,0,1,1,0,0,0,1,1,2,2012_Ike Diogu
2012,Jannero Pargo,PG,32,105,253,0.4150197628458498,53,138,0.38405797101449274,52,115,0.45217391304347826,19,20,0.95,9,64,73,96,20,2,49,64,282,2012_Jannero Pargo
2012,Jason Maxiell,PF,28,183,383,0.47780678851174935,0,2,0.0,183,381,0.48031496062992124,58,106,0.5471698113207547,126,207,333,41,32,50,71,151,424,2012_Jason Maxiell
2012,Lavoy Allen,PF,22,79,167,0.47305389221556887,0,0,NaN,79,167,0.47305389221556887,11,14,0.7857142857142857,47,124,171,34,13,18,20,73,169,2012_Lavoy Allen
2012,Mike James,PG,36,20,49,0.40816326530612246,6,10,0.6,14,39,0.358974358974359,7,8,0.875,2,8,10,29,4,2,14,20,53,2012_Mike James
2012,Mike Miller,SG,31,91,209,0.4354066985645933,53,117,0.452991452991453,38,92,0.41304347826086957,2,5,0.4,22,106,128,42,14,6,30,58,237,2012_Mike Miller
2012,Nick Young,SG,26,632,1568,0.4030612244897959,206,564,0.36524822695035464,426,1004,0.4243027888446215,288,338,0.8520710059171598,62,204,266,112,88,34,166,282,1758,2012_Nick Young
2012,Quincy Pondexter,SF,23,108,239,0.45188284518828453,22,73,0.3013698630136986,86,166,0.5180722891566265,33,53,0.6226415094339622,55,71,126,27,27,5,30,90,271,2012_Quincy Pondexter
2012,Spencer Hawes,C,23,156,319,0.4890282131661442,3,12,0.25,153,307,0.498371335504886,40,55,0.7272727272727273,78,192,270,98,16,48,55,100,355,2012_Spencer Hawes
2013,Anthony Davis,PF,19,349,676,0.5162721893491125,0,6,0.0,349,670,0.5208955223880597,169,225,0.7511111111111111,165,357,522,63,75,112,89,158,867,2013_Anthony Davis
2013,Arron Afflalo,SF,27,397,905,0.43867403314917125,72,240,0.3,325,665,0.48872180451127817,191,223,0.8565022421524664,29,210,239,206,40,11,138,137,1057,2013_Arron Afflalo
2013,Cole Aldrich,C,24,88,160,0.55,0,0,NaN,88,160,0.55,24,40,0.6,60,180,240,18,10,46,46,120,200,2013_Cole Aldrich
2013,Darrell Arthur,PF,24,162,359,0.45125348189415043,5,18,0.2777777777777778,157,341,0.4604105571847507,33,46,0.717391304347826,68,101,169,33,24,33,43,126,362,2013_Darrell Arthur
2013,DeJuan Blair,PF,23,142,271,0.5239852398523985,0,1,0.0,142,270,0.5259259259259259,44,70,0.6285714285714286,66,164,230,45,37,10,49,112,328,2013_DeJuan Blair
2013,Dominic McGuire,SF,27,48,112,0.42857142857142855,0,0,NaN,48,112,0.42857142857142855,6,20,0.3,38,118,156,40,26,22,24,78,102,2013_Dominic McGuire
2013,Dominique Jones,PG,24,40,109,0.3669724770642202,1,9,0.1111111111111111,39,100,0.39,35,53,0.660377358490566,18,27,45,83,14,2,38,29,116,2013_Dominique Jones
2013,E'Twaun Moore,SG,23,237,598,0.3963210702341137,67,197,0.3401015228426396,170,401,0.4239401496259352,47,59,0.7966101694915254,48,119,167,206,51,23,105,122,588,2013_E'Twaun Moore
2013,Enes Kanter,C,20,206,379,0.5435356200527705,1,1,1.0,205,378,0.5423280423280423,93,117,0.7948717948717948,135,169,304,31,28,32,101,116,506,2013_Enes Kanter
2013,Jannero Pargo,PG,33,156,424,0.36792452830188677,78,232,0.33620689655172414,78,192,0.40625,24,26,0.9230769230769231,20,50,70,134,36,6,82,84,414,2013_Jannero Pargo
2013,Jason Maxiell,PF,29,204,457,0.44638949671772427,0,0,NaN,204,457,0.44638949671772427,90,145,0.6206896551724138,135,274,409,54,32,95,81,172,498,2013_Jason Maxiell
2013,Josh Smith,PF,27,550,1182,0.4653130287648054,61,201,0.3034825870646766,489,981,0.4984709480122324,166,321,0.5171339563862928,133,506,639,321,94,136,226,175,1327,2013_Josh Smith
2013,Lavoy Allen,C,23,206,454,0.45374449339207046,0,1,0.0,206,453,0.45474613686534215,43,60,0.7166666666666667,159,236,395,73,24,55,55,180,455,2013_Lavoy Allen
2013,Mike Miller,SF,32,100,231,0.4329004329004329,73,175,0.41714285714285715,27,56,0.48214285714285715,8,11,0.7272727272727273,18,139,157,99,21,4,35,63,281,2013_Mike Miller
2013,Miles Plumlee,C,24,5,21,0.23809523809523808,0,0,NaN,5,21,0.23809523809523808,3,4,0.75,12,10,22,2,0,3,3,5,13,2013_Miles Plumlee
2013,Nando De,SG,25,105,241,0.43568464730290457,31,82,0.3780487804878049,74,159,0.46540880503144655,35,44,0.7954545454545454,23,115,138,138,41,6,81,87,276,2013_Nando De
2013,Rasheed Wallace,C,38,55,142,0.3873239436619718,22,69,0.3188405797101449,33,73,0.4520547945205479,14,20,0.7,11,72,83,6,13,15,10,40,146,2013_Rasheed Wallace
2013,Spencer Hawes,C,24,376,811,0.4636251541307028,31,87,0.3563218390804598,345,724,0.47651933701657456,122,157,0.7770700636942676,173,417,590,183,24,113,131,233,905,2013_Spencer Hawes
2013,Tim Duncan,C,36,490,976,0.5020491803278688,2,7,0.2857142857142857,488,969,0.5036119711042312,245,300,0.8166666666666667,124,562,686,184,50,183,147,117,1227,2013_Tim Duncan
2013,Tony Parker,PG,30,519,995,0.521608040201005,24,68,0.35294117647058826,495,927,0.5339805825242718,279,330,0.8454545454545455,18,180,198,499,54,6,170,92,1341,2013_Tony Parker
2014,Arron Afflalo,SG,28,464,1011,0.4589515331355094,128,300,0.4266666666666667,336,711,0.47257383966244726,274,336,0.8154761904761905,32,230,262,248,35,3,146,136,1330,2014_Arron Afflalo
2014,Casper Ware,PG,24,18,42,0.42857142857142855,7,21,0.3333333333333333,11,21,0.5238095238095238,5,6,0.8333333333333334,0,9,9,10,8,0,5,11,48,2014_Casper Ware
2014,Dennis Schroder,PG,20,72,188,0.3829787234042553,10,42,0.23809523809523808,62,146,0.4246575342465753,29,43,0.6744186046511628,5,55,60,93,17,0,61,54,183,2014_Dennis Schroder
2014,Deron Williams,PG,29,322,716,0.44972067039106145,98,268,0.3656716417910448,224,448,0.5,173,216,0.8009259259259259,15,153,168,392,93,13,143,148,915,2014_Deron Williams
2014,E'Twaun Moore,SG,24,195,456,0.4276315789473684,57,161,0.35403726708074534,138,295,0.46779661016949153,52,68,0.7647058823529411,29,107,136,112,60,13,55,106,499,2014_E'Twaun Moore
2014,Enes Kanter,C,21,419,853,0.4912075029308324,0,1,0.0,419,852,0.49178403755868544,149,204,0.7303921568627451,222,376,598,75,28,42,144,230,987,2014_Enes Kanter
2014,Jannero Pargo,PG,34,52,118,0.4406779661016949,24,60,0.4,28,58,0.4827586206896552,8,11,0.7272727272727273,1,19,20,52,14,1,26,17,136,2014_Jannero Pargo
2014,Jeff Green,SF,27,482,1171,0.4116140051238258,135,396,0.3409090909090909,347,775,0.447741935483871,283,356,0.7949438202247191,54,326,380,138,57,47,165,180,1382,2014_Jeff Green
2014,John Lucas,PG,31,62,190,0.3263157894736842,25,84,0.2976190476190476,37,106,0.3490566037735849,10,16,0.625,12,27,39,42,14,0,22,41,159,2014_John Lucas
2014,Lavoy Allen,PF,24,268,600,0.44666666666666666,4,26,0.15384615384615385,264,574,0.45993031358885017,66,100,0.66,238,384,622,142,48,66,88,252,606,2014_Lavoy Allen
2014,Lou Williams,PG,27,197,493,0.3995943204868154,79,231,0.341991341991342,118,262,0.45038167938931295,152,179,0.8491620111731844,10,114,124,210,45,4,92,65,625,2014_Lou Williams
2014,Mike Miller,SF,33,213,443,0.48081264108352145,107,233,0.4592274678111588,106,210,0.5047619047619047,46,56,0.8214285714285714,30,177,207,130,26,5,77,95,579,2014_Mike Miller
2014,Miles Plumlee,C,25,286,553,0.5171790235081374,0,0,NaN,286,553,0.5171790235081374,74,132,0.5606060606060606,198,428,626,43,50,90,111,185,646,2014_Miles Plumlee
2014,Othyus Jeffers,SG,28,6,12,0.5,0,4,0.0,6,8,0.75,6,8,0.75,2,16,18,2,0,0,2,6,18,2014_Othyus Jeffers
2014,Shavlik Randolph,PF,30,7,14,0.5,0,0,NaN,7,14,0.5,6,11,0.5454545454545454,7,18,25,1,3,1,5,15,20,2014_Shavlik Randolph
2014,Spencer Hawes,C,25,806,1766,0.4563986409966025,256,616,0.4155844155844156,550,1150,0.4782608695652174,238,304,0.7828947368421053,262,1058,1320,480,88,188,346,474,2106,2014_Spencer Hawes
2014,Tony Parker,PG,31,456,914,0.4989059080962801,25,67,0.373134328358209,431,847,0.5088547815820543,197,243,0.8106995884773662,17,138,155,388,36,9,151,86,1134,2014_Tony Parker
2015,Andre Miller,PG,38,290,580,0.5,14,68,0.20588235294117646,276,512,0.5390625,116,154,0.7532467532467533,74,232,306,568,64,12,208,206,710,2015_Andre Miller
2015,Arron Afflalo,SG,29,750,1768,0.4242081447963801,236,666,0.35435435435435436,514,1102,0.4664246823956443,334,396,0.8434343434343434,54,440,494,258,82,14,232,334,2070,2015_Arron Afflalo
2015,Ben McLemore,SG,21,363,831,0.4368231046931408,140,391,0.35805626598465473,223,440,0.5068181818181818,130,160,0.8125,31,210,241,140,77,19,138,219,996,2015_Ben McLemore
2015,Damian Lillard,PG,24,590,1360,0.4338235294117647,196,572,0.34265734265734266,394,788,0.5,344,398,0.864321608040201,49,329,378,507,97,21,222,164,1720,2015_Damian Lillard
2015,David West,PF,34,323,686,0.4708454810495627,4,20,0.2,319,666,0.47897897897897895,119,161,0.7391304347826086,108,341,449,223,48,48,120,160,769,2015_David West
2015,Dennis Schroder,PG,21,284,665,0.4270676691729323,52,148,0.35135135135135137,232,517,0.44874274661508706,148,179,0.8268156424581006,29,135,164,317,49,4,150,127,768,2015_Dennis Schroder
2015,E'Twaun Moore,SG,25,62,139,0.4460431654676259,13,38,0.34210526315789475,49,101,0.48514851485148514,12,20,0.6,12,34,46,33,20,6,14,45,149,2015_E'Twaun Moore
2015,Enes Kanter,C,22,964,1856,0.5193965517241379,32,90,0.35555555555555557,932,1766,0.5277463193657984,366,468,0.782051282051282,554,788,1342,110,72,58,290,378,2326,2015_Enes Kanter
2015,Ersan Ilyasova,PF,27,263,557,0.47217235188509876,74,190,0.3894736842105263,189,367,0.5149863760217984,69,107,0.6448598130841121,80,197,277,56,36,19,45,149,669,2015_Ersan Ilyasova
2015,J.J. Barea,PG,30,225,536,0.4197761194029851,54,167,0.32335329341317365,171,369,0.4634146341463415,76,94,0.8085106382978723,23,111,134,263,33,1,70,104,580,2015_J.J. Barea
2015,Jannero Pargo,PG,35,15,35,0.42857142857142855,9,22,0.4090909090909091,6,13,0.46153846153846156,2,2,1.0,0,3,3,8,0,0,3,8,41,2015_Jannero Pargo
2015,Jarnell Stokes,PF,21,21,37,0.5675675675675675,0,0,NaN,21,37,0.5675675675675675,15,28,0.5357142857142857,16,18,34,4,5,5,7,25,57,2015_Jarnell Stokes
2015,Kevin Seraphin,C,25,231,450,0.5133333333333333,0,2,0.0,231,448,0.515625,58,82,0.7073170731707317,87,201,288,59,10,59,98,197,520,2015_Kevin Seraphin
2015,Kosta Koufos,C,25,182,358,0.5083798882681564,0,0,NaN,182,358,0.5083798882681564,55,85,0.6470588235294118,121,305,426,37,29,63,69,148,419,2015_Kosta Koufos
2015,Larry Drew,PG,24,20,58,0.3448275862068966,4,26,0.15384615384615385,16,32,0.5,2,3,0.6666666666666666,1,14,15,45,6,0,25,13,46,2015_Larry Drew
2015,Lavoy Allen,C,25,141,299,0.47157190635451507,0,0,NaN,141,299,0.47157190635451507,33,47,0.7021276595744681,123,200,323,73,15,42,40,102,315,2015_Lavoy Allen
2015,Mike Miller,SF,34,37,114,0.32456140350877194,32,98,0.32653061224489793,5,16,0.3125,3,4,0.75,4,87,91,46,14,4,23,74,109,2015_Mike Miller
2015,Miles Plumlee,C,26,272,508,0.5354330708661418,0,0,NaN,272,508,0.5354330708661418,44,92,0.4782608695652174,224,416,640,68,82,132,102,222,588,2015_Miles Plumlee
2015,Mitch McGary,PF,22,88,165,0.5333333333333333,0,2,0.0,88,163,0.5398773006134969,25,40,0.625,53,112,165,14,16,16,31,72,201,2015_Mitch McGary
2015,Patrick Beverley,PG,26,204,532,0.38345864661654133,115,323,0.3560371517027864,89,209,0.4258373205741627,45,60,0.75,67,170,237,192,59,23,83,182,568,2015_Patrick Beverley
2015,Ramon Sessions,PG,28,250,668,0.37425149700598803,38,120,0.31666666666666665,212,548,0.38686131386861317,266,346,0.7687861271676301,46,242,288,364,58,0,172,146,804,2015_Ramon Sessions
2015,Sean Kilpatrick,SG,25,7,20,0.35,4,13,0.3076923076923077,3,7,0.42857142857142855,4,4,1.0,1,5,6,4,3,0,2,3,22,2015_Sean Kilpatrick
2015,Spencer Hawes,PF,26,163,415,0.3927710843373494,55,176,0.3125,108,239,0.45188284518828453,44,68,0.6470588235294118,30,228,258,88,24,53,61,173,425,2015_Spencer Hawes
2015,Tony Parker,PG,32,404,832,0.4855769230769231,38,89,0.42696629213483145,366,743,0.49259757738896365,130,166,0.7831325301204819,15,114,129,335,44,2,146,108,976,2015_Tony Parker
2015,Tristan Thompson,PF,23,267,488,0.5471311475409836,0,0,NaN,267,488,0.5471311475409836,159,248,0.6411290322580645,274,383,657,39,34,61,83,189,693,2015_Tristan Thompson
2015,Tyler Hansbrough,PF,29,86,165,0.5212121212121212,1,7,0.14285714285714285,85,158,0.5379746835443038,97,139,0.697841726618705,106,159,265,21,30,15,20,141,270,2015_Tyler Hansbrough
2016,Dennis Schroder,PG,22,329,781,0.4212548015364917,77,239,0.32217573221757323,252,542,0.46494464944649444,144,182,0.7912087912087912,25,179,204,349,70,9,183,138,879,2016_Dennis Schroder
2016,E'Twaun Moore,SG,26,187,389,0.480719794344473,47,104,0.4519230769230769,140,285,0.49122807017543857,22,35,0.6285714285714286,19,114,133,99,37,18,53,103,443,2016_E'Twaun Moore
2016,Enes Kanter,C,23,414,719,0.5757997218358831,10,21,0.47619047619047616,404,698,0.5787965616045845,200,251,0.796812749003984,249,415,664,33,26,33,115,166,1038,2016_Enes Kanter
2016,Garrett Temple,SF,29,201,505,0.39801980198019804,89,258,0.3449612403100775,112,247,0.4534412955465587,91,125,0.728,36,176,212,140,69,18,64,195,582,2016_Garrett Temple
2016,Josh Huestis,PF,24,5,12,0.4166666666666667,4,6,0.6666666666666666,1,6,0.16666666666666666,0,4,0.0,2,8,10,0,1,2,3,3,14,2016_Josh Huestis
2016,Kendall Marshall,PG,24,43,118,0.3644067796610169,16,49,0.32653061224489793,27,69,0.391304347826087,9,13,0.6923076923076923,2,26,28,73,16,2,43,30,111,2016_Kendall Marshall
2016,Kevin Martin,SG,32,312,838,0.3723150357995227,98,272,0.3602941176470588,214,566,0.37809187279151946,306,344,0.8895348837209303,28,192,220,116,52,6,108,166,1028,2016_Kevin Martin
2016,Kyle Lowry,PG,29,512,1198,0.4273789649415693,212,547,0.3875685557586837,300,651,0.4608294930875576,398,491,0.8105906313645621,55,310,365,494,158,34,225,211,1634,2016_Kyle Lowry
2016,Lavoy Allen,PF,26,191,370,0.5162162162162162,0,0,NaN,191,370,0.5162162162162162,46,73,0.6301369863013698,162,262,424,76,26,42,69,147,428,2016_Lavoy Allen
2016,Luc Mbah,PF,29,94,207,0.45410628019323673,13,40,0.325,81,167,0.48502994011976047,30,57,0.5263157894736842,60,111,171,30,44,19,34,100,231,2016_Luc Mbah
2016,Mike Miller,SF,35,22,62,0.3548387096774194,19,52,0.36538461538461536,3,10,0.3,0,0,NaN,6,47,53,40,13,4,17,53,63,2016_Mike Miller
2016,Miles Plumlee,C,27,140,233,0.6008583690987125,0,0,NaN,140,233,0.6008583690987125,34,59,0.576271186440678,94,138,232,16,21,50,40,73,314,2016_Miles Plumlee
2016,Sean Kilpatrick,SG,26,246,540,0.45555555555555555,78,228,0.34210526315789475,168,312,0.5384615384615384,120,134,0.8955223880597015,24,88,112,58,24,4,62,74,690,2016_Sean Kilpatrick
2016,Spencer Hawes,PF,27,124,306,0.40522875816993464,38,102,0.37254901960784315,86,204,0.4215686274509804,54,65,0.8307692307692308,51,193,244,109,22,27,58,111,340,2016_Spencer Hawes
2016,Stanley Johnson,SF,19,225,600,0.375,63,205,0.3073170731707317,162,395,0.41012658227848103,80,102,0.7843137254901961,58,248,306,118,55,12,114,178,593,2016_Stanley Johnson
2016,Tony Parker,PG,33,350,710,0.49295774647887325,27,65,0.4153846153846154,323,645,0.5007751937984496,130,171,0.7602339181286549,17,159,176,379,54,11,131,114,857,2016_Tony Parker
2017,Chris Andersen,C,38,9,22,0.4090909090909091,0,3,0.0,9,19,0.47368421052631576,10,14,0.7142857142857143,9,22,31,5,5,7,5,20,28,2017_Chris Andersen
2017,Dennis Schroder,PG,23,548,1215,0.4510288065843621,100,294,0.3401360544217687,448,921,0.48642779587404994,218,255,0.8549019607843137,42,206,248,499,74,16,258,149,1414,2017_Dennis Schroder
2017,E'Twaun Moore,SG,27,283,619,0.45718901453957994,77,208,0.3701923076923077,206,411,0.5012165450121655,57,74,0.7702702702702703,33,119,152,164,50,32,62,131,700,2017_E'Twaun Moore
2017,Enes Kanter,C,24,402,737,0.5454545454545454,5,38,0.13157894736842105,397,699,0.5679542203147353,224,285,0.7859649122807018,195,287,482,67,32,38,123,154,1033,2017_Enes Kanter
2017,Fred VanVleet,PG,22,39,111,0.35135135135135137,11,29,0.3793103448275862,28,82,0.34146341463414637,18,22,0.8181818181818182,4,38,42,35,17,2,15,36,107,2017_Fred VanVleet
2017,Jamal Crawford,SG,36,359,869,0.4131185270425777,116,322,0.36024844720496896,243,547,0.44424131627056673,174,203,0.8571428571428571,17,112,129,213,59,14,134,115,1008,2017_Jamal Crawford
2017,Lavoy Allen,PF,27,77,168,0.4583333333333333,0,1,0.0,77,167,0.46107784431137727,23,33,0.696969696969697,105,115,220,57,18,24,29,78,177,2017_Lavoy Allen
2017,Marc Gasol,C,32,532,1160,0.4586206896551724,104,268,0.3880597014925373,428,892,0.4798206278026906,278,332,0.8373493975903614,60,402,462,338,67,99,166,171,1446,2017_Marc Gasol
2017,Mike Miller,SF,36,9,23,0.391304347826087,8,20,0.4,1,3,0.3333333333333333,2,2,1.0,3,36,39,22,2,0,13,9,28,2017_Mike Miller
2017,Miles Plumlee,C,28,88,184,0.4782608695652174,0,0,NaN,88,184,0.4782608695652174,50,78,0.6410256410256411,76,114,190,42,36,26,60,146,226,2017_Miles Plumlee
2017,Sean Kilpatrick,SG,27,305,735,0.41496598639455784,105,308,0.3409090909090909,200,427,0.468384074941452,204,242,0.8429752066115702,22,258,280,157,46,6,136,118,919,2017_Sean Kilpatrick
2017,Spencer Hawes,PF,28,268,554,0.48375451263537905,50,162,0.30864197530864196,218,392,0.5561224489795918,88,104,0.8461538461538461,76,306,382,162,30,60,98,154,674,2017_Spencer Hawes
2017,Tony Parker,PG,34,265,569,0.46572934973637964,23,69,0.3333333333333333,242,500,0.484,85,117,0.7264957264957265,9,104,113,285,33,2,89,92,638,2017_Tony Parker
2017,Tyus Jones,PG,20,75,181,0.4143646408839779,26,73,0.3561643835616438,49,108,0.4537037037037037,33,43,0.7674418604651163,10,57,67,156,47,5,38,50,209,2017_Tyus Jones
2003,Brad Miller,C,26,329,667,0.49325337331334335,5,16,0.3125,324,651,0.4976958525345622,292,357,0.8179271708683473,185,418,603,193,65,43,118,203,955,2003_Brad Miller
2003,Donyell Marshall,PF,29,421,918,0.45860566448801743,33,87,0.3793103448275862,388,831,0.46690734055354993,167,221,0.755656108597285,234,465,699,137,95,85,135,234,1042,2003_Donyell Marshall
2003,Elton Brand,PF,23,451,899,0.5016685205784205,0,1,0.0,451,898,0.5022271714922049,244,356,0.6853932584269663,283,420,703,157,71,158,161,204,1146,2003_Elton Brand
2003,Hedo Turkoglu,SF,23,165,391,0.4219948849104859,29,78,0.3717948717948718,136,313,0.43450479233226835,88,110,0.8,35,153,188,87,25,12,50,125,447,2003_Hedo Turkoglu
2003,LaPhonso Ellis,PF,32,100,262,0.3816793893129771,27,107,0.2523364485981308,73,155,0.47096774193548385,50,66,0.7575757575757576,44,113,157,15,15,15,31,88,277,2003_LaPhonso Ellis
2003,Michael Stewart,PF,27,14,37,0.3783783783783784,0,0,NaN,14,37,0.3783783783783784,8,12,0.6666666666666666,19,36,55,6,2,15,10,42,36,2003_Michael Stewart
2003,P.J. Brown,PF,33,319,601,0.5307820299500832,0,3,0.0,319,598,0.5334448160535117,194,232,0.8362068965517241,243,458,701,147,67,80,98,203,832,2003_P.J. Brown
2003,Popeye Jones,PF,32,24,62,0.3870967741935484,0,0,NaN,24,62,0.3870967741935484,5,11,0.45454545454545453,29,30,59,8,5,1,15,31,53,2003_Popeye Jones
2003,Robert Traylor,C,25,105,237,0.4430379746835443,1,3,0.3333333333333333,104,234,0.4444444444444444,57,88,0.6477272727272727,108,154,262,50,45,37,53,153,268,2003_Robert Traylor
2003,Samaki Walker,C,26,115,274,0.4197080291970803,0,1,0.0,115,273,0.42124542124542125,66,101,0.6534653465346535,115,253,368,64,20,55,56,143,296,2003_Samaki Walker
2003,Shammond Williams,PG,27,456,1158,0.39378238341968913,186,522,0.3563218390804598,270,636,0.42452830188679247,156,204,0.7647058823529411,48,294,342,532,154,12,228,280,1254,2003_Shammond Williams
2004,Alvin Williams,SG,29,201,496,0.40524193548387094,26,89,0.29213483146067415,175,407,0.42997542997543,66,85,0.7764705882352941,18,132,150,224,55,10,78,114,494,2004_Alvin Williams
2004,Antoine Walker,PF,27,483,1129,0.42781222320637735,82,305,0.26885245901639343,401,824,0.4866504854368932,103,186,0.553763440860215,198,486,684,369,65,65,202,212,1151,2004_Antoine Walker
2004,Brad Miller,PF,27,373,731,0.5102599179206566,12,38,0.3157894736842105,361,693,0.5209235209235209,256,329,0.7781155015197568,191,552,743,312,68,86,144,247,1014,2004_Brad Miller
2004,Brandon Hunter,PF,23,53,116,0.45689655172413796,0,3,0.0,53,113,0.4690265486725664,19,43,0.4418604651162791,50,68,118,19,13,1,22,40,125,2004_Brandon Hunter
2004,Cherokee Parks,C,31,4,10,0.4,0,0,NaN,4,10,0.4,4,6,0.6666666666666666,4,6,10,1,0,3,2,7,12,2004_Cherokee Parks
2004,Elton Brand,PF,24,484,982,0.49287169042769857,0,1,0.0,484,981,0.49337410805300713,411,532,0.7725563909774437,269,445,714,227,64,154,193,229,1379,2004_Elton Brand
2004,Hedo Turkoglu,SF,24,262,645,0.4062015503875969,101,241,0.4190871369294606,161,404,0.39851485148514854,114,161,0.7080745341614907,52,306,358,154,80,32,94,165,739,2004_Hedo Turkoglu
2004,Jamaal Tinsley,PG,25,153,370,0.4135135135135135,77,207,0.3719806763285024,76,163,0.4662576687116564,49,67,0.7313432835820896,28,108,136,303,84,17,110,132,432,2004_Jamaal Tinsley
2004,Jamal Mashburn,SF,31,156,398,0.39195979899497485,19,67,0.2835820895522388,137,331,0.41389728096676737,65,80,0.8125,19,98,117,47,14,5,37,42,396,2004_Jamal Mashburn
2004,Kirk Penney,SG,23,1,6,0.16666666666666666,1,3,0.3333333333333333,0,3,0.0,0,0,NaN,0,1,1,1,1,0,3,1,3,2004_Kirk Penney
2004,Michael Stewart,C_PF_C-PF,28,10,24,0.4166666666666667,0,0,NaN,10,24,0.4166666666666667,6,8,0.75,16,42,58,0,4,20,6,68,26,2004_Michael Stewart
2004,Samaki Walker,PF,27,38,99,0.3838383838383838,0,2,0.0,38,97,0.3917525773195876,29,44,0.6590909090909091,42,70,112,6,9,11,15,54,105,2004_Samaki Walker
2004,Samuel Dalembert,C,22,270,499,0.5410821643286573,0,1,0.0,270,498,0.5421686746987951,112,174,0.6436781609195402,194,432,626,21,44,189,86,273,652,2004_Samuel Dalembert
2004,Shammond Williams,SG-PG_SG_PG,28,174,464,0.375,60,200,0.3,114,264,0.4318181818181818,102,116,0.8793103448275862,18,102,120,232,74,4,94,124,510,2004_Shammond Williams
2005,Andre Barrett,PG,22,90,248,0.3629032258064516,28,104,0.2692307692307692,62,144,0.4305555555555556,28,38,0.7368421052631579,22,58,80,138,38,2,54,102,236,2005_Andre Barrett
2005,Brad Miller,C,28,319,609,0.5238095238095238,5,19,0.2631578947368421,314,590,0.5322033898305085,233,287,0.8118466898954704,139,382,521,220,69,68,82,181,876,2005_Brad Miller
2005,Derek Anderson,SG,30,152,391,0.3887468030690537,58,151,0.3841059602649007,94,240,0.39166666666666666,70,87,0.8045977011494253,25,103,128,143,36,4,70,89,432,2005_Derek Anderson
2005,Elton Brand,PF,25,629,1251,0.5027977617905676,0,3,0.0,629,1248,0.5040064102564102,364,484,0.7520661157024794,296,474,770,208,62,169,183,240,1622,2005_Elton Brand
2005,Hedo Turkoglu,SF,25,328,782,0.4194373401534527,93,245,0.3795918367346939,235,537,0.4376163873370577,188,225,0.8355555555555556,62,171,233,153,41,18,119,140,937,2005_Hedo Turkoglu
2005,Jason Kapono,SF,23,269,671,0.4008941877794337,80,194,0.41237113402061853,189,477,0.39622641509433965,70,85,0.8235294117647058,32,132,164,61,40,6,46,132,688,2005_Jason Kapono
2005,Kirk Penney,SG,24,1,3,0.3333333333333333,0,1,0.0,1,2,0.5,0,0,NaN,0,1,1,1,0,0,2,0,2,2005_Kirk Penney
2005,Maurice Baker,PG,25,0,2,0.0,0,0,NaN,0,2,0.0,0,0,NaN,2,2,4,2,2,0,2,6,0,2005_Maurice Baker
2005,Michael Doleac,C,27,148,331,0.4471299093655589,0,2,0.0,148,329,0.44984802431610943,25,41,0.6097560975609756,74,185,259,47,23,22,36,160,321,2005_Michael Doleac
2005,Michael Stewart,PF,29,11,21,0.5238095238095238,0,0,NaN,11,21,0.5238095238095238,3,7,0.42857142857142855,21,19,40,5,6,5,6,32,25,2005_Michael Stewart
2005,Nick Collison,C,24,190,354,0.536723163841808,0,3,0.0,190,351,0.5413105413105413,83,118,0.7033898305084746,156,220,376,32,34,50,62,252,463,2005_Nick Collison
2005,Qyntel Woods,SF,23,5,12,0.4166666666666667,0,0,NaN,5,12,0.4166666666666667,0,0,NaN,2,4,6,0,4,0,2,6,10,2005_Qyntel Woods
2005,Samaki Walker,PF,28,11,31,0.3548387096774194,0,0,NaN,11,31,0.3548387096774194,2,3,0.6666666666666666,8,10,18,4,3,7,8,25,24,2005_Samaki Walker
2005,Tremaine Fowlkes,SF,28,9,17,0.5294117647058824,1,3,0.3333333333333333,8,14,0.5714285714285714,0,2,0.0,3,5,8,0,2,0,5,7,19,2005_Tremaine Fowlkes
2005,Tyson Chandler,C,22,207,419,0.49403341288782815,0,2,0.0,207,417,0.49640287769784175,226,336,0.6726190476190477,261,514,775,65,69,141,118,268,640,2005_Tyson Chandler
2006,Aaron Miles,PG,22,6,18,0.3333333333333333,0,0,NaN,6,18,0.3333333333333333,4,4,1.0,0,14,14,24,4,1,11,13,16,2006_Aaron Miles
2006,Andre Barrett,PG,23,76,208,0.36538461538461536,4,28,0.14285714285714285,72,180,0.4,18,24,0.75,18,32,50,104,20,0,30,26,174,2006_Andre Barrett
2006,Brad Miller,C,29,434,877,0.49486887115165334,34,88,0.38636363636363635,400,789,0.5069708491761724,280,338,0.8284023668639053,122,493,615,374,61,62,180,234,1182,2006_Brad Miller
2006,Brandon Bass,PF,20,28,70,0.4,0,0,NaN,28,70,0.4,12,19,0.631578947368421,18,50,68,3,3,7,11,18,68,2006_Brandon Bass
2006,Damien Wilkins,SF,26,193,435,0.4436781609195402,14,56,0.25,179,379,0.47229551451187335,136,162,0.8395061728395061,79,113,192,107,72,12,85,144,536,2006_Damien Wilkins
2006,Elton Brand,PF,26,756,1435,0.526829268292683,1,3,0.3333333333333333,755,1432,0.5272346368715084,440,568,0.7746478873239436,236,554,790,208,81,201,173,227,1953,2006_Elton Brand
2006,Gilbert Arenas,PG,24,746,1668,0.447242206235012,199,540,0.3685185185185185,547,1128,0.4849290780141844,655,799,0.8197747183979975,59,221,280,484,161,25,297,286,2346,2006_Gilbert Arenas
2006,Hedo Turkoglu,SF,26,398,877,0.45381984036488027,114,283,0.4028268551236749,284,594,0.4781144781144781,255,296,0.8614864864864865,70,263,333,216,70,21,130,234,1165,2006_Hedo Turkoglu
2006,Jason Hart,PG,27,86,221,0.3891402714932127,9,31,0.2903225806451613,77,190,0.4052631578947368,37,56,0.6607142857142857,12,59,71,70,31,5,43,85,218,2006_Jason Hart
2006,Nick Collison,PF,25,207,394,0.5253807106598984,0,3,0.0,207,391,0.5294117647058824,79,113,0.6991150442477876,143,225,368,74,21,35,77,213,493,2006_Nick Collison
2006,Samaki Walker,PF,29,0,2,0.0,0,0,NaN,0,2,0.0,2,2,1.0,0,3,3,0,0,1,2,7,2,2006_Samaki Walker
2006,Terence Morris,SF,27,16,49,0.32653061224489793,0,2,0.0,16,47,0.3404255319148936,3,3,1.0,6,32,38,4,6,5,7,19,35,2006_Terence Morris
2007,Andre Barrett,PG,24,4,8,0.5,0,0,NaN,4,8,0.5,0,0,NaN,1,4,5,7,0,0,4,4,8,2007_Andre Barrett
2007,Elton Brand,PF,27,645,1211,0.532617671345995,1,1,1.0,644,1210,0.5322314049586777,351,461,0.7613882863340564,268,476,744,235,77,179,202,238,1642,2007_Elton Brand
2007,Francisco Elson,C,30,144,282,0.5106382978723404,0,2,0.0,144,280,0.5142857142857142,62,80,0.775,81,255,336,55,31,59,86,184,350,2007_Francisco Elson
2007,Gerald Wallace,SF,24,478,952,0.5021008403361344,39,120,0.325,439,832,0.5276442307692307,309,447,0.6912751677852349,142,376,518,185,144,69,160,209,1304,2007_Gerald Wallace
2007,Hedo Turkoglu,SF,27,345,823,0.41919805589307413,109,281,0.3879003558718861,236,542,0.4354243542435424,171,219,0.7808219178082192,57,236,293,233,70,16,143,221,970,2007_Hedo Turkoglu
2007,Jason Richardson,SG,26,306,734,0.41689373297002724,110,301,0.3654485049833887,196,433,0.45265588914549654,92,140,0.6571428571428571,71,188,259,172,54,32,82,129,814,2007_Jason Richardson
2007,Jorge Garbajosa,PF,29,222,529,0.41965973534971646,66,193,0.34196891191709844,156,336,0.4642857142857143,57,78,0.7307692307692307,48,282,330,125,78,15,64,90,567,2007_Jorge Garbajosa
2007,Keith McLeod,PG,27,146,376,0.3882978723404255,32,90,0.35555555555555557,114,286,0.3986013986013986,138,156,0.8846153846153846,8,78,86,180,48,10,92,102,462,2007_Keith McLeod
2007,Kirk Hinrich,PG,26,475,1061,0.44769085768143263,140,337,0.41543026706231456,335,724,0.462707182320442,237,284,0.8345070422535211,32,242,274,500,100,23,191,274,1327,2007_Kirk Hinrich
2007,Marcus Williams,PG,21,208,526,0.39543726235741444,46,163,0.2822085889570552,162,363,0.4462809917355372,72,85,0.8470588235294118,29,134,163,260,29,2,142,96,534,2007_Marcus Williams
2007,Mike James,PG,31,297,703,0.422475106685633,80,215,0.37209302325581395,217,488,0.444672131147541,154,184,0.8369565217391305,25,138,163,297,55,7,129,171,828,2007_Mike James
2007,Nick Collison,C,26,318,636,0.5,0,2,0.0,318,634,0.501577287066246,154,199,0.7738693467336684,229,437,666,82,48,66,123,289,790,2007_Nick Collison
2007,Vassilis Spanoulis,SG,24,23,72,0.3194444444444444,5,29,0.1724137931034483,18,43,0.4186046511627907,34,42,0.8095238095238095,5,17,22,28,7,1,29,33,85,2007_Vassilis Spanoulis
2007,Zydrunas Ilgauskas,C,31,385,793,0.4854981084489281,0,1,0.0,385,792,0.4861111111111111,155,192,0.8072916666666666,242,357,599,123,48,98,141,257,925,2007_Zydrunas Ilgauskas
2008,Andre Barrett,PG,25,2,5,0.4,1,3,0.3333333333333333,1,2,0.5,1,2,0.5,0,1,1,7,0,0,1,1,6,2008_Andre Barrett
2008,Brian Cardinal,PF,30,43,126,0.3412698412698413,25,81,0.30864197530864196,18,45,0.4,13,19,0.6842105263157895,26,70,96,22,10,2,23,62,124,2008_Brian Cardinal
2008,Brian Cook,PF,27,176,468,0.37606837606837606,86,230,0.3739130434782609,90,238,0.37815126050420167,38,42,0.9047619047619048,56,162,218,54,26,24,78,186,476,2008_Brian Cook
2008,Brian Scalabrine,PF,29,29,94,0.30851063829787234,15,46,0.32608695652173914,14,48,0.2916666666666667,15,20,0.75,22,57,79,40,9,8,26,63,88,2008_Brian Scalabrine
2008,Chris Richard,C,23,41,87,0.47126436781609193,0,0,NaN,41,87,0.47126436781609193,16,27,0.5925925925925926,52,83,135,18,10,12,24,83,98,2008_Chris Richard
2008,Elton Brand,PF,28,52,114,0.45614035087719296,0,0,NaN,52,114,0.45614035087719296,37,47,0.7872340425531915,21,43,64,16,3,15,17,21,141,2008_Elton Brand
2008,Francisco Elson,C,31,184,472,0.3898305084745763,0,2,0.0,184,470,0.39148936170212767,52,74,0.7027027027027027,100,300,400,48,30,40,94,192,420,2008_Francisco Elson
2008,Hedo Turkoglu,SF,28,556,1219,0.4561115668580804,166,415,0.4,390,804,0.48507462686567165,324,391,0.8286445012787724,83,388,471,409,74,25,246,244,1602,2008_Hedo Turkoglu
2008,Josh Smith,PF,22,518,1133,0.45719329214474846,25,99,0.25252525252525254,493,1034,0.47678916827852996,333,469,0.7100213219616205,161,506,667,272,123,227,245,269,1394,2008_Josh Smith
2008,Kevin Durant,SG,19,587,1366,0.42972181551976574,59,205,0.28780487804878047,528,1161,0.45478036175710596,391,448,0.8727678571428571,70,278,348,192,78,75,232,122,1624,2008_Kevin Durant
2008,Marcus Williams,PG,22,111,293,0.378839590443686,54,142,0.38028169014084506,57,151,0.37748344370860926,37,47,0.7872340425531915,14,87,101,140,25,3,75,52,313,2008_Marcus Williams
2008,Nick Collison,PF,27,322,641,0.5023400936037441,0,2,0.0,322,639,0.5039123630672926,123,167,0.7365269461077845,254,476,730,113,47,60,118,250,767,2008_Nick Collison
2008,Rasho Nesterovic,C,31,257,467,0.550321199143469,1,3,0.3333333333333333,256,464,0.5517241379310345,37,49,0.7551020408163265,130,212,342,82,20,52,60,132,552,2008_Rasho Nesterovic
2008,Shelden Williams,PF,24,184,424,0.4339622641509434,0,4,0.0,184,420,0.4380952380952381,142,210,0.6761904761904762,136,274,410,38,44,42,70,220,510,2008_Shelden Williams
2008,Tim Duncan,C,31,585,1178,0.4966044142614601,0,4,0.0,585,1174,0.49829642248722317,338,463,0.7300215982721382,237,644,881,218,56,152,178,185,1508,2008_Tim Duncan
2009,Acie Law,PG,24,52,139,0.37410071942446044,9,29,0.3103448275862069,43,110,0.39090909090909093,49,60,0.8166666666666667,6,52,58,86,11,3,29,43,162,2009_Acie Law
2009,Andrei Kirilenko,PF,27,256,570,0.44912280701754387,20,73,0.273972602739726,236,497,0.47484909456740443,244,311,0.7845659163987139,84,235,319,175,83,77,121,127,776,2009_Andrei Kirilenko
2009,Anthony Parker,SG,33,321,754,0.42572944297082227,94,241,0.3900414937759336,227,513,0.442495126705653,121,145,0.8344827586206897,45,272,317,269,100,15,114,145,857,2009_Anthony Parker
2009,Deron Williams,PG,24,463,984,0.47052845528455284,70,226,0.30973451327433627,393,758,0.5184696569920845,326,384,0.8489583333333334,24,171,195,725,73,20,228,134,1322,2009_Deron Williams
2009,Elton Brand,PF,29,163,365,0.4465753424657534,0,0,NaN,163,365,0.4465753424657534,73,108,0.6759259259259259,77,177,254,37,17,45,68,78,399,2009_Elton Brand
2009,Francisco Elson,C,32,83,169,0.4911242603550296,1,4,0.25,82,165,0.49696969696969695,33,39,0.8461538461538461,100,129,229,32,36,36,48,144,200,2009_Francisco Elson
2009,Francisco Garcia,SF,27,295,665,0.44360902255639095,88,221,0.39819004524886875,207,444,0.46621621621621623,146,178,0.8202247191011236,56,162,218,150,80,67,112,196,824,2009_Francisco Garcia
2009,Hedo Turkoglu,SF,29,423,1025,0.41268292682926827,134,376,0.35638297872340424,289,649,0.4453004622496148,314,389,0.8071979434447301,45,365,410,375,64,19,204,218,1294,2009_Hedo Turkoglu
2009,Jeff Green,PF,22,476,1068,0.44569288389513106,96,247,0.38866396761133604,380,821,0.4628501827040195,242,307,0.7882736156351792,120,399,519,155,81,33,173,202,1290,2009_Jeff Green
2009,Joel Przybilla,C,29,168,269,0.6245353159851301,0,1,0.0,168,268,0.6268656716417911,112,169,0.6627218934911243,204,513,717,27,34,97,78,215,448,2009_Joel Przybilla
2009,Lou Williams,SG,22,336,844,0.3981042654028436,63,220,0.2863636363636364,273,624,0.4375,304,385,0.7896103896103897,36,129,165,242,85,14,151,128,1039,2009_Lou Williams
2009,Marcus Williams,PG,23,4,17,0.23529411764705882,2,6,0.3333333333333333,2,11,0.18181818181818182,2,6,0.3333333333333333,0,4,4,13,1,1,4,6,12,2009_Marcus Williams
2009,Mike Taylor,PG,23,110,267,0.41198501872659177,13,40,0.325,97,227,0.42731277533039647,56,81,0.691358024691358,22,65,87,106,36,0,73,84,289,2009_Mike Taylor
2009,Nick Collison,C,28,243,428,0.5677570093457944,0,2,0.0,243,426,0.5704225352112676,98,136,0.7205882352941176,181,308,489,66,51,50,73,239,584,2009_Nick Collison
2009,Quincy Douby,PG,24,84,220,0.38181818181818183,28,92,0.30434782608695654,56,128,0.4375,34,38,0.8947368421052632,12,52,64,50,10,10,26,54,230,2009_Quincy Douby
2009,Randy Foye,SG,25,399,981,0.40672782874617736,111,308,0.36038961038961037,288,673,0.4279346210995542,230,272,0.8455882352941176,34,180,214,303,72,26,150,201,1139,2009_Randy Foye
2009,Rashad McCants,SG,24,384,976,0.39344262295081966,126,378,0.3333333333333333,258,598,0.431438127090301,214,282,0.7588652482269503,42,178,220,136,94,28,128,206,1108,2009_Rashad McCants
2009,Reggie Evans,PF,28,79,178,0.4438202247191011,0,1,0.0,79,177,0.4463276836158192,104,175,0.5942857142857143,135,226,361,26,41,8,69,161,262,2009_Reggie Evans
2009,Theo Ratliff,C,35,34,64,0.53125,0,0,NaN,34,64,0.53125,21,35,0.6,46,82,128,9,17,47,14,77,89,2009_Theo Ratliff
2010,Brad Miller,C,33,250,581,0.43029259896729777,37,132,0.2803030303030303,213,449,0.47438752783964366,182,220,0.8272727272727273,83,316,399,154,44,29,107,189,719,2010_Brad Miller
2010,C.J. Watson,PG,25,247,528,0.4678030303030303,45,145,0.3103448275862069,202,383,0.5274151436031331,128,166,0.7710843373493976,28,141,169,180,103,8,69,124,667,2010_C.J. Watson
2010,Carl Landry,PF,26,998,1862,0.5359828141783028,2,6,0.3333333333333333,996,1856,0.5366379310344828,688,854,0.8056206088992974,376,560,936,132,110,126,272,468,2686,2010_Carl Landry
2010,Charlie Bell,SG,30,169,443,0.38148984198645597,73,200,0.365,96,243,0.3950617283950617,48,67,0.7164179104477612,31,101,132,104,39,12,54,136,459,2010_Charlie Bell
2010,Chris Kaman,C,27,589,1202,0.49001663893510816,0,6,0.0,589,1196,0.49247491638795987,230,307,0.749185667752443,184,520,704,120,37,94,223,213,1408,2010_Chris Kaman
2010,Corey Brewer,SG,23,409,949,0.4309799789251844,82,237,0.3459915611814346,327,712,0.4592696629213483,166,256,0.6484375,70,209,279,193,117,29,164,224,1066,2010_Corey Brewer
2010,David West,PF,29,619,1226,0.5048939641109299,7,27,0.25925925925925924,612,1199,0.5104253544620517,296,342,0.8654970760233918,164,441,605,239,76,60,173,233,1541,2010_David West
2010,Elton Brand,PF,30,412,858,0.4801864801864802,0,1,0.0,412,857,0.4807467911318553,172,233,0.7381974248927039,179,282,461,109,82,80,131,232,996,2010_Elton Brand
2010,Hedo Turkoglu,SF,30,276,674,0.4094955489614243,108,289,0.3737024221453287,168,385,0.43636363636363634,175,226,0.7743362831858407,42,301,343,304,55,32,125,220,835,2010_Hedo Turkoglu
2010,J.J. Barea,PG,25,232,527,0.44022770398481975,56,157,0.35668789808917195,176,370,0.4756756756756757,76,90,0.8444444444444444,17,129,146,258,35,6,102,119,596,2010_J.J. Barea
2010,Jason Williams,PG,34,189,426,0.44366197183098594,84,221,0.38009049773755654,105,205,0.5121951219512195,31,41,0.7560975609756098,7,119,126,298,53,3,87,65,493,2010_Jason Williams
2010,Marcus Banks,PG,28,39,73,0.5342465753424658,7,24,0.2916666666666667,32,49,0.6530612244897959,24,29,0.8275862068965517,3,20,23,26,12,2,20,30,109,2010_Marcus Banks
2010,Rodrigue Beaubois,PG,21,155,299,0.5183946488294314,45,110,0.4090909090909091,110,189,0.582010582010582,42,52,0.8076923076923077,12,66,78,74,29,12,54,84,397,2010_Rodrigue Beaubois
2010,Royal Ivey,SG,28,70,166,0.42168674698795183,28,70,0.4,42,96,0.4375,18,24,0.75,12,56,68,54,38,4,22,78,186,2010_Royal Ivey
2010,Stephen Graham,SG,27,119,240,0.49583333333333335,16,50,0.32,103,190,0.5421052631578948,42,65,0.6461538461538462,24,111,135,23,20,10,36,94,296,2010_Stephen Graham
2011,Blake Griffin,PF,21,696,1376,0.5058139534883721,7,24,0.2916666666666667,689,1352,0.5096153846153846,446,695,0.641726618705036,270,719,989,312,63,45,223,252,1845,2011_Blake Griffin
2011,Brad Miller,C,34,132,296,0.44594594594594594,40,107,0.37383177570093457,92,189,0.48677248677248675,78,94,0.8297872340425532,44,178,222,145,28,21,54,98,382,2011_Brad Miller
2011,C.J. Watson,PG,26,146,394,0.37055837563451777,44,112,0.39285714285714285,102,282,0.3617021276595745,69,93,0.7419354838709677,16,78,94,186,55,11,73,82,405,2011_C.J. Watson
2011,Carl Landry,PF,27,690,1374,0.5021834061135371,0,8,0.0,690,1366,0.5051244509516838,426,576,0.7395833333333334,330,364,694,126,80,64,218,392,1806,2011_Carl Landry
2011,Chris Kaman,C,28,177,376,0.47074468085106386,0,0,NaN,177,376,0.47074468085106386,43,57,0.7543859649122807,51,174,225,46,16,48,58,75,397,2011_Chris Kaman
2011,Chris Wilcox,PF,28,187,322,0.5807453416149069,0,1,0.0,187,321,0.5825545171339563,50,89,0.5617977528089888,95,176,271,43,29,17,43,145,424,2011_Chris Wilcox
2011,D.J. White,C_PF_C-PF,24,222,438,0.5068493150684932,0,4,0.0,222,434,0.511520737327189,92,128,0.71875,86,230,316,38,24,40,28,154,536,2011_D.J. White
2011,Elton Brand,PF,31,502,981,0.5117227319062182,0,1,0.0,502,980,0.5122448979591837,213,273,0.7802197802197802,237,439,676,120,92,106,101,244,1217,2011_Elton Brand
2011,Goran Dragic,PG,24,384,882,0.43537414965986393,112,310,0.36129032258064514,272,572,0.4755244755244755,166,266,0.6240601503759399,72,212,284,408,100,20,234,250,1046,2011_Goran Dragic
2011,Hedo Turkoglu,SF-PF_SF_PF,31,644,1444,0.44598337950138506,254,620,0.4096774193548387,390,824,0.4733009708737864,212,312,0.6794871794871795,90,622,712,686,144,68,264,494,1754,2011_Hedo Turkoglu
2011,Kevin Martin,SG,27,553,1267,0.43646408839779005,176,459,0.38344226579520696,377,808,0.4665841584158416,594,669,0.8878923766816144,28,230,258,198,80,15,184,155,1876,2011_Kevin Martin
2011,Maurice Ager,SG,26,6,11,0.5454545454545454,3,4,0.75,3,7,0.42857142857142855,0,0,NaN,0,2,2,1,1,0,4,4,15,2011_Maurice Ager
2011,Nick Collison,C,30,137,242,0.5661157024793388,0,0,NaN,137,242,0.5661157024793388,55,73,0.7534246575342466,119,197,316,69,42,31,55,210,329,2011_Nick Collison
2011,Rodrigue Beaubois,PG,22,94,223,0.42152466367713004,25,83,0.30120481927710846,69,140,0.4928571428571429,23,30,0.7666666666666667,7,45,52,64,20,8,47,76,236,2011_Rodrigue Beaubois
2011,Rudy Gay,SF,24,409,869,0.4706559263521289,57,144,0.3958333333333333,352,725,0.48551724137931035,194,241,0.8049792531120332,82,254,336,153,91,58,135,131,1069,2011_Rudy Gay
2011,Trey Johnson,SG,26,24,66,0.36363636363636365,2,6,0.3333333333333333,22,60,0.36666666666666664,18,20,0.9,4,10,14,22,2,2,10,24,68,2011_Trey Johnson
2012,Blake Griffin,PF,22,561,1022,0.5489236790606654,2,16,0.125,559,1006,0.5556660039761432,244,468,0.5213675213675214,218,499,717,210,54,48,150,216,1368,2012_Blake Griffin
2012,Brad Miller,C,35,9,27,0.3333333333333333,7,15,0.4666666666666667,2,12,0.16666666666666666,10,12,0.8333333333333334,4,15,19,24,4,2,12,10,35,2012_Brad Miller
2012,C.J. Watson,PG,27,161,437,0.3684210526315789,68,173,0.3930635838150289,93,264,0.3522727272727273,84,104,0.8076923076923077,21,84,105,200,45,8,97,103,474,2012_C.J. Watson
2012,Carl Landry,PF,28,182,362,0.5027624309392266,0,3,0.0,182,359,0.5069637883008357,147,184,0.7989130434782609,78,136,214,38,13,12,64,89,511,2012_Carl Landry
2012,Chris Kaman,C,29,266,597,0.4455611390284757,0,0,NaN,266,597,0.4455611390284757,84,107,0.7850467289719626,89,275,364,101,25,77,129,106,616,2012_Chris Kaman
2012,Dan Gadzuric,C,33,0,2,0.0,0,0,NaN,0,2,0.0,0,2,0.0,1,4,5,0,1,1,1,4,0,2012_Dan Gadzuric
2012,Elton Brand,C,32,287,581,0.4939759036144578,0,1,0.0,287,580,0.49482758620689654,85,116,0.7327586206896551,145,284,429,97,58,97,65,176,659,2012_Elton Brand
2012,Gordon Hayward,SF,21,267,586,0.45563139931740615,55,159,0.34591194968553457,212,427,0.4964871194379391,193,232,0.8318965517241379,59,171,230,207,53,41,109,106,782,2012_Gordon Hayward
2012,Hedo Turkoglu,SF,32,209,504,0.4146825396825397,91,258,0.35271317829457366,118,246,0.4796747967479675,67,95,0.7052631578947368,24,175,199,233,45,17,142,139,576,2012_Hedo Turkoglu
2012,Iman Shumpert,PG,21,214,534,0.40074906367041196,48,157,0.3057324840764331,166,377,0.4403183023872679,87,109,0.7981651376146789,42,144,186,164,101,8,111,173,563,2012_Iman Shumpert
2012,JaJuan Johnson,PF,22,54,121,0.4462809917355372,0,0,NaN,54,121,0.4462809917355372,6,9,0.6666666666666666,20,38,58,6,5,14,14,25,114,2012_JaJuan Johnson
2012,Jamario Moon,SF,31,7,24,0.2916666666666667,2,10,0.2,5,14,0.35714285714285715,2,2,1.0,2,20,22,5,1,5,8,5,18,2012_Jamario Moon
2012,Jason Thompson,PF,25,237,443,0.5349887133182845,0,2,0.0,237,441,0.5374149659863946,109,181,0.6022099447513812,166,277,443,79,43,44,68,149,583,2012_Jason Thompson
2012,Jerry Stackhouse,SF,37,37,100,0.37,13,38,0.34210526315789475,24,62,0.3870967741935484,21,23,0.9130434782608695,6,17,23,14,10,3,13,12,108,2012_Jerry Stackhouse
2012,Kyrylo Fesenko,C,25,2,5,0.4,0,0,NaN,2,5,0.4,4,6,0.6666666666666666,2,7,9,1,2,0,0,2,8,2012_Kyrylo Fesenko
2012,Marc Gasol,C,27,357,740,0.48243243243243245,1,12,0.08333333333333333,356,728,0.489010989010989,237,317,0.7476340694006309,120,459,579,204,62,121,121,201,952,2012_Marc Gasol
2012,Nick Collison,PF,31,120,201,0.5970149253731343,0,1,0.0,120,200,0.6,44,62,0.7096774193548387,119,155,274,82,33,28,61,153,284,2012_Nick Collison
2012,Rodrigue Beaubois,PG,23,188,445,0.42247191011235957,38,132,0.2878787878787879,150,313,0.4792332268370607,58,69,0.8405797101449275,19,132,151,152,56,28,70,98,472,2012_Rodrigue Beaubois
2012,Ryan Hollins,C,27,92,168,0.5476190476190477,0,0,NaN,92,168,0.5476190476190477,78,150,0.52,68,96,164,18,10,34,70,156,262,2012_Ryan Hollins
2012,Tyrus Thomas,PF,25,120,327,0.3669724770642202,1,3,0.3333333333333333,119,324,0.36728395061728397,63,83,0.7590361445783133,49,151,200,35,36,60,53,144,304,2012_Tyrus Thomas
2013,Anthony Tolliver,SF,27,82,216,0.37962962962962965,45,133,0.3383458646616541,37,83,0.4457831325301205,44,51,0.8627450980392157,31,124,155,32,15,12,36,66,253,2013_Anthony Tolliver
2013,Bernard James,C,27,53,103,0.5145631067961165,0,2,0.0,53,101,0.5247524752475248,25,41,0.6097560975609756,52,79,131,6,12,38,18,64,131,2013_Bernard James
2013,Blake Griffin,PF,23,577,1072,0.5382462686567164,5,28,0.17857142857142858,572,1044,0.5478927203065134,281,426,0.6596244131455399,186,476,662,299,97,50,185,231,1440,2013_Blake Griffin
2013,C.J. Watson,PG,28,192,459,0.41830065359477125,88,214,0.411214953271028,104,245,0.42448979591836733,71,91,0.7802197802197802,38,107,145,161,66,12,69,123,543,2013_C.J. Watson
2013,Carl Landry,PF,29,325,602,0.5398671096345515,1,3,0.3333333333333333,324,599,0.5409015025041736,223,273,0.8168498168498168,180,303,483,65,35,31,115,190,874,2013_Carl Landry
2013,Devin Ebanks,SF,23,24,73,0.3287671232876712,6,22,0.2727272727272727,18,51,0.35294117647058826,11,14,0.7857142857142857,10,31,41,10,3,1,11,23,65,2013_Devin Ebanks
2013,Elton Brand,C,33,226,478,0.47280334728033474,0,1,0.0,226,477,0.47379454926624737,66,93,0.7096774193548387,130,300,430,70,50,90,57,192,518,2013_Elton Brand
2013,Hedo Turkoglu,SF,33,14,53,0.2641509433962264,1,24,0.041666666666666664,13,29,0.4482758620689655,3,6,0.5,4,22,26,23,7,1,12,11,32,2013_Hedo Turkoglu
2013,Iman Shumpert,SG,22,109,275,0.39636363636363636,51,127,0.4015748031496063,58,148,0.3918918918918919,36,47,0.7659574468085106,31,105,136,75,43,7,37,99,305,2013_Iman Shumpert
2013,Jan Vesely,PF,22,57,114,0.5,0,1,0.0,57,113,0.504424778761062,12,39,0.3076923076923077,43,79,122,28,15,17,27,107,126,2013_Jan Vesely
2013,Jerryd Bayless,PG,24,260,621,0.41867954911433175,71,201,0.35323383084577115,189,420,0.45,102,122,0.8360655737704918,22,154,176,264,59,17,120,168,693,2013_Jerryd Bayless
2013,Kyrie Irving,PG,20,484,1070,0.4523364485981308,109,279,0.3906810035842294,375,791,0.4740834386852086,248,290,0.8551724137931035,34,182,216,350,89,21,191,146,1325,2013_Kyrie Irving
2013,Nick Collison,C,32,176,296,0.5945945945945946,0,4,0.0,176,292,0.6027397260273972,60,78,0.7692307692307693,123,210,333,121,51,30,69,197,412,2013_Nick Collison
2013,Rodrigue Beaubois,PG,24,65,176,0.3693181818181818,21,72,0.2916666666666667,44,104,0.4230769230769231,30,38,0.7894736842105263,9,48,57,84,19,4,33,54,181,2013_Rodrigue Beaubois
2014,Amir Johnson,PF,26,344,612,0.5620915032679739,20,66,0.30303030303030304,324,546,0.5934065934065934,91,143,0.6363636363636364,172,333,505,115,56,88,123,271,799,2014_Amir Johnson
2014,Andrew Bynum,C,26,188,450,0.4177777777777778,0,0,NaN,188,450,0.4177777777777778,74,98,0.7551020408163265,106,184,290,58,12,58,68,62,450,2014_Andrew Bynum
2014,Bernard James,C,28,11,23,0.4782608695652174,0,1,0.0,11,22,0.5,6,11,0.5454545454545454,15,27,42,3,3,8,10,24,28,2014_Bernard James
2014,Blake Griffin,PF,24,718,1359,0.5283296541574687,12,44,0.2727272727272727,706,1315,0.5368821292775665,482,674,0.7151335311572701,192,565,757,309,92,51,224,265,1930,2014_Blake Griffin
2014,Brandon Davies,PF,22,54,128,0.421875,2,10,0.2,52,118,0.4406779661016949,34,53,0.6415094339622641,38,71,109,28,24,8,35,92,144,2014_Brandon Davies
2014,C.J. Watson,PG,29,146,334,0.437125748502994,53,145,0.36551724137931035,93,189,0.49206349206349204,69,88,0.7840909090909091,19,82,101,107,60,8,60,66,414,2014_C.J. Watson
2014,Damion James,SF,26,2,9,0.2222222222222222,0,2,0.0,2,7,0.2857142857142857,2,2,1.0,1,11,12,3,0,1,1,3,6,2014_Damion James
2014,DeAndre Jordan,C,25,348,515,0.6757281553398058,0,0,NaN,348,515,0.6757281553398058,160,374,0.42780748663101603,331,783,1114,74,80,203,123,264,856,2014_DeAndre Jordan
2014,Elton Brand,C,34,179,332,0.5391566265060241,0,2,0.0,179,330,0.5424242424242425,61,94,0.648936170212766,97,264,361,74,40,88,60,192,419,2014_Elton Brand
2014,Hedo Turkoglu,SF,34,42,109,0.3853211009174312,22,50,0.44,20,59,0.3389830508474576,9,18,0.5,11,78,89,33,19,10,16,50,115,2014_Hedo Turkoglu
2014,Iman Shumpert,SG,23,183,484,0.378099173553719,76,228,0.3333333333333333,107,256,0.41796875,53,71,0.7464788732394366,81,227,308,129,92,13,79,209,495,2014_Iman Shumpert
2014,Kentavious Caldwell-Pope,SG,20,182,460,0.39565217391304347,59,185,0.31891891891891894,123,275,0.44727272727272727,47,61,0.7704918032786885,38,118,156,55,75,12,28,145,470,2014_Kentavious Caldwell-Pope
2014,Nick Collison,PF,33,134,241,0.5560165975103735,4,17,0.23529411764705882,130,224,0.5803571428571429,66,93,0.7096774193548387,116,177,293,104,30,28,71,187,338,2014_Nick Collison
2015,Bernard James,C,29,12,27,0.4444444444444444,0,0,NaN,12,27,0.4444444444444444,20,23,0.8695652173913043,18,21,39,4,2,15,6,17,44,2015_Bernard James
2015,Blake Griffin,PF,25,574,1144,0.5017482517482518,10,25,0.4,564,1119,0.5040214477211796,311,427,0.7283372365339579,126,382,508,354,63,35,152,196,1469,2015_Blake Griffin
2015,Doug McDermott,SF,23,43,107,0.40186915887850466,13,41,0.3170731707317073,30,66,0.45454545454545453,10,15,0.6666666666666666,6,37,43,6,4,1,17,29,109,2015_Doug McDermott
2015,Elton Brand,C,35,42,95,0.4421052631578947,0,1,0.0,42,94,0.44680851063829785,12,23,0.5217391304347826,28,72,100,22,17,25,18,54,96,2015_Elton Brand
2015,Hedo Turkoglu,SF,35,83,188,0.44148936170212766,60,139,0.4316546762589928,23,49,0.46938775510204084,6,11,0.5454545454545454,5,94,99,37,19,7,29,66,232,2015_Hedo Turkoglu
2015,Henry Walker,SF,27,58,168,0.34523809523809523,45,132,0.3409090909090909,13,36,0.3611111111111111,14,18,0.7777777777777778,7,75,82,29,24,9,24,76,175,2015_Henry Walker
2015,Iman Shumpert,SG,24,386,942,0.40976645435244163,134,392,0.34183673469387754,252,550,0.4581818181818182,86,128,0.671875,110,338,448,270,162,32,182,276,992,2015_Iman Shumpert
2015,James Ennis,SF,24,101,247,0.4089068825910931,31,95,0.3263157894736842,70,152,0.4605263157894737,79,94,0.8404255319148937,51,125,176,48,25,17,39,89,312,2015_James Ennis
2015,Nick Collison,PF,34,106,253,0.4189723320158103,16,60,0.26666666666666666,90,193,0.46632124352331605,45,65,0.6923076923076923,90,160,250,90,35,25,45,156,273,2015_Nick Collison
2015,Samuel Dalembert,C,33,57,130,0.43846153846153846,0,0,NaN,57,130,0.43846153846153846,14,20,0.7,53,115,168,29,14,41,39,70,128,2015_Samuel Dalembert
2015,Shabazz Muhammad,SG,22,194,397,0.48866498740554154,20,51,0.39215686274509803,174,346,0.5028901734104047,104,145,0.7172413793103448,63,91,154,44,18,7,35,49,512,2015_Shabazz Muhammad
2016,Blake Griffin,PF,26,301,603,0.49917081260364843,6,18,0.3333333333333333,295,585,0.5042735042735043,141,194,0.7268041237113402,51,243,294,170,28,17,83,95,749,2016_Blake Griffin
2016,Chris McCullough,PF,20,44,109,0.4036697247706422,13,34,0.38235294117647056,31,75,0.41333333333333333,11,23,0.4782608695652174,25,43,68,9,28,12,15,39,112,2016_Chris McCullough
2016,Cory Jefferson,PF,25,9,22,0.4090909090909091,0,1,0.0,9,21,0.42857142857142855,4,6,0.6666666666666666,6,10,16,0,0,1,0,8,22,2016_Cory Jefferson
2016,Delon Wright,PG,23,36,80,0.45,5,13,0.38461538461538464,31,67,0.4626865671641791,26,35,0.7428571428571429,8,29,37,31,8,3,16,7,103,2016_Delon Wright
2016,Derrick Rose,PG,27,447,1048,0.4265267175572519,44,150,0.29333333333333333,403,898,0.4487750556792873,142,179,0.7932960893854749,46,179,225,311,44,14,175,84,1080,2016_Derrick Rose
2016,Elton Brand,C,36,31,72,0.4305555555555556,0,1,0.0,31,71,0.43661971830985913,8,9,0.8888888888888888,9,54,63,18,9,8,11,32,70,2016_Elton Brand
2016,Iman Shumpert,SG,25,114,305,0.3737704918032787,43,146,0.2945205479452055,71,159,0.44654088050314467,40,51,0.7843137254901961,32,171,203,92,54,19,57,119,311,2016_Iman Shumpert
2016,James Ennis,SF,25,108,226,0.4778761061946903,52,116,0.4482758620689655,56,110,0.509090909090909,50,68,0.7352941176470589,42,42,84,42,32,10,38,56,318,2016_James Ennis
2016,Jerian Grant,PG,23,154,391,0.3938618925831202,22,100,0.22,132,291,0.4536082474226804,96,123,0.7804878048780488,23,120,143,177,50,10,87,97,426,2016_Jerian Grant
2016,Jimmy Butler,SG,26,470,1035,0.45410628019323673,64,205,0.3121951219512195,406,830,0.4891566265060241,395,475,0.8315789473684211,79,279,358,321,110,43,132,124,1399,2016_Jimmy Butler
2016,Kelly Oubre,SF,20,90,211,0.4265402843601896,25,79,0.31645569620253167,65,132,0.49242424242424243,31,49,0.6326530612244898,25,108,133,13,22,7,34,100,236,2016_Kelly Oubre
2016,Marcelo Huertas,PG,32,97,230,0.4217391304347826,16,61,0.26229508196721313,81,169,0.47928994082840237,27,29,0.9310344827586207,18,72,90,182,26,7,80,76,237,2016_Marcelo Huertas
2016,Nick Collison,PF,35,50,109,0.45871559633027525,0,2,0.0,50,107,0.4672897196261682,23,33,0.696969696969697,68,103,171,52,15,16,50,107,123,2016_Nick Collison
2016,Robert Covington,SF,25,274,712,0.3848314606741573,170,482,0.35269709543568467,104,230,0.45217391304347826,140,177,0.7909604519774012,65,354,419,97,105,40,143,232,858,2016_Robert Covington
2016,Sergey Karasev,SF,22,30,74,0.40540540540540543,11,37,0.2972972972972973,19,37,0.5135135135135135,26,28,0.9285714285714286,8,50,58,35,6,2,22,27,97,2016_Sergey Karasev
2016,Shelvin Mack,PG,25,364,830,0.43855421686746987,78,250,0.312,286,580,0.49310344827586206,90,122,0.7377049180327869,26,230,256,374,68,6,190,144,896,2016_Shelvin Mack
2016,Troy Daniels,SG,24,89,187,0.47593582887700536,59,122,0.48360655737704916,30,65,0.46153846153846156,5,9,0.5555555555555556,7,50,57,21,11,3,24,40,242,2016_Troy Daniels
2016,Tyson Chandler,C,33,183,314,0.5828025477707006,0,1,0.0,183,313,0.5846645367412141,106,171,0.6198830409356725,175,401,576,64,36,44,93,145,472,2016_Tyson Chandler
2017,Blake Griffin,PF,27,479,971,0.4933058702368692,38,113,0.336283185840708,441,858,0.513986013986014,320,421,0.7600950118764845,111,385,496,300,58,23,142,157,1316,2017_Blake Griffin
2017,Brandon Bass,PF,31,107,186,0.5752688172043011,1,3,0.3333333333333333,106,183,0.5792349726775956,77,88,0.875,43,86,129,21,14,11,29,45,292,2017_Brandon Bass
2017,Dante Cunningham,SF,29,174,359,0.48467966573816157,71,181,0.39226519337016574,103,178,0.5786516853932584,16,27,0.5925925925925926,56,221,277,36,39,28,28,100,435,2017_Dante Cunningham
2017,Donatas Motiejunas,PF,26,57,138,0.41304347826086957,11,47,0.23404255319148937,46,91,0.5054945054945055,25,49,0.5102040816326531,26,75,101,34,18,11,31,55,150,2017_Donatas Motiejunas
2017,Iman Shumpert,SG,26,201,489,0.4110429447852761,94,261,0.36015325670498083,107,228,0.4692982456140351,71,90,0.7888888888888889,39,180,219,109,62,27,78,150,567,2017_Iman Shumpert
2017,James Ennis,SF,26,146,321,0.45482866043613707,51,137,0.3722627737226277,95,184,0.5163043478260869,86,110,0.7818181818181819,69,190,259,64,46,19,59,165,429,2017_James Ennis
2017,Kelly Oubre,SF,21,186,442,0.42081447963800905,54,188,0.2872340425531915,132,254,0.5196850393700787,75,99,0.7575757575757576,61,199,260,47,58,17,49,195,501,2017_Kelly Oubre
2017,Marcelo Huertas,PG,33,25,68,0.36764705882352944,4,19,0.21052631578947367,21,49,0.42857142857142855,9,17,0.5294117647058824,2,22,24,52,10,2,19,16,63,2017_Marcelo Huertas
2017,Nick Collison,PF,36,14,23,0.6086956521739131,0,1,0.0,14,22,0.6363636363636364,5,8,0.625,9,21,30,12,2,2,4,17,33,2017_Nick Collison
2017,Wesley Johnson,SF,29,73,200,0.365,29,118,0.2457627118644068,44,82,0.5365853658536586,11,17,0.6470588235294118,26,155,181,23,29,30,18,83,186,2017_Wesley Johnson
2003,Andrew DeClercq,C,29,149,279,0.5340501792114696,0,0,NaN,149,279,0.5340501792114696,67,104,0.6442307692307693,142,197,339,52,39,36,84,258,365,2003_Andrew DeClercq
2003,Bonzi Wells,SG,26,437,990,0.4414141414141414,38,130,0.2923076923076923,399,860,0.46395348837209305,226,313,0.7220447284345048,98,296,394,246,123,18,215,220,1138,2003_Bonzi Wells
2003,Brian Cardinal,PF,25,1,4,0.25,0,1,0.0,1,3,0.3333333333333333,2,2,1.0,3,2,5,1,0,0,1,0,4,2003_Brian Cardinal
2003,Donnell Harvey,SF,22,246,551,0.44646098003629764,1,7,0.14285714285714285,245,544,0.45036764705882354,118,176,0.6704545454545454,125,284,409,100,48,27,123,203,611,2003_Donnell Harvey
2003,Earl Watson,PG,23,170,391,0.43478260869565216,31,91,0.34065934065934067,139,300,0.4633333333333333,62,86,0.7209302325581395,46,118,164,225,89,14,88,138,433,2003_Earl Watson
2003,Howard Eisley,PG,30,262,628,0.4171974522292994,131,337,0.3887240356083086,131,291,0.45017182130584193,89,105,0.8476190476190476,24,162,186,444,71,9,149,222,744,2003_Howard Eisley
2003,Melvin Ely,C,24,92,186,0.4946236559139785,0,0,NaN,92,186,0.4946236559139785,52,74,0.7027027027027027,64,110,174,15,10,32,50,95,236,2003_Melvin Ely
2003,Michael Jordan,SF,39,679,1527,0.4446627373935822,16,55,0.2909090909090909,663,1472,0.45040760869565216,266,324,0.8209876543209876,71,426,497,311,123,39,173,171,1640,2003_Michael Jordan
2003,Mike Wilks,PG-SG_SG_PG,23,100,296,0.33783783783783783,20,70,0.2857142857142857,80,226,0.35398230088495575,74,94,0.7872340425531915,40,102,142,184,54,8,56,138,294,2003_Mike Wilks
2003,Nikoloz Tskitishvili,SF,19,115,393,0.2926208651399491,37,152,0.24342105263157895,78,241,0.3236514522821577,48,65,0.7384615384615385,64,117,181,91,31,29,84,136,315,2003_Nikoloz Tskitishvili
2003,Olumide Oyedeji,C,21,10,23,0.43478260869565216,0,0,NaN,10,23,0.43478260869565216,7,11,0.6363636363636364,10,40,50,5,5,3,5,30,27,2003_Olumide Oyedeji
2003,Primoz Brezec,C,23,15,38,0.39473684210526316,0,1,0.0,15,37,0.40540540540540543,12,20,0.6,13,10,23,4,2,4,7,16,42,2003_Primoz Brezec
2003,Rasho Nesterovic,C,26,400,762,0.5249343832020997,0,2,0.0,400,760,0.5263157894736842,61,95,0.6421052631578947,146,358,504,114,39,116,99,256,861,2003_Rasho Nesterovic
2003,Tim Duncan,PF,26,714,1392,0.5129310344827587,6,22,0.2727272727272727,708,1370,0.5167883211678832,450,634,0.7097791798107256,259,784,1043,316,55,237,248,231,1884,2003_Tim Duncan
2003,Tony Battie,C,26,199,369,0.5392953929539296,1,5,0.2,198,364,0.5439560439560439,88,118,0.7457627118644068,148,285,433,49,33,81,48,197,487,2003_Tony Battie
2004,Bonzi Wells,SG,27,726,1700,0.42705882352941177,44,138,0.3188405797101449,682,1562,0.43661971830985913,276,366,0.7540983606557377,156,364,520,278,182,38,322,394,1772,2004_Bonzi Wells
2004,Bruno Sundov,C,23,8,20,0.4,0,0,NaN,8,20,0.4,6,12,0.5,4,16,20,2,0,0,6,18,22,2004_Bruno Sundov
2004,Corey Maggette,SF,24,453,1013,0.4471865745310958,76,231,0.329004329004329,377,782,0.4820971867007673,526,620,0.8483870967741935,96,334,430,224,65,16,207,217,1508,2004_Corey Maggette
2004,Dale Davis,C,34,133,281,0.47330960854092524,0,0,NaN,133,281,0.47330960854092524,65,106,0.6132075471698113,158,240,398,72,43,62,40,154,331,2004_Dale Davis
2004,Dana Barros,SG,36,2,3,0.6666666666666666,0,0,NaN,2,3,0.6666666666666666,2,2,1.0,0,0,0,0,0,0,0,2,6,2004_Dana Barros
2004,Daniel Santiago,C,27,78,163,0.4785276073619632,0,0,NaN,78,163,0.4785276073619632,61,90,0.6777777777777778,35,97,132,24,19,21,32,98,217,2004_Daniel Santiago
2004,Earl Watson,PG,24,172,464,0.3706896551724138,26,106,0.24528301886792453,146,358,0.40782122905027934,90,138,0.6521739130434783,49,129,178,402,91,19,146,175,460,2004_Earl Watson
2004,Howard Eisley,PG,31,332,902,0.36807095343680707,104,326,0.31901840490797545,228,576,0.3958333333333333,152,178,0.8539325842696629,40,218,258,546,112,10,196,274,920,2004_Howard Eisley
2004,Mitchell Butler,SG,33,54,124,0.43548387096774194,11,30,0.36666666666666664,43,94,0.4574468085106383,15,24,0.625,24,47,71,32,22,4,24,54,134,2004_Mitchell Butler
2004,Primoz Brezec,C,24,12,26,0.46153846153846156,0,0,NaN,12,26,0.46153846153846156,4,6,0.6666666666666666,5,10,15,3,0,3,6,13,28,2004_Primoz Brezec
2004,Reece Gaines,PG,23,25,86,0.29069767441860467,3,10,0.3,22,76,0.2894736842105263,16,25,0.64,8,31,39,40,11,2,18,22,69,2004_Reece Gaines
2004,Sean Rooks,C,34,108,302,0.3576158940397351,0,2,0.0,108,300,0.36,66,74,0.8918918918918919,48,146,194,58,28,20,44,178,282,2004_Sean Rooks
2004,Tony Battie,C,27,340,768,0.4427083333333333,4,18,0.2222222222222222,336,750,0.448,132,178,0.7415730337078652,236,482,718,116,52,134,126,318,816,2004_Tony Battie
2004,Vitaly Potapenko,C,28,200,409,0.4889975550122249,0,0,NaN,200,409,0.4889975550122249,59,92,0.6413043478260869,101,188,289,53,22,28,77,161,459,2004_Vitaly Potapenko
2005,Andre Miller,PG,28,427,895,0.4770949720670391,6,39,0.15384615384615385,421,856,0.49182242990654207,253,302,0.8377483443708609,100,238,338,569,121,8,220,204,1113,2005_Andre Miller
2005,Bonzi Wells,SG,28,272,617,0.44084278768233387,36,104,0.34615384615384615,236,513,0.4600389863547758,141,188,0.75,49,180,229,80,85,27,90,165,721,2005_Bonzi Wells
2005,Daniel Santiago,C,28,7,21,0.3333333333333333,0,0,NaN,7,21,0.3333333333333333,8,11,0.7272727272727273,6,13,19,1,3,4,4,28,22,2005_Daniel Santiago
2005,David West,SF,24,75,172,0.436046511627907,2,5,0.4,73,167,0.437125748502994,34,50,0.68,40,89,129,23,12,16,37,62,186,2005_David West
2005,Earl Watson,PG,25,236,554,0.4259927797833935,52,163,0.31901840490797545,184,391,0.47058823529411764,91,138,0.6594202898550725,35,129,164,359,83,19,167,184,615,2005_Earl Watson
2005,Howard Eisley,PG,32,161,405,0.39753086419753086,27,103,0.2621359223300971,134,302,0.44370860927152317,66,83,0.7951807228915663,15,75,90,250,45,9,111,156,415,2005_Howard Eisley
2005,Marcus Banks,PG,23,115,286,0.4020979020979021,21,59,0.3559322033898305,94,227,0.41409691629955947,121,163,0.7423312883435583,29,97,126,155,63,13,79,146,372,2005_Marcus Banks
2005,Primoz Brezec,C,25,387,756,0.5119047619047619,0,0,NaN,387,756,0.5119047619047619,164,220,0.7454545454545455,226,305,531,86,33,55,106,183,938,2005_Primoz Brezec
2005,Royal Ivey,PG,23,85,198,0.4292929292929293,3,9,0.3333333333333333,82,189,0.43386243386243384,47,67,0.7014925373134329,19,65,84,103,39,7,58,140,220,2005_Royal Ivey
2005,Tony Battie,C,28,163,354,0.4604519774011299,0,6,0.0,163,348,0.46839080459770116,68,94,0.723404255319149,109,343,452,42,30,81,81,244,394,2005_Tony Battie
2005,Tyronn Lue,PG,27,590,1308,0.4510703363914373,110,310,0.3548387096774194,480,998,0.48096192384769537,284,330,0.8606060606060606,28,270,298,644,66,0,210,336,1574,2005_Tyronn Lue
2006,Bonzi Wells,SG,29,284,613,0.4632952691680261,10,45,0.2222222222222222,274,568,0.4823943661971831,129,190,0.6789473684210526,142,259,401,144,94,25,126,156,707,2006_Bonzi Wells
2006,Chris Wilcox,C_PF_C-PF,23,514,900,0.5711111111111111,0,4,0.0,514,896,0.5736607142857143,224,306,0.7320261437908496,236,584,820,104,66,68,144,366,1252,2006_Chris Wilcox
2006,Earl Watson,PG,26,438,1018,0.4302554027504912,220,544,0.40441176470588236,218,474,0.459915611814346,150,222,0.6756756756756757,48,268,316,578,136,20,272,318,1246,2006_Earl Watson
2006,Eddy Curry,C,23,336,597,0.5628140703517588,0,0,NaN,336,597,0.5628140703517588,307,486,0.6316872427983539,145,287,432,19,28,56,179,239,979,2006_Eddy Curry
2006,Gerald Fitch,PG,23,30,89,0.33707865168539325,7,26,0.2692307692307692,23,63,0.36507936507936506,17,23,0.7391304347826086,7,23,30,33,7,5,15,28,84,2006_Gerald Fitch
2006,Howard Eisley,PG,33,68,206,0.3300970873786408,26,84,0.30952380952380953,42,122,0.3442622950819672,40,48,0.8333333333333334,6,60,66,138,22,4,42,68,202,2006_Howard Eisley
2006,Jeff McInnis,SG,31,63,143,0.4405594405594406,3,16,0.1875,60,127,0.47244094488188976,20,29,0.6896551724137931,11,39,50,52,11,2,29,37,149,2006_Jeff McInnis
2006,Johan Petro,C,20,153,300,0.51,0,0,NaN,153,300,0.51,47,75,0.6266666666666667,109,187,296,15,25,51,60,213,353,2006_Johan Petro
2006,Josh Davis,PF,25,4,14,0.2857142857142857,0,4,0.0,4,10,0.4,4,6,0.6666666666666666,6,2,8,2,4,0,2,6,12,2006_Josh Davis
2006,Kevin Martin,SG,22,262,546,0.47985347985347987,66,179,0.3687150837988827,196,367,0.5340599455040872,188,222,0.8468468468468469,58,203,261,97,55,9,81,138,778,2006_Kevin Martin
2006,Marc Jackson,C,31,348,738,0.4715447154471545,2,4,0.5,346,734,0.4713896457765668,132,164,0.8048780487804879,172,262,434,88,26,16,130,252,830,2006_Marc Jackson
2006,Michael Ruffin,C,29,34,77,0.44155844155844154,0,2,0.0,34,75,0.4533333333333333,37,74,0.5,122,149,271,27,33,31,38,179,105,2006_Michael Ruffin
2006,Primoz Brezec,C,26,409,791,0.5170670037926675,0,2,0.0,409,789,0.5183776932826363,164,224,0.7321428571428571,181,259,440,45,19,32,85,227,982,2006_Primoz Brezec
2006,Tony Battie,C,29,280,552,0.5072463768115942,0,6,0.0,280,546,0.5128205128205128,89,134,0.664179104477612,145,312,457,49,46,69,88,250,649,2006_Tony Battie
2007,Earl Watson,PG,27,263,687,0.38282387190684136,92,280,0.32857142857142857,171,407,0.4201474201474201,108,147,0.7346938775510204,34,151,185,437,99,23,167,152,726,2007_Earl Watson
2007,Hilton Armstrong,C,22,68,125,0.544,0,0,NaN,68,125,0.544,40,67,0.5970149253731343,58,91,149,10,12,26,35,79,176,2007_Hilton Armstrong
2007,Jamal Crawford,SG,26,354,886,0.39954853273137697,103,322,0.3198757763975155,251,564,0.4450354609929078,228,272,0.8382352941176471,44,145,189,259,57,8,162,114,1039,2007_Jamal Crawford
2007,Jerry Stackhouse,SF,32,280,654,0.42813455657492355,62,162,0.38271604938271603,218,492,0.44308943089430897,182,215,0.8465116279069768,39,106,145,187,51,10,117,78,804,2007_Jerry Stackhouse
2007,Johan Petro,C,21,226,438,0.5159817351598174,0,0,NaN,226,438,0.5159817351598174,50,77,0.6493506493506493,92,243,335,45,39,47,82,237,502,2007_Johan Petro
2007,Kevin Willis,PF,44,5,13,0.38461538461538464,0,0,NaN,5,13,0.38461538461538464,2,2,1.0,2,6,8,1,2,1,2,11,12,2007_Kevin Willis
2007,Primoz Brezec,C,27,122,274,0.44525547445255476,1,3,0.3333333333333333,121,271,0.44649446494464945,43,68,0.6323529411764706,80,104,184,23,11,23,38,161,288,2007_Primoz Brezec
2007,Renaldo Balkman,SF,22,139,275,0.5054545454545455,5,27,0.18518518518518517,134,248,0.5403225806451613,51,90,0.5666666666666667,97,197,294,44,57,44,49,146,334,2007_Renaldo Balkman
2007,Ryan Hollins,C,22,20,36,0.5555555555555556,0,0,NaN,20,36,0.5555555555555556,24,40,0.6,11,20,31,1,4,7,16,40,64,2007_Ryan Hollins
2007,Tyrus Thomas,PF,20,134,282,0.475177304964539,0,2,0.0,134,280,0.4785714285714286,106,175,0.6057142857142858,89,180,269,40,46,76,94,162,374,2007_Tyrus Thomas
2007,Walter Herrmann,PF,27,174,330,0.5272727272727272,53,115,0.4608695652173913,121,215,0.5627906976744186,41,53,0.7735849056603774,28,111,139,26,17,7,32,76,442,2007_Walter Herrmann
2008,Aaron Williams,C,36,27,55,0.4909090909090909,0,0,NaN,27,55,0.4909090909090909,14,18,0.7777777777777778,15,46,61,9,12,15,13,44,68,2008_Aaron Williams
2008,Darryl Watkins,C,23,5,15,0.3333333333333333,0,0,NaN,5,15,0.3333333333333333,2,5,0.4,5,7,12,0,2,2,7,8,12,2008_Darryl Watkins
2008,Earl Watson,PG,28,339,747,0.4538152610441767,49,132,0.3712121212121212,290,615,0.4715447154471545,111,145,0.7655172413793103,43,182,225,531,69,11,175,158,838,2008_Earl Watson
2008,Fred Jones,SG,28,182,432,0.4212962962962963,74,192,0.3854166666666667,108,240,0.45,94,126,0.746031746031746,30,140,170,166,48,18,78,140,532,2008_Fred Jones
2008,Ian Mahinmi,C,21,6,12,0.5,0,0,NaN,6,12,0.5,9,9,1.0,0,5,5,1,0,4,2,4,21,2008_Ian Mahinmi
2008,Jake Voskuhl,C,30,37,80,0.4625,0,0,NaN,37,80,0.4625,24,29,0.8275862068965517,30,67,97,13,9,21,29,83,98,2008_Jake Voskuhl
2008,Jermareo Davidson,SF,23,51,125,0.408,0,0,NaN,51,125,0.408,18,28,0.6428571428571429,21,41,62,13,7,15,17,46,120,2008_Jermareo Davidson
2008,Johan Petro,C,22,184,439,0.4191343963553531,0,1,0.0,184,438,0.4200913242009132,64,87,0.735632183908046,98,272,370,32,35,42,73,173,432,2008_Johan Petro
2008,Primoz Brezec,C,28,88,188,0.46808510638297873,0,0,NaN,88,188,0.46808510638297873,48,80,0.6,60,102,162,22,6,14,48,166,224,2008_Primoz Brezec
2008,Renaldo Balkman,SF,23,91,186,0.489247311827957,1,12,0.08333333333333333,90,174,0.5172413793103449,41,95,0.43157894736842106,83,133,216,40,44,30,37,132,224,2008_Renaldo Balkman
2008,Taurean Green,SG-PG_SG_PG,21,14,50,0.28,4,22,0.18181818181818182,10,28,0.35714285714285715,22,24,0.9166666666666666,0,20,20,22,4,0,18,10,54,2008_Taurean Green
2008,Walter Herrmann,PF,28,112,288,0.3888888888888889,40,128,0.3125,72,160,0.45,42,50,0.84,44,102,146,36,14,2,24,48,306,2008_Walter Herrmann
2008,Yakhouba Diawara,SG,25,55,134,0.41044776119402987,21,66,0.3181818181818182,34,68,0.5,22,31,0.7096774193548387,23,39,62,37,8,3,16,61,153,2008_Yakhouba Diawara
2009,Amir Johnson,PF,21,97,163,0.5950920245398773,0,0,NaN,97,163,0.5950920245398773,23,35,0.6571428571428571,102,130,232,20,20,60,33,171,217,2009_Amir Johnson
2009,Andre Iguodala,SF,25,542,1147,0.47253705318221445,80,261,0.3065134099616858,462,886,0.5214446952595937,377,521,0.7236084452975048,92,379,471,434,131,36,222,152,1541,2009_Andre Iguodala
2009,Andrew Bynum,C,21,281,502,0.5597609561752988,0,0,NaN,281,502,0.5597609561752988,152,215,0.7069767441860465,137,261,398,71,18,90,85,157,714,2009_Andrew Bynum
2009,DeAndre Jordan,C,20,93,147,0.6326530612244898,0,0,NaN,93,147,0.6326530612244898,42,109,0.3853211009174312,72,165,237,11,11,59,41,96,228,2009_DeAndre Jordan
2009,Donyell Marshall,PF,35,33,73,0.4520547945205479,25,55,0.45454545454545453,8,18,0.4444444444444444,3,6,0.5,6,34,40,15,4,5,6,24,94,2009_Donyell Marshall
2009,Earl Watson,PG,29,174,453,0.3841059602649007,20,85,0.23529411764705882,154,368,0.41847826086956524,80,106,0.7547169811320755,36,147,183,391,50,11,156,137,448,2009_Earl Watson
2009,Etan Thomas,C,30,32,66,0.48484848484848486,0,0,NaN,32,66,0.48484848484848486,16,23,0.6956521739130435,25,41,66,6,3,18,18,35,80,2009_Etan Thomas
2009,Jermareo Davidson,SF,24,17,35,0.4857142857142857,0,0,NaN,17,35,0.4857142857142857,8,17,0.47058823529411764,10,24,34,1,2,3,5,12,42,2009_Jermareo Davidson
2009,Johan Petro,C,23,146,352,0.4147727272727273,0,4,0.0,146,348,0.41954022988505746,32,58,0.5517241379310345,84,232,316,32,38,30,56,214,324,2009_Johan Petro
2009,Lou Amundson,PF,26,134,250,0.536,0,1,0.0,134,249,0.5381526104417671,53,120,0.44166666666666665,128,142,270,28,32,65,56,154,321,2009_Lou Amundson
2009,Renaldo Balkman,PF,24,110,197,0.5583756345177665,2,7,0.2857142857142857,108,190,0.5684210526315789,42,65,0.6461538461538462,86,117,203,34,47,23,35,98,264,2009_Renaldo Balkman
2009,Ronny Turiaf,C,26,186,366,0.5081967213114754,0,3,0.0,186,363,0.512396694214876,98,124,0.7903225806451613,88,272,360,166,34,168,70,243,470,2009_Ronny Turiaf
2009,Walter Herrmann,SF,29,82,207,0.3961352657004831,41,120,0.3416666666666667,41,87,0.47126436781609193,19,25,0.76,28,79,107,22,7,4,17,43,224,2009_Walter Herrmann
2009,Will Bynum,PG,26,156,342,0.45614035087719296,3,19,0.15789473684210525,153,323,0.47368421052631576,95,119,0.7983193277310925,19,56,75,157,34,2,76,85,410,2009_Will Bynum
2010,Anthony Carter,PG,34,76,181,0.4198895027624309,17,63,0.2698412698412698,59,118,0.5,11,13,0.8461538461538461,17,72,89,160,39,13,58,72,180,2010_Anthony Carter
2010,Chauncey Billups,PG,33,402,962,0.4178794178794179,157,407,0.3857493857493858,245,555,0.44144144144144143,466,512,0.91015625,25,203,228,409,82,9,177,153,1427,2010_Chauncey Billups
2010,Earl Watson,PG,30,223,524,0.4255725190839695,53,184,0.28804347826086957,170,340,0.5,120,169,0.7100591715976331,54,186,240,399,104,16,175,181,619,2010_Earl Watson
2010,J.J. Redick,SG,25,243,553,0.4394213381555154,111,274,0.4051094890510949,132,279,0.4731182795698925,191,222,0.8603603603603603,17,138,155,158,28,4,63,118,788,2010_J.J. Redick
2010,John Salmons,SG,30,874,1982,0.4409687184661958,236,618,0.3818770226537217,638,1364,0.46774193548387094,506,610,0.8295081967213115,70,470,540,446,198,52,246,332,2490,2010_John Salmons
2010,Patrick O'Bryant,C,23,8,15,0.5333333333333333,0,1,0.0,8,14,0.5714285714285714,3,6,0.5,2,9,11,1,2,4,5,12,19,2010_Patrick O'Bryant
2010,Primoz Brezec,C,30,18,52,0.34615384615384615,0,0,NaN,18,52,0.34615384615384615,2,12,0.16666666666666666,24,26,50,2,2,6,4,38,38,2010_Primoz Brezec
2010,Rajon Rondo,PG,23,459,904,0.5077433628318584,17,80,0.2125,442,824,0.5364077669902912,175,282,0.6205673758865248,100,260,360,794,189,11,246,198,1110,2010_Rajon Rondo
2010,Sam Young,SF,24,224,497,0.4507042253521127,11,56,0.19642857142857142,213,441,0.48299319727891155,136,175,0.7771428571428571,77,124,201,52,34,20,94,106,595,2010_Sam Young
2010,Samuel Dalembert,C,28,285,523,0.5449330783938815,0,0,NaN,285,523,0.5449330783938815,97,133,0.7293233082706767,239,545,784,64,42,151,123,252,667,2010_Samuel Dalembert
2010,Steve Nash,PG,35,499,985,0.5065989847715736,124,291,0.4261168384879725,375,694,0.5403458213256485,211,225,0.9377777777777778,34,234,268,892,42,12,295,108,1333,2010_Steve Nash
2010,Taj Gibson,PF,24,311,629,0.4944356120826709,0,0,NaN,311,629,0.4944356120826709,113,175,0.6457142857142857,226,385,611,70,50,104,114,282,735,2010_Taj Gibson
2010,Tony Battie,C,33,14,40,0.35,1,4,0.25,13,36,0.3611111111111111,7,10,0.7,4,19,23,3,4,2,3,19,36,2010_Tony Battie
2011,Andray Blatche,PF,24,426,957,0.445141065830721,4,18,0.2222222222222222,422,939,0.4494142705005325,220,283,0.7773851590106007,183,343,526,144,98,51,172,182,1076,2011_Andray Blatche
2011,Danilo Gallinari,SF_PF_PF-SF,22,530,1280,0.4140625,206,586,0.3515358361774744,324,694,0.4668587896253602,674,782,0.8618925831202046,118,492,610,208,102,54,166,288,1940,2011_Danilo Gallinari
2011,Earl Watson,PG,31,126,307,0.41042345276872966,36,107,0.3364485981308411,90,200,0.45,55,82,0.6707317073170732,52,130,182,278,61,17,116,146,343,2011_Earl Watson
2011,J.J. Redick,SG,26,197,447,0.4407158836689038,87,219,0.3972602739726027,110,228,0.4824561403508772,112,128,0.875,6,107,113,102,29,3,53,80,593,2011_J.J. Redick
2011,Jason Kapono,SF,29,7,28,0.25,1,8,0.125,6,20,0.3,1,2,0.5,3,8,11,4,2,1,2,4,16,2011_Jason Kapono
2011,Josh McRoberts,PF,23,211,386,0.5466321243523317,23,60,0.38333333333333336,188,326,0.5766871165644172,88,119,0.7394957983193278,109,273,382,150,47,57,93,165,533,2011_Josh McRoberts
2011,Lance Stephenson,SG,20,13,39,0.3333333333333333,0,5,0.0,13,34,0.38235294117647056,11,14,0.7857142857142857,1,17,18,21,4,0,16,14,37,2011_Lance Stephenson
2011,Rajon Rondo,PG,24,318,670,0.4746268656716418,10,43,0.23255813953488372,308,627,0.49122807017543857,75,132,0.5681818181818182,87,210,297,760,153,11,234,120,721,2011_Rajon Rondo
2011,Sam Young,SF,25,233,494,0.4716599190283401,17,50,0.34,216,444,0.4864864864864865,89,116,0.7672413793103449,40,147,187,71,68,23,61,120,572,2011_Sam Young
2011,Tony Battie,C,34,45,96,0.46875,2,3,0.6666666666666666,43,93,0.46236559139784944,8,14,0.5714285714285714,17,82,99,12,5,15,12,59,100,2011_Tony Battie
2011,Tyson Chandler,C,28,266,407,0.6535626535626535,0,0,NaN,266,407,0.6535626535626535,216,295,0.7322033898305085,206,486,692,32,36,80,88,240,748,2011_Tyson Chandler
2012,Brandon Bass,PF,26,303,632,0.47943037974683544,0,0,NaN,303,632,0.47943037974683544,132,163,0.8098159509202454,95,270,365,55,34,54,65,135,738,2012_Brandon Bass
2012,Earl Watson,PG,32,54,160,0.3375,10,52,0.19230769230769232,44,108,0.4074074074074074,31,46,0.6739130434782609,30,91,121,217,54,22,85,105,149,2012_Earl Watson
2012,Gerald Henderson,SG,24,332,723,0.45919778699861685,11,47,0.23404255319148937,321,676,0.47485207100591714,155,204,0.7598039215686274,64,161,225,126,49,20,100,128,830,2012_Gerald Henderson
2012,J.J. Redick,SG,27,248,584,0.4246575342465753,112,268,0.417910447761194,136,316,0.43037974683544306,143,157,0.910828025477707,18,132,150,164,27,6,68,92,751,2012_J.J. Redick
2012,Justin Harper,PF,22,9,31,0.2903225806451613,2,13,0.15384615384615385,7,18,0.3888888888888889,0,1,0.0,3,9,12,2,2,3,6,5,20,2012_Justin Harper
2012,Morris Almond,SG,26,6,17,0.35294117647058826,1,3,0.3333333333333333,5,14,0.35714285714285715,1,3,0.3333333333333333,1,7,8,2,7,0,1,6,14,2012_Morris Almond
2012,Rajon Rondo,PG,25,256,572,0.44755244755244755,10,42,0.23809523809523808,246,530,0.4641509433962264,108,181,0.5966850828729282,62,195,257,620,95,3,193,99,630,2012_Rajon Rondo
2012,Sam Young,SF,26,90,254,0.3543307086614173,10,34,0.29411764705882354,80,220,0.36363636363636365,38,52,0.7307692307692307,40,84,124,30,34,12,32,46,228,2012_Sam Young
2012,Tony Battie,C,35,19,51,0.37254901960784315,0,1,0.0,19,50,0.38,4,4,1.0,8,59,67,16,4,6,4,26,42,2012_Tony Battie
2013,A.J. Price,PG,26,161,413,0.3898305084745763,70,200,0.35,91,213,0.4272300469483568,49,62,0.7903225806451613,20,94,114,205,33,3,64,73,441,2013_A.J. Price
2013,Brian Roberts,PG,27,213,511,0.41682974559686886,59,153,0.38562091503267976,154,358,0.4301675977653631,70,77,0.9090909090909091,17,80,97,219,37,3,71,108,555,2013_Brian Roberts
2013,DaJuan Summers,PF,25,1,4,0.25,0,0,NaN,1,4,0.25,0,0,NaN,0,2,2,1,0,0,0,0,2,2013_DaJuan Summers
2013,Dion Waiters,SG,21,336,815,0.41226993865030676,63,203,0.3103448275862069,273,612,0.44607843137254904,159,213,0.7464788732394366,22,127,149,183,59,16,121,113,894,2013_Dion Waiters
2013,Donald Sloan,SG-PG_SG_PG,25,54,156,0.34615384615384615,14,38,0.3684210526315789,40,118,0.3389830508474576,40,50,0.8,6,50,56,76,10,0,28,34,162,2013_Donald Sloan
2013,Earl Watson,PG,33,37,120,0.30833333333333335,5,28,0.17857142857142858,32,92,0.34782608695652173,17,25,0.68,23,64,87,190,40,8,69,94,96,2013_Earl Watson
2013,Evan Fournier,SG,20,75,152,0.4934210526315789,22,54,0.4074074074074074,53,98,0.5408163265306123,30,39,0.7692307692307693,6,29,35,44,19,1,32,65,202,2013_Evan Fournier
2013,J.J. Redick,SG,28,764,1760,0.4340909090909091,330,902,0.36585365853658536,434,858,0.5058275058275058,342,380,0.9,34,308,342,592,76,18,276,234,2200,2013_J.J. Redick
2013,Jeremy Lamb,SF,20,24,68,0.35294117647058826,9,30,0.3,15,38,0.39473684210526316,14,14,1.0,5,13,18,5,2,2,6,13,71,2013_Jeremy Lamb
2013,Kevin Murphy,SG,22,7,28,0.25,1,5,0.2,6,23,0.2608695652173913,0,0,NaN,0,4,4,2,1,0,3,4,15,2013_Kevin Murphy
2013,Luke Zeller,C,25,9,26,0.34615384615384615,1,5,0.2,8,21,0.38095238095238093,0,0,NaN,1,9,10,3,0,0,0,5,19,2013_Luke Zeller
2013,Maalik Wayns,PG,21,52,176,0.29545454545454547,14,62,0.22580645161290322,38,114,0.3333333333333333,34,38,0.8947368421052632,2,12,14,54,12,0,30,52,152,2013_Maalik Wayns
2013,Mike James,PG,37,101,271,0.3726937269372694,48,125,0.384,53,146,0.363013698630137,23,29,0.7931034482758621,9,63,72,139,26,3,55,95,273,2013_Mike James
2013,Nick Young,SG,27,224,542,0.4132841328413284,75,210,0.35714285714285715,149,332,0.44879518072289154,105,128,0.8203125,24,106,130,84,36,14,50,84,628,2013_Nick Young
2013,Quincy Acy,PF,22,42,75,0.56,1,2,0.5,41,73,0.5616438356164384,31,38,0.8157894736842105,30,47,77,11,13,15,17,53,116,2013_Quincy Acy
2013,Quincy Pondexter,SF,24,128,299,0.4280936454849498,60,152,0.39473684210526316,68,147,0.46258503401360546,59,75,0.7866666666666666,43,89,132,61,35,6,42,95,375,2013_Quincy Pondexter
2013,Rajon Rondo,PG,26,225,465,0.4838709677419355,12,50,0.24,213,415,0.5132530120481927,60,93,0.6451612903225806,43,169,212,420,70,9,148,96,522,2013_Rajon Rondo
2013,Sam Young,SG,27,58,148,0.3918918918918919,16,52,0.3076923076923077,42,96,0.4375,23,43,0.5348837209302325,26,97,123,42,15,8,33,62,155,2013_Sam Young
2013,Scott Machado,PG,22,3,6,0.5,0,1,0.0,3,5,0.6,2,2,1.0,0,1,1,6,2,0,8,0,8,2013_Scott Machado
2014,Brian Roberts,PG,28,244,581,0.4199655765920826,64,178,0.3595505617977528,180,403,0.4466501240694789,125,133,0.9398496240601504,17,119,136,234,43,7,95,132,677,2014_Brian Roberts
2014,Cole Aldrich,C,25,33,61,0.5409836065573771,0,0,NaN,33,61,0.5409836065573771,26,30,0.8666666666666667,37,92,129,14,8,30,18,40,92,2014_Cole Aldrich
2014,Darrell Arthur,SF,25,162,410,0.3951219512195122,24,64,0.375,138,346,0.3988439306358382,53,62,0.8548387096774194,52,158,210,61,39,47,58,185,401,2014_Darrell Arthur
2014,DeJuan Blair,PF,24,210,393,0.5343511450381679,0,2,0.0,210,391,0.5370843989769821,77,121,0.6363636363636364,139,229,368,70,60,21,77,192,497,2014_DeJuan Blair
2014,Earl Watson,PG,34,3,11,0.2727272727272727,2,7,0.2857142857142857,1,4,0.25,4,4,1.0,5,10,15,28,5,1,17,33,12,2014_Earl Watson
2014,Evan Fournier,SG,21,228,544,0.41911764705882354,89,237,0.3755274261603376,139,307,0.4527687296416938,93,123,0.7560975609756098,34,168,202,112,34,7,100,179,638,2014_Evan Fournier
2014,J.J. Redick,SG,29,181,398,0.4547738693467337,73,185,0.3945945945945946,108,213,0.5070422535211268,97,106,0.9150943396226415,9,65,74,78,28,3,42,65,532,2014_J.J. Redick
2014,Jeremy Lamb,SG,21,263,609,0.4318555008210181,88,247,0.3562753036437247,175,362,0.48342541436464087,51,64,0.796875,27,162,189,115,56,26,61,143,665,2014_Jeremy Lamb
2014,Josh Smith,SF,28,517,1233,0.41930251419302517,70,265,0.2641509433962264,447,968,0.4617768595041322,160,301,0.53156146179402,102,418,520,252,105,110,199,197,1264,2014_Josh Smith
2014,Melvin Ely,C,35,3,6,0.5,0,0,NaN,3,6,0.5,0,0,NaN,0,1,1,0,0,1,0,5,6,2014_Melvin Ely
2014,Nando De,SF,26,128,306,0.41830065359477125,36,106,0.33962264150943394,92,200,0.46,62,70,0.8857142857142857,28,118,146,130,44,12,70,96,354,2014_Nando De
2014,Peyton Siva,SG,23,18,57,0.3157894736842105,7,25,0.28,11,32,0.34375,11,15,0.7333333333333333,2,12,14,34,9,1,18,27,54,2014_Peyton Siva
2014,Rajon Rondo,PG,27,141,350,0.40285714285714286,26,90,0.28888888888888886,115,260,0.4423076923076923,42,67,0.6268656716417911,22,142,164,294,40,2,99,65,350,2014_Rajon Rondo
2014,Tim Duncan,C,37,444,906,0.4900662251655629,0,5,0.0,444,901,0.49278579356270813,231,316,0.7310126582278481,158,563,721,220,43,139,159,134,1119,2014_Tim Duncan
2015,Al Jefferson,C,30,486,1010,0.48118811881188117,2,5,0.4,484,1005,0.481592039800995,108,165,0.6545454545454545,99,449,548,113,47,84,68,139,1082,2015_Al Jefferson
2015,Brian Roberts,PG,29,176,452,0.3893805309734513,62,193,0.32124352331606215,114,259,0.44015444015444016,66,74,0.8918918918918919,13,96,109,162,33,6,57,75,480,2015_Brian Roberts
2015,Chris Copeland,SF,30,112,310,0.36129032258064514,52,167,0.31137724550898205,60,143,0.4195804195804196,33,45,0.7333333333333333,23,88,111,51,11,11,59,78,309,2015_Chris Copeland
2015,Evan Fournier,SG,22,253,575,0.44,85,225,0.37777777777777777,168,350,0.48,107,147,0.7278911564625851,28,125,153,120,40,2,82,116,698,2015_Evan Fournier
2015,Jeff Green,SF,28,832,1934,0.4301964839710445,194,584,0.3321917808219178,638,1350,0.4725925925925926,478,574,0.8327526132404182,128,528,656,268,106,68,216,294,2336,2015_Jeff Green
2015,Jeremy Lamb,SG,22,104,250,0.416,38,111,0.34234234234234234,66,139,0.4748201438848921,49,55,0.8909090909090909,8,99,107,44,21,6,27,52,295,2015_Jeremy Lamb
2015,John Lucas,PG,32,42,104,0.40384615384615385,9,29,0.3103448275862069,33,75,0.44,5,5,1.0,4,12,16,60,8,0,16,18,98,2015_John Lucas
2015,Lou Williams,SG,28,375,928,0.4040948275862069,152,447,0.3400447427293065,223,481,0.46361746361746364,340,395,0.8607594936708861,24,127,151,164,88,10,101,103,1242,2015_Lou Williams
2015,Rajon Rondo,PG,28,550,1290,0.4263565891472868,54,172,0.313953488372093,496,1118,0.44364937388193204,62,156,0.3974358974358974,146,600,746,1076,182,14,420,306,1216,2015_Rajon Rondo
2015,Shavlik Randolph,PF,31,18,70,0.2571428571428571,0,10,0.0,18,60,0.3,12,24,0.5,32,44,76,8,10,6,6,32,48,2015_Shavlik Randolph
2016,Andre Miller,PG,39,118,212,0.5566037735849056,4,16,0.25,114,196,0.5816326530612245,48,64,0.75,24,78,102,174,32,0,74,92,288,2016_Andre Miller
2016,Ben McLemore,SG,22,195,455,0.42857142857142855,67,185,0.3621621621621622,128,270,0.4740740740740741,74,103,0.7184466019417476,34,114,148,79,52,10,99,140,531,2016_Ben McLemore
2016,Damian Lillard,PG,25,618,1474,0.41926729986431477,229,610,0.37540983606557377,389,864,0.45023148148148145,414,464,0.8922413793103449,45,257,302,512,65,28,242,165,1879,2016_Damian Lillard
2016,David West,PF,35,244,448,0.5446428571428571,3,7,0.42857142857142855,241,441,0.546485260770975,63,80,0.7875,72,237,309,143,44,55,68,142,554,2016_David West
2016,Ersan Ilyasova,PF,28,560,1322,0.4236006051437216,192,518,0.37065637065637064,368,804,0.4577114427860697,222,308,0.7207792207792207,288,518,806,134,104,66,142,342,1534,2016_Ersan Ilyasova
2016,Evan Fournier,SF,23,429,929,0.46178686759956944,156,390,0.4,273,539,0.5064935064935064,199,238,0.8361344537815126,33,192,225,213,96,2,133,214,1213,2016_Evan Fournier
2016,J.J. Barea,PG,31,317,711,0.44585091420534456,100,260,0.38461538461538464,217,451,0.4811529933481153,74,96,0.7708333333333334,26,126,152,302,26,2,113,110,808,2016_J.J. Barea
2016,Jarnell Stokes,C,22,6,10,0.6,0,0,NaN,6,10,0.6,2,4,0.5,2,6,8,2,2,0,0,2,14,2016_Jarnell Stokes
2016,Jeremy Lamb,SG,23,230,510,0.45098039215686275,56,181,0.30939226519337015,174,329,0.5288753799392097,64,88,0.7272727272727273,44,208,252,77,42,30,50,105,580,2016_Jeremy Lamb
2016,Justin Harper,PF,26,4,10,0.4,4,9,0.4444444444444444,0,1,0.0,1,2,0.5,0,1,1,0,1,0,2,3,13,2016_Justin Harper
2016,Kevin Seraphin,C,26,84,205,0.4097560975609756,0,2,0.0,84,203,0.41379310344827586,19,23,0.8260869565217391,31,95,126,47,8,36,43,67,187,2016_Kevin Seraphin
2016,Kosta Koufos,C,26,236,444,0.5315315315315315,0,0,NaN,236,444,0.5315315315315315,57,104,0.5480769230769231,169,254,423,33,40,70,48,185,529,2016_Kosta Koufos
2016,Mitch McGary,PF,23,11,23,0.4782608695652174,0,4,0.0,11,19,0.5789473684210527,4,10,0.4,4,14,18,3,1,2,7,10,26,2016_Mitch McGary
2016,Montrezl Harrell,PF,22,58,90,0.6444444444444445,0,1,0.0,58,89,0.651685393258427,24,46,0.5217391304347826,25,40,65,17,11,11,17,48,140,2016_Montrezl Harrell
2016,Patrick Beverley,PG,27,258,594,0.43434343434343436,124,310,0.4,134,284,0.47183098591549294,60,88,0.6818181818181818,73,177,250,239,94,26,91,234,700,2016_Patrick Beverley
2016,Rajon Rondo,PG,29,355,782,0.4539641943734015,62,170,0.36470588235294116,293,612,0.47875816993464054,87,150,0.58,77,358,435,839,141,10,278,175,859,2016_Rajon Rondo
2016,Ramon Sessions,PG,29,280,592,0.47297297297297297,36,111,0.32432432432432434,244,481,0.5072765072765073,214,283,0.7561837455830389,25,178,203,239,46,5,115,102,810,2016_Ramon Sessions
2016,Tristan Thompson,PF,24,247,420,0.5880952380952381,0,0,NaN,247,420,0.5880952380952381,149,242,0.6157024793388429,268,470,738,62,38,51,61,202,643,2016_Tristan Thompson
2017,Evan Fournier,SG,24,408,930,0.43870967741935485,128,360,0.35555555555555557,280,570,0.49122807017543857,223,277,0.8050541516245487,44,165,209,202,66,4,141,180,1167,2017_Evan Fournier
2017,Goran Dragic,PG,30,534,1124,0.4750889679715303,117,289,0.40484429065743943,417,835,0.4994011976047904,298,377,0.7904509283819628,61,217,278,423,89,13,212,199,1483,2017_Goran Dragic
2017,Ian Mahinmi,C,30,65,111,0.5855855855855856,0,0,NaN,65,111,0.5855855855855856,43,75,0.5733333333333334,47,103,150,19,33,24,34,90,173,2017_Ian Mahinmi
2017,Jeremy Lamb,SG,24,226,491,0.46028513238289204,41,146,0.2808219178082192,185,345,0.5362318840579711,110,129,0.8527131782945736,30,234,264,75,27,23,40,98,603,2017_Jeremy Lamb
2017,Josh Huestis,PF,25,6,11,0.5454545454545454,2,4,0.5,4,7,0.5714285714285714,0,1,0.0,4,5,9,3,0,3,0,0,14,2017_Josh Huestis
2017,Justin Harper,PF,27,5,12,0.4166666666666667,2,7,0.2857142857142857,3,5,0.6,0,0,NaN,2,3,5,2,0,0,4,2,12,2017_Justin Harper
2017,Justise Winslow,SF,20,80,225,0.35555555555555557,7,35,0.2,73,190,0.38421052631578945,29,47,0.6170212765957447,23,71,94,66,27,6,33,52,196,2017_Justise Winslow
2017,Maurice Ndour,PF,24,39,86,0.45348837209302323,1,7,0.14285714285714285,38,79,0.4810126582278481,19,26,0.7307692307692307,22,42,64,8,15,8,12,30,98,2017_Maurice Ndour
2017,Rudy Gay,SF,30,201,442,0.45475113122171945,42,113,0.37168141592920356,159,329,0.48328267477203646,118,138,0.855072463768116,35,155,190,82,44,26,74,79,562,2017_Rudy Gay
2003,Hubert Davis,SG,32,31,79,0.3924050632911392,12,36,0.3333333333333333,19,43,0.4418604651162791,5,6,0.8333333333333334,6,30,36,29,5,0,11,23,79,2003_Hubert Davis
2003,Jake Voskuhl,C,25,92,163,0.5644171779141104,0,0,NaN,92,163,0.5644171779141104,64,96,0.6666666666666666,97,128,225,36,18,29,48,172,248,2003_Jake Voskuhl
2003,Jarron Collins,C,24,38,86,0.4418604651162791,0,1,0.0,38,85,0.4470588235294118,44,62,0.7096774193548387,32,28,60,14,5,6,19,70,120,2003_Jarron Collins
2003,Larry Hughes,PG,24,346,741,0.4669365721997301,29,79,0.3670886075949367,317,662,0.4788519637462236,136,186,0.7311827956989247,67,241,308,205,86,24,136,149,857,2003_Larry Hughes
2003,Moochie Norris,PG,29,134,330,0.40606060606060607,11,45,0.24444444444444444,123,285,0.43157894736842106,78,114,0.6842105263157895,37,122,159,196,55,4,86,72,357,2003_Moochie Norris
2003,Stephon Marbury,PG,25,671,1530,0.43856209150326797,89,296,0.30067567567567566,582,1234,0.47163695299837927,375,467,0.8029978586723768,53,210,263,654,108,20,263,200,1806,2003_Stephon Marbury
2003,Tayshaun Prince,SF,22,53,118,0.4491525423728814,20,47,0.425531914893617,33,71,0.4647887323943662,11,17,0.6470588235294118,5,40,45,24,10,14,21,25,137,2003_Tayshaun Prince
2004,Amal McCaskill,C,30,47,117,0.4017094017094017,0,1,0.0,47,116,0.4051724137931034,19,27,0.7037037037037037,48,85,133,20,12,20,25,89,113,2004_Amal McCaskill
2004,Mo Williams,SG,21,115,303,0.3795379537953795,10,39,0.2564102564102564,105,264,0.3977272727272727,44,56,0.7857142857142857,23,49,72,76,28,2,51,87,284,2004_Mo Williams
2004,P.J. Brown,PF,34,339,712,0.476123595505618,0,1,0.0,339,711,0.4767932489451477,158,185,0.8540540540540541,237,453,690,155,78,73,101,203,836,2004_P.J. Brown
2004,Popeye Jones,PF,33,0,2,0.0,0,0,NaN,0,2,0.0,0,0,NaN,1,0,1,0,0,0,0,2,0,2004_Popeye Jones
2004,Robert Traylor,C,26,145,287,0.5052264808362369,2,5,0.4,143,282,0.5070921985815603,70,128,0.546875,106,156,262,43,39,37,62,161,362,2004_Robert Traylor
2004,Rodney Buford,SF,26,19,56,0.3392857142857143,0,2,0.0,19,54,0.35185185185185186,3,6,0.5,6,9,15,7,6,1,4,9,41,2004_Rodney Buford
2004,Stephon Marbury,PG,26,1196,2772,0.4314574314574315,174,548,0.3175182481751825,1022,2224,0.4595323741007194,712,872,0.8165137614678899,116,410,526,1438,258,18,498,344,3278,2004_Stephon Marbury
2004,Tayshaun Prince,SF,23,338,723,0.46749654218533887,57,157,0.3630573248407643,281,566,0.49646643109540634,108,141,0.7659574468085106,93,297,390,191,63,69,119,149,841,2004_Tayshaun Prince
2004,Travis Outlaw,PF,19,3,7,0.42857142857142855,0,0,NaN,3,7,0.42857142857142855,2,4,0.5,2,2,4,1,1,0,1,1,8,2004_Travis Outlaw
2004,Zaza Pachulia,C,19,68,175,0.38857142857142857,0,0,NaN,68,175,0.38857142857142857,58,90,0.6444444444444445,69,105,174,13,21,12,34,87,194,2004_Zaza Pachulia
2005,Antoine Walker,PF,28,1162,2754,0.42193173565722586,220,682,0.3225806451612903,942,2072,0.4546332046332046,402,746,0.5388739946380697,364,1026,1390,530,178,116,506,434,2946,2005_Antoine Walker
2005,Brandon Hunter,PF,24,37,73,0.5068493150684932,0,0,NaN,37,73,0.5068493150684932,21,39,0.5384615384615384,25,44,69,3,4,7,22,42,95,2005_Brandon Hunter
2005,Jamaal Tinsley,PG,26,218,522,0.41762452107279696,58,156,0.3717948717948718,160,366,0.4371584699453552,122,164,0.7439024390243902,26,134,160,257,81,12,134,112,616,2005_Jamaal Tinsley
2005,Malik Rose,PF,30,396,882,0.4489795918367347,2,20,0.1,394,862,0.45707656612529,274,372,0.7365591397849462,258,424,682,118,92,32,204,416,1068,2005_Malik Rose
2005,Mo Williams,PG,22,323,737,0.43826322930800543,32,99,0.32323232323232326,291,638,0.4561128526645768,136,160,0.85,50,194,244,484,74,11,196,221,814,2005_Mo Williams
2005,Rodney Buford,SF,27,187,489,0.3824130879345603,34,108,0.3148148148148148,153,381,0.4015748031496063,37,45,0.8222222222222222,33,156,189,63,40,4,35,101,445,2005_Rodney Buford
2005,Samuel Dalembert,C,23,250,477,0.5241090146750524,0,0,NaN,250,477,0.5241090146750524,89,148,0.6013513513513513,187,355,542,35,46,121,114,241,589,2005_Samuel Dalembert
2005,Stephon Marbury,PG,27,604,1308,0.4617737003058104,115,325,0.35384615384615387,489,983,0.49745676500508645,458,549,0.8342440801457195,50,198,248,668,122,6,233,186,1781,2005_Stephon Marbury
2005,Steve Nash,PG,30,430,857,0.5017502917152858,94,218,0.43119266055045874,336,639,0.5258215962441315,211,238,0.8865546218487395,57,192,249,861,74,6,245,136,1165,2005_Steve Nash
2005,Tayshaun Prince,SF,24,469,963,0.48701973001038423,47,138,0.34057971014492755,422,825,0.5115151515151515,221,274,0.8065693430656934,133,302,435,247,56,71,135,161,1206,2005_Tayshaun Prince
2006,Adonal Foyle,C,30,152,300,0.5066666666666667,0,0,NaN,152,300,0.5066666666666667,41,67,0.6119402985074627,143,281,424,33,44,125,80,215,345,2006_Adonal Foyle
2006,Derek Anderson,SG,31,216,606,0.3564356435643564,80,268,0.29850746268656714,136,338,0.40236686390532544,186,222,0.8378378378378378,42,244,286,202,46,12,108,196,698,2006_Derek Anderson
2006,Dwayne Jones,PF,22,4,10,0.4,0,0,NaN,4,10,0.4,6,13,0.46153846153846156,10,21,31,2,1,3,3,14,14,2006_Dwayne Jones
2006,Ha Seung-Jin,C,20,18,31,0.5806451612903226,0,0,NaN,18,31,0.5806451612903226,8,17,0.47058823529411764,14,35,49,1,3,8,14,41,44,2006_Ha Seung-Jin
2006,James Singleton,SF,24,77,151,0.5099337748344371,10,20,0.5,67,131,0.5114503816793893,39,50,0.78,63,134,197,29,19,21,28,95,203,2006_James Singleton
2006,Jason Kapono,SF,24,79,177,0.4463276836158192,21,53,0.39622641509433965,58,124,0.46774193548387094,28,33,0.8484848484848485,12,59,71,37,7,3,20,89,207,2006_Jason Kapono
2006,Michael Doleac,C,28,37,88,0.42045454545454547,0,0,NaN,37,88,0.42045454545454547,24,30,0.8,23,62,85,8,10,7,14,45,98,2006_Michael Doleac
2006,Mo Williams,PG,23,267,629,0.424483306836248,73,191,0.38219895287958117,194,438,0.4429223744292237,96,113,0.8495575221238938,30,113,143,230,52,7,105,146,703,2006_Mo Williams
2006,Qyntel Woods,SF,24,129,254,0.5078740157480315,22,60,0.36666666666666664,107,194,0.5515463917525774,49,76,0.6447368421052632,44,146,190,47,32,13,61,96,329,2006_Qyntel Woods
2006,Robert Whaley,C,23,23,57,0.40350877192982454,0,0,NaN,23,57,0.40350877192982454,3,6,0.5,16,27,43,17,7,8,14,41,49,2006_Robert Whaley
2006,Stephon Marbury,PG,28,349,774,0.4509043927648579,33,104,0.3173076923076923,316,670,0.4716417910447761,246,326,0.754601226993865,25,150,175,382,63,4,157,143,977,2006_Stephon Marbury
2006,Tayshaun Prince,SF,25,455,999,0.45545545545545546,64,183,0.34972677595628415,391,816,0.4791666666666667,182,238,0.7647058823529411,104,242,346,186,62,39,91,96,1156,2006_Tayshaun Prince
2006,Tyson Chandler,C,23,160,283,0.5653710247349824,0,1,0.0,160,282,0.5673758865248227,97,193,0.5025906735751295,265,449,714,81,41,104,123,298,417,2006_Tyson Chandler
2007,Alexander Johnson,PF,23,91,169,0.5384615384615384,0,0,NaN,91,169,0.5384615384615384,78,118,0.6610169491525424,50,131,181,17,25,35,47,137,260,2007_Alexander Johnson
2007,Andrea Bargnani,PF,21,267,625,0.4272,100,268,0.373134328358209,167,357,0.4677871148459384,117,142,0.823943661971831,52,203,255,50,32,53,107,180,751,2007_Andrea Bargnani
2007,Brandon Bass,PF,21,15,44,0.3409090909090909,0,1,0.0,15,43,0.3488372093023256,12,16,0.75,13,30,43,3,2,3,10,16,42,2007_Brandon Bass
2007,Damien Wilkins,SF,27,262,602,0.43521594684385384,50,122,0.4098360655737705,212,480,0.44166666666666665,150,170,0.8823529411764706,87,142,229,156,92,16,116,157,724,2007_Damien Wilkins
2007,Dikembe Mutombo,C,40,85,153,0.5555555555555556,0,0,NaN,85,153,0.5555555555555556,60,87,0.6896551724137931,164,324,488,13,22,76,38,156,230,2007_Dikembe Mutombo
2007,Gilbert Arenas,PG,25,647,1548,0.41795865633074936,205,584,0.351027397260274,442,964,0.45850622406639,606,718,0.8440111420612814,61,277,338,443,139,13,236,249,2105,2007_Gilbert Arenas
2007,James Singleton,PF,25,30,82,0.36585365853658536,3,14,0.21428571428571427,27,68,0.39705882352941174,22,29,0.7586206896551724,36,70,106,17,15,17,17,45,85,2007_James Singleton
2007,Jason Hart,PG,28,200,448,0.44642857142857145,14,58,0.2413793103448276,186,390,0.47692307692307695,84,94,0.8936170212765957,28,168,196,206,88,2,76,166,498,2007_Jason Hart
2007,Mo Williams,PG,24,468,1049,0.446139180171592,79,228,0.34649122807017546,389,821,0.47381242387332523,159,186,0.8548387096774194,54,275,329,416,85,6,203,201,1174,2007_Mo Williams
2007,Stephon Marbury,PG,29,395,952,0.41491596638655465,123,345,0.3565217391304348,272,607,0.44810543657331137,297,386,0.7694300518134715,36,177,213,403,71,10,179,185,1210,2007_Stephon Marbury
2007,Tayshaun Prince,SF,26,459,997,0.46038114343029085,81,210,0.38571428571428573,378,787,0.48030495552731894,172,224,0.7678571428571429,144,285,429,227,51,55,98,116,1171,2007_Tayshaun Prince
2008,Alexander Johnson,PF,24,61,125,0.488,0,0,NaN,61,125,0.488,57,83,0.6867469879518072,32,62,94,13,13,10,42,80,179,2008_Alexander Johnson
2008,Andrea Bargnani,PF,22,280,725,0.38620689655172413,90,261,0.3448275862068966,190,464,0.40948275862068967,142,169,0.8402366863905325,50,238,288,89,23,37,88,211,792,2008_Andrea Bargnani
2008,Awvee Storey,SG,30,39,89,0.43820224719101125,0,7,0.0,39,82,0.47560975609756095,14,29,0.4827586206896552,31,23,54,16,7,1,10,41,92,2008_Awvee Storey
2008,Coby Karl,SG,24,9,26,0.34615384615384615,4,13,0.3076923076923077,5,13,0.38461538461538464,8,10,0.8,3,11,14,9,4,2,5,4,30,2008_Coby Karl
2008,Desmond Mason,SF,30,230,477,0.48218029350104824,0,0,NaN,230,477,0.48218029350104824,114,173,0.6589595375722543,75,181,256,121,40,30,83,106,574,2008_Desmond Mason
2008,Dikembe Mutombo,C,41,43,80,0.5375,0,0,NaN,43,80,0.5375,32,45,0.7111111111111111,68,131,199,5,11,48,17,55,118,2008_Dikembe Mutombo
2008,Gerald Wallace,PF,25,408,908,0.44933920704845814,71,221,0.3212669683257919,337,687,0.49053857350800584,313,428,0.7313084112149533,58,315,373,216,131,58,180,189,1200,2008_Gerald Wallace
2008,Jason Richardson,SF,27,648,1468,0.44141689373297005,243,599,0.4056761268781302,405,869,0.4660529344073648,249,331,0.7522658610271903,80,361,441,258,116,57,166,241,1788,2008_Jason Richardson
2008,Kirk Hinrich,PG,27,330,797,0.41405269761606023,84,240,0.35,246,557,0.44165170556552963,118,142,0.8309859154929577,28,216,244,452,87,19,157,224,862,2008_Kirk Hinrich
2008,Mike Harris,PF,24,27,54,0.5,0,2,0.0,27,52,0.5192307692307693,8,13,0.6153846153846154,24,30,54,3,6,3,9,16,62,2008_Mike Harris
2008,Mike James,PG,32,202,580,0.3482758620689655,62,194,0.31958762886597936,140,386,0.3626943005181347,78,96,0.8125,28,110,138,120,42,4,72,112,544,2008_Mike James
2008,Mo Williams,PG,25,441,919,0.47986942328618065,89,231,0.3852813852813853,352,688,0.5116279069767442,166,194,0.8556701030927835,37,193,230,419,78,10,182,188,1137,2008_Mo Williams
2008,Nick Young,SG,22,210,478,0.4393305439330544,40,100,0.4,170,378,0.4497354497354497,101,124,0.8145161290322581,23,92,115,63,35,7,94,130,561,2008_Nick Young
2008,Tayshaun Prince,SF,27,421,940,0.4478723404255319,53,146,0.363013698630137,368,794,0.4634760705289673,185,241,0.7676348547717843,109,289,398,268,42,33,91,90,1080,2008_Tayshaun Prince
2008,Zydrunas Ilgauskas,C,32,417,879,0.47440273037542663,0,1,0.0,417,878,0.47494305239179957,195,243,0.8024691358024691,263,419,682,104,34,120,135,247,1029,2008_Zydrunas Ilgauskas
2009,Andrea Bargnani,PF,23,431,958,0.4498956158663883,119,291,0.40893470790378006,312,667,0.46776611694152925,221,266,0.8308270676691729,70,346,416,94,34,97,135,242,1202,2009_Andrea Bargnani
2009,Brian Cardinal,PF,31,65,169,0.38461538461538464,30,92,0.32608695652173914,35,77,0.45454545454545453,30,35,0.8571428571428571,39,103,142,76,37,13,48,135,190,2009_Brian Cardinal
2009,Brian Cook,PF,28,56,152,0.3684210526315789,26,60,0.43333333333333335,30,92,0.32608695652173914,10,12,0.8333333333333334,14,50,64,10,6,6,26,52,148,2009_Brian Cook
2009,Darrell Arthur,PF,20,191,436,0.4380733944954128,0,2,0.0,191,434,0.4400921658986175,40,60,0.6666666666666666,108,238,346,43,52,52,47,206,422,2009_Darrell Arthur
2009,Desmond Mason,SG,31,124,285,0.43508771929824563,0,3,0.0,124,282,0.4397163120567376,46,85,0.5411764705882353,41,116,157,46,15,30,56,96,294,2009_Desmond Mason
2009,Dikembe Mutombo,C,42,5,13,0.38461538461538464,0,0,NaN,5,13,0.38461538461538464,6,9,0.6666666666666666,12,21,33,0,0,11,6,11,16,2009_Dikembe Mutombo
2009,James Singleton,PF,27,117,221,0.5294117647058824,13,40,0.325,104,181,0.574585635359116,67,78,0.8589743589743589,89,161,250,17,26,28,36,110,314,2009_James Singleton
2009,Josh Smith,PF,23,418,849,0.4923439340400471,26,87,0.2988505747126437,392,762,0.5144356955380578,211,359,0.5877437325905293,134,364,498,169,94,111,161,184,1073,2009_Josh Smith
2009,Melvin Ely,C,30,37,95,0.3894736842105263,0,0,NaN,37,95,0.3894736842105263,23,36,0.6388888888888888,30,34,64,18,2,9,23,58,97,2009_Melvin Ely
2009,Mo Williams,PG,26,526,1126,0.46714031971580816,183,420,0.4357142857142857,343,706,0.48583569405099153,208,228,0.9122807017543859,47,232,279,329,69,9,179,215,1443,2009_Mo Williams
2009,Nathan Jawai,PF,22,1,4,0.25,0,0,NaN,1,4,0.25,0,0,NaN,1,1,2,0,0,0,2,3,2,2009_Nathan Jawai
2009,Rasho Nesterovic,C,32,224,437,0.5125858123569794,0,1,0.0,224,436,0.5137614678899083,25,32,0.78125,93,147,240,109,30,38,63,171,473,2009_Rasho Nesterovic
2009,Shelden Williams,PF,25,140,314,0.445859872611465,0,4,0.0,140,310,0.45161290322580644,92,126,0.7301587301587301,98,208,306,24,44,36,68,128,372,2009_Shelden Williams
2009,Tayshaun Prince,SF,28,459,1020,0.45,56,141,0.3971631205673759,403,879,0.45847554038680316,189,243,0.7777777777777778,128,348,476,253,44,51,101,104,1163,2009_Tayshaun Prince
2009,Tim Duncan,C,32,558,1107,0.5040650406504065,0,2,0.0,558,1105,0.5049773755656108,334,483,0.6915113871635611,201,599,800,264,38,126,165,173,1450,2009_Tim Duncan
2010,Al Jefferson,C,25,560,1125,0.49777777777777776,0,4,0.0,560,1121,0.49955396966993754,181,266,0.6804511278195489,180,523,703,137,63,98,136,205,1301,2010_Al Jefferson
2010,Danny Granger,SF,26,488,1139,0.42844600526777876,158,438,0.3607305936073059,330,701,0.47075606276747506,363,428,0.8481308411214953,67,275,342,171,94,51,157,183,1497,2010_Danny Granger
2010,J.J. Hickson,PF,21,289,522,0.553639846743295,0,1,0.0,289,521,0.5547024952015355,111,163,0.6809815950920245,110,290,400,40,36,39,92,132,689,2010_J.J. Hickson
2010,James Harden,SG,20,233,578,0.4031141868512111,93,248,0.375,140,330,0.42424242424242425,194,240,0.8083333333333333,47,197,244,137,80,20,106,200,753,2010_James Harden
2010,James Jones,SF,29,43,119,0.36134453781512604,37,90,0.4111111111111111,6,29,0.20689655172413793,23,28,0.8214285714285714,4,41,45,17,11,4,11,45,146,2010_James Jones
2010,Kevin Love,PF,21,291,646,0.4504643962848297,35,106,0.330188679245283,256,540,0.4740740740740741,225,276,0.8152173913043478,227,431,658,136,43,23,117,136,842,2010_Kevin Love
2010,Kurt Thomas,C,37,99,208,0.47596153846153844,0,0,NaN,99,208,0.47596153846153844,12,15,0.8,84,207,291,47,26,46,48,159,210,2010_Kurt Thomas
2010,Othello Hunter,SF,23,4,12,0.3333333333333333,0,0,NaN,4,12,0.3333333333333333,3,4,0.75,6,6,12,0,0,1,3,5,11,2010_Othello Hunter
2010,Pops Mensah-Bonsu,PF,26,26,66,0.3939393939393939,0,0,NaN,26,66,0.3939393939393939,26,48,0.5416666666666666,32,38,70,6,8,18,20,40,78,2010_Pops Mensah-Bonsu
2010,Ronnie Brewer,SG,24,418,858,0.48717948717948717,16,62,0.25806451612903225,402,796,0.5050251256281407,170,266,0.6390977443609023,90,284,374,308,182,30,106,160,1022,2010_Ronnie Brewer
2010,Shavlik Randolph,PF,26,12,36,0.3333333333333333,0,0,NaN,12,36,0.3333333333333333,4,4,1.0,14,14,28,2,2,2,6,18,28,2010_Shavlik Randolph
2010,Terrence Williams,SF,22,261,651,0.4009216589861751,31,100,0.31,230,551,0.41742286751361163,103,144,0.7152777777777778,46,302,348,223,43,10,124,126,656,2010_Terrence Williams
2010,Travis Outlaw,SF,25,220,562,0.3914590747330961,80,210,0.38095238095238093,140,352,0.3977272727272727,98,118,0.8305084745762712,66,176,242,68,36,34,64,86,618,2010_Travis Outlaw
2010,Zaza Pachulia,C,25,120,246,0.4878048780487805,0,4,0.0,120,242,0.49586776859504134,93,143,0.6503496503496503,117,176,293,42,37,31,58,186,333,2010_Zaza Pachulia
2011,Ben Uzoh,PG,22,61,144,0.4236111111111111,3,8,0.375,58,136,0.4264705882352941,33,56,0.5892857142857143,30,31,61,69,13,8,25,29,158,2011_Ben Uzoh
2011,Charlie Bell,SG,31,12,43,0.27906976744186046,6,21,0.2857142857142857,6,22,0.2727272727272727,2,4,0.5,6,12,18,13,6,1,6,13,32,2011_Charlie Bell
2011,Corey Brewer,SF_SG_SF-SG,24,386,976,0.39549180327868855,60,224,0.26785714285714285,326,752,0.43351063829787234,272,384,0.7083333333333334,114,236,350,178,200,32,174,318,1104,2011_Corey Brewer
2011,Danny Granger,SF,27,535,1260,0.4246031746031746,157,407,0.3857493857493858,378,853,0.44314185228604924,395,466,0.8476394849785408,87,338,425,203,89,62,206,213,1622,2011_Danny Granger
2011,J.J. Barea,PG,26,285,649,0.4391371340523883,66,189,0.3492063492063492,219,460,0.47608695652173916,133,157,0.8471337579617835,29,130,159,317,30,1,136,136,769,2011_J.J. Barea
2011,Jason Williams,PG,35,44,134,0.3283582089552239,20,76,0.2631578947368421,24,58,0.41379310344827586,0,0,NaN,6,54,60,104,22,2,36,16,108,2011_Jason Williams
2011,Kurt Thomas,PF,38,95,186,0.510752688172043,1,1,1.0,94,185,0.5081081081081081,20,32,0.625,75,226,301,60,32,42,42,164,211,2011_Kurt Thomas
2011,Marcus Banks,PG,29,0,2,0.0,0,0,NaN,0,2,0.0,6,8,0.75,0,1,1,3,1,0,2,4,6,2011_Marcus Banks
2011,Pops Mensah-Bonsu,PF,27,1,3,0.3333333333333333,0,0,NaN,1,3,0.3333333333333333,0,0,NaN,3,8,11,2,0,0,2,11,2,2011_Pops Mensah-Bonsu
2011,Ronnie Brewer,SG,25,205,427,0.48009367681498827,6,27,0.2222222222222222,199,400,0.4975,87,133,0.6541353383458647,55,207,262,140,106,22,55,82,503,2011_Ronnie Brewer
2011,Royal Ivey,SG,29,16,38,0.42105263157894735,7,16,0.4375,9,22,0.4090909090909091,2,2,1.0,2,14,16,7,6,1,5,17,41,2011_Royal Ivey
2011,Stephen Graham,SG,28,81,200,0.405,5,21,0.23809523809523808,76,179,0.4245810055865922,31,38,0.8157894736842105,17,106,123,40,14,1,38,106,198,2011_Stephen Graham
2011,Tayshaun Prince,SF,30,473,1001,0.4725274725274725,34,98,0.3469387755102041,439,903,0.48615725359911405,118,168,0.7023809523809523,78,251,329,215,30,41,82,90,1098,2011_Tayshaun Prince
2011,Terrence Williams,SG,23,86,230,0.3739130434782609,12,44,0.2727272727272727,74,186,0.3978494623655914,28,42,0.6666666666666666,8,94,102,76,18,0,66,50,212,2011_Terrence Williams
2011,Travis Outlaw,SF,26,274,731,0.3748290013679891,76,252,0.30158730158730157,198,479,0.4133611691022965,132,171,0.7719298245614035,54,271,325,84,34,36,71,148,756,2011_Travis Outlaw
2011,Zaza Pachulia,C,26,107,232,0.46120689655172414,0,0,NaN,107,232,0.46120689655172414,135,179,0.7541899441340782,119,214,333,58,34,22,69,184,349,2011_Zaza Pachulia
2012,Chris Wilcox,C,29,64,107,0.5981308411214953,0,0,NaN,64,107,0.5981308411214953,24,39,0.6153846153846154,38,84,122,12,11,9,30,64,152,2012_Chris Wilcox
2012,D.J. White,PF,25,174,353,0.49291784702549574,1,1,1.0,173,352,0.4914772727272727,43,61,0.7049180327868853,50,159,209,47,17,23,43,94,392,2012_D.J. White
2012,Danny Granger,SF,28,391,941,0.4155154091392136,123,323,0.38080495356037153,268,618,0.4336569579288026,254,291,0.872852233676976,79,228,307,109,62,40,110,144,1159,2012_Danny Granger
2012,Eddy Curry,C,29,12,26,0.46153846153846156,0,0,NaN,12,26,0.46153846153846156,6,8,0.75,4,8,12,1,0,2,10,17,30,2012_Eddy Curry
2012,Goran Dragic,PG,25,277,600,0.46166666666666667,68,202,0.33663366336633666,209,398,0.5251256281407035,153,190,0.8052631578947368,53,115,168,351,85,10,157,166,775,2012_Goran Dragic
2012,James Singleton,PF,30,41,75,0.5466666666666666,2,9,0.2222222222222222,39,66,0.5909090909090909,14,15,0.9333333333333333,25,56,81,15,9,8,10,27,98,2012_James Singleton
2012,Jon Leuer,PF,22,97,191,0.5078534031413613,3,9,0.3333333333333333,94,182,0.5164835164835165,21,28,0.75,45,75,120,25,14,17,18,67,218,2012_Jon Leuer
2012,Kevin Martin,SG,28,222,537,0.4134078212290503,78,225,0.3466666666666667,144,312,0.46153846153846156,160,179,0.8938547486033519,13,93,106,110,28,3,70,70,682,2012_Kevin Martin
2012,Kurt Thomas,C,39,73,157,0.46496815286624205,0,0,NaN,73,157,0.46496815286624205,14,20,0.7,39,149,188,46,24,31,31,123,160,2012_Kurt Thomas
2012,Malcolm Lee,SG,21,23,59,0.3898305084745763,2,10,0.2,21,49,0.42857142857142855,14,17,0.8235294117647058,9,17,26,31,8,4,17,22,62,2012_Malcolm Lee
2012,Ronnie Brewer,SG,26,190,445,0.42696629213483145,19,69,0.2753623188405797,171,376,0.45478723404255317,56,100,0.56,72,159,231,137,72,21,59,64,455,2012_Ronnie Brewer
2012,Rudy Gay,SF,25,485,1067,0.45454545454545453,54,173,0.31213872832369943,431,894,0.48210290827740493,208,263,0.7908745247148289,130,287,417,147,95,55,161,138,1232,2012_Rudy Gay
2012,Tayshaun Prince,SF,31,336,798,0.42105263157894735,37,104,0.3557692307692308,299,694,0.430835734870317,89,115,0.7739130434782608,72,209,281,153,27,32,74,77,798,2012_Tayshaun Prince
2012,Terrence Williams,SG,24,170,396,0.4292929292929293,32,92,0.34782608695652173,138,304,0.45394736842105265,54,92,0.5869565217391305,26,178,204,130,40,14,86,70,426,2012_Terrence Williams
2012,Travis Leslie,SG,21,5,14,0.35714285714285715,0,0,NaN,5,14,0.35714285714285715,4,9,0.4444444444444444,6,3,9,5,2,2,2,4,14,2012_Travis Leslie
2012,Travis Outlaw,SF,27,60,175,0.34285714285714286,16,60,0.26666666666666666,44,115,0.3826086956521739,31,46,0.6739130434782609,19,42,61,16,19,21,20,34,167,2012_Travis Outlaw
2012,Trey Johnson,SG,27,8,14,0.5714285714285714,0,0,NaN,8,14,0.5714285714285714,5,5,1.0,3,9,12,4,1,0,5,10,21,2012_Trey Johnson
2012,Trey Thompkins,C,21,24,61,0.39344262295081966,4,13,0.3076923076923077,20,48,0.4166666666666667,5,7,0.7142857142857143,4,20,24,3,3,3,6,10,57,2012_Trey Thompkins
2012,Willie Green,SG,30,153,325,0.4707692307692308,50,113,0.4424778761061947,103,212,0.4858490566037736,48,56,0.8571428571428571,15,65,80,40,23,6,33,74,404,2012_Willie Green
2012,Zaza Pachulia,C,27,169,339,0.49852507374631266,0,0,NaN,169,339,0.49852507374631266,117,158,0.740506329113924,154,303,457,79,55,29,81,172,455,2012_Zaza Pachulia
2013,Danny Granger,SF,29,10,35,0.2857142857142857,2,10,0.2,8,25,0.32,5,8,0.625,3,6,9,3,2,1,4,6,27,2013_Danny Granger
2013,Gordon Hayward,SF,22,336,773,0.4346701164294955,102,246,0.4146341463414634,234,527,0.444022770398482,243,294,0.826530612244898,51,174,225,213,58,38,120,125,1017,2013_Gordon Hayward
2013,Jason Thompson,PF,26,374,745,0.5020134228187919,0,3,0.0,374,742,0.5040431266846361,143,206,0.6941747572815534,172,377,549,84,48,61,101,227,891,2013_Jason Thompson
2013,Jerry Stackhouse,SF,38,66,172,0.38372093023255816,30,89,0.33707865168539325,36,83,0.43373493975903615,20,23,0.8695652173913043,5,28,33,35,7,4,24,31,182,2013_Jerry Stackhouse
2013,Jon Leuer,C_PF_PF-C,23,50,104,0.4807692307692308,0,6,0.0,50,98,0.5102040816326531,12,26,0.46153846153846156,26,48,74,16,12,0,16,42,112,2013_Jon Leuer
2013,Malcolm Lee,SG,22,29,76,0.3815789473684211,8,24,0.3333333333333333,21,52,0.40384615384615385,12,20,0.6,15,24,39,20,12,6,10,30,78,2013_Malcolm Lee
2013,Marc Gasol,C,28,429,869,0.4936708860759494,1,14,0.07142857142857142,428,855,0.5005847953216375,268,316,0.8481012658227848,184,438,622,318,80,139,157,255,1127,2013_Marc Gasol
2013,Mo Williams,PG,30,229,533,0.42964352720450283,59,154,0.38311688311688313,170,379,0.44854881266490765,75,85,0.8823529411764706,24,86,110,285,46,9,125,105,592,2013_Mo Williams
2013,Ronnie Brewer,SF,27,140,396,0.35353535353535354,46,152,0.3026315789473684,94,244,0.38524590163934425,32,78,0.41025641025641024,84,196,280,100,86,12,36,66,358,2013_Ronnie Brewer
2013,Ryan Hollins,C,28,70,114,0.6140350877192983,0,0,NaN,70,114,0.6140350877192983,66,88,0.75,50,89,139,11,6,34,44,133,206,2013_Ryan Hollins
2013,Tayshaun Prince,SF,32,718,1640,0.4378048780487805,76,188,0.40425531914893614,642,1452,0.44214876033057854,192,260,0.7384615384615385,144,584,728,392,96,50,178,172,1704,2013_Tayshaun Prince
2013,Terrence Williams,SF,25,48,97,0.4948453608247423,5,15,0.3333333333333333,43,82,0.524390243902439,9,21,0.42857142857142855,4,40,44,38,11,2,22,13,110,2013_Terrence Williams
2013,Tobias Harris,SF-PF_SF_PF,20,466,1024,0.455078125,68,216,0.3148148148148148,398,808,0.49257425742574257,206,274,0.7518248175182481,146,428,574,138,64,88,132,240,1206,2013_Tobias Harris
2013,Travis Outlaw,SF,28,74,177,0.4180790960451977,14,50,0.28,60,127,0.47244094488188976,38,52,0.7307692307692307,17,44,61,21,11,8,19,35,200,2013_Travis Outlaw
2013,Tyrus Thomas,PF,26,48,136,0.35294117647058826,3,8,0.375,45,128,0.3515625,26,31,0.8387096774193549,16,44,60,19,14,15,17,51,125,2013_Tyrus Thomas
2013,Zaza Pachulia,C,28,114,241,0.4730290456431535,0,3,0.0,114,238,0.4789915966386555,78,103,0.7572815533980582,132,204,336,79,35,12,70,128,306,2013_Zaza Pachulia
2014,Andre Drummond,C,20,479,769,0.6228868660598179,0,2,0.0,479,767,0.6245110821382008,137,328,0.4176829268292683,440,631,1071,35,101,131,110,273,1095,2014_Andre Drummond
2014,Andre Roberson,SG,22,33,68,0.4852941176470588,2,13,0.15384615384615385,31,55,0.5636363636363636,7,10,0.7,36,58,94,15,19,10,19,74,75,2014_Andre Roberson
2014,Anthony Tolliver,PF,28,129,307,0.4201954397394137,102,247,0.41295546558704455,27,60,0.45,33,41,0.8048780487804879,33,135,168,42,19,15,23,82,393,2014_Anthony Tolliver
2014,Arinze Onuaku,PF,26,2,10,0.2,0,0,NaN,2,10,0.2,2,4,0.5,4,12,16,6,0,0,2,6,6,2014_Arinze Onuaku
2014,Jan Vesely,PF,23,178,346,0.5144508670520231,0,0,NaN,178,346,0.5144508670520231,38,112,0.3392857142857143,162,220,382,42,106,70,72,242,394,2014_Jan Vesely
2014,Jerryd Bayless,PG,25,496,1234,0.4019448946515397,152,424,0.3584905660377358,344,810,0.4246913580246914,188,236,0.7966101694915254,44,246,290,388,120,18,164,322,1332,2014_Jerryd Bayless
2014,Jon Leuer,PF,24,121,246,0.491869918699187,23,49,0.46938775510204084,98,197,0.49746192893401014,37,47,0.7872340425531915,37,121,158,20,18,13,27,63,302,2014_Jon Leuer
2014,Kyrie Irving,PG,21,532,1237,0.43007275666936134,123,344,0.35755813953488375,409,893,0.458006718924972,291,338,0.8609467455621301,52,207,259,433,108,23,190,163,1478,2014_Kyrie Irving
2014,Mike Harris,PF,30,29,61,0.47540983606557374,0,2,0.0,29,59,0.4915254237288136,26,27,0.9629629629629629,15,18,33,5,16,7,11,36,84,2014_Mike Harris
2014,Mo Williams,PG,31,280,672,0.4166666666666667,83,225,0.3688888888888889,197,447,0.4407158836689038,78,89,0.8764044943820225,42,111,153,321,55,10,149,197,721,2014_Mo Williams
2014,Nick Calathes,SG,24,142,311,0.4565916398713826,19,61,0.3114754098360656,123,250,0.492,44,72,0.6111111111111112,23,114,137,207,66,8,101,117,347,2014_Nick Calathes
2014,Otto Porter,SF,20,33,91,0.3626373626373626,4,21,0.19047619047619047,29,70,0.4142857142857143,8,12,0.6666666666666666,21,36,57,10,8,1,14,26,78,2014_Otto Porter
2014,Ronnie Brewer,SF,28,6,30,0.2,2,16,0.125,4,14,0.2857142857142857,0,4,0.0,4,24,28,20,12,2,4,8,14,2014_Ronnie Brewer
2014,Tayshaun Prince,SF,33,200,492,0.4065040650406504,20,69,0.2898550724637681,180,423,0.425531914893617,34,60,0.5666666666666667,32,202,234,119,39,19,41,63,454,2014_Tayshaun Prince
2014,Tobias Harris,PF,21,332,716,0.46368715083798884,32,126,0.25396825396825395,300,590,0.5084745762711864,197,244,0.8073770491803278,88,336,424,82,41,24,78,143,893,2014_Tobias Harris
2014,Travis Outlaw,SF,29,130,326,0.3987730061349693,41,117,0.3504273504273504,89,209,0.4258373205741627,42,52,0.8076923076923077,36,132,168,48,20,19,26,94,343,2014_Travis Outlaw
2014,Zaza Pachulia,C,29,149,349,0.4269340974212034,0,1,0.0,149,348,0.4281609195402299,110,130,0.8461538461538461,141,192,333,136,45,14,92,124,408,2014_Zaza Pachulia
2015,Amir Johnson,PF,27,298,519,0.5741811175337187,19,46,0.41304347826086957,279,473,0.5898520084566596,79,129,0.6124031007751938,159,297,456,117,44,59,110,225,694,2015_Amir Johnson
2015,Arinze Onuaku,C,27,12,14,0.8571428571428571,0,0,NaN,12,14,0.8571428571428571,3,8,0.375,7,14,21,4,1,3,2,6,27,2015_Arinze Onuaku
2015,Brandon Davies,PF,23,110,274,0.40145985401459855,16,68,0.23529411764705882,94,206,0.4563106796116505,48,74,0.6486486486486487,76,90,166,60,36,14,58,118,284,2015_Brandon Davies
2015,Damjan Rudez,SF,28,119,263,0.4524714828897338,69,170,0.40588235294117647,50,93,0.5376344086021505,16,23,0.6956521739130435,8,39,47,53,16,5,47,79,323,2015_Damjan Rudez
2015,DeAndre Jordan,C,26,379,534,0.7097378277153558,1,4,0.25,378,530,0.7132075471698113,187,471,0.3970276008492569,397,829,1226,61,81,183,109,245,946,2015_DeAndre Jordan
2015,Dwight Powell,PF,23,62,134,0.4626865671641791,6,22,0.2727272727272727,56,112,0.5,50,66,0.7575757575757576,36,64,100,18,18,12,22,80,180,2015_Dwight Powell
2015,Jon Leuer,PF,25,121,273,0.4432234432234432,7,29,0.2413793103448276,114,244,0.4672131147540984,37,59,0.6271186440677966,50,157,207,46,17,9,35,86,286,2015_Jon Leuer
2015,Kentavious Caldwell-Pope,SG,21,390,972,0.4012345679012346,153,444,0.34459459459459457,237,528,0.44886363636363635,110,158,0.6962025316455697,46,209,255,109,93,18,94,161,1043,2015_Kentavious Caldwell-Pope
2015,Malcolm Lee,SG,24,0,1,0.0,0,0,NaN,0,1,0.0,0,0,NaN,0,0,0,0,0,0,0,0,0,2015_Malcolm Lee
2015,Mo Williams,PG,32,682,1720,0.39651162790697675,238,696,0.34195402298850575,444,1024,0.43359375,326,374,0.8716577540106952,44,304,348,848,92,28,344,324,1928,2015_Mo Williams
2015,Nick Calathes,SG,25,104,247,0.42105263157894735,11,43,0.2558139534883721,93,204,0.45588235294117646,24,45,0.5333333333333333,19,87,106,146,63,5,61,100,243,2015_Nick Calathes
2015,Otto Porter,SF,21,176,391,0.45012787723785164,35,104,0.33653846153846156,141,287,0.4912891986062718,58,79,0.7341772151898734,70,151,221,65,44,30,52,97,445,2015_Otto Porter
2015,Tayshaun Prince,SF,34,354,804,0.44029850746268656,62,134,0.4626865671641791,292,670,0.43582089552238806,98,130,0.7538461538461538,104,316,420,186,58,32,70,110,868,2015_Tayshaun Prince
2015,Tobias Harris,SF,22,442,949,0.4657534246575342,87,239,0.36401673640167365,355,710,0.5,193,245,0.7877551020408163,73,357,430,124,69,36,115,134,1164,2015_Tobias Harris
2016,Andrea Bargnani,C,30,127,279,0.4551971326164875,3,16,0.1875,124,263,0.4714828897338403,47,57,0.8245614035087719,28,69,97,18,4,9,26,61,304,2016_Andrea Bargnani
2016,Anthony Brown,SF,23,39,126,0.30952380952380953,20,70,0.2857142857142857,19,56,0.3392857142857143,17,20,0.85,9,61,70,19,14,5,15,34,115,2016_Anthony Brown
2016,Doug McDermott,SF,24,291,644,0.4518633540372671,110,259,0.4247104247104247,181,385,0.4701298701298701,72,84,0.8571428571428571,37,158,195,59,14,6,53,127,764,2016_Doug McDermott
2016,Dwight Powell,PF,24,146,296,0.49324324324324326,2,16,0.125,144,280,0.5142857142857142,105,142,0.7394366197183099,84,189,273,44,36,24,40,118,399,2016_Dwight Powell
2016,Jon Leuer,PF,26,224,466,0.48068669527896996,42,110,0.38181818181818183,182,356,0.5112359550561798,77,101,0.7623762376237624,76,297,373,72,38,30,75,125,567,2016_Jon Leuer
2016,Mo Williams,PG,33,132,302,0.4370860927152318,36,102,0.35294117647058826,96,200,0.48,38,42,0.9047619047619048,6,66,72,98,14,5,57,60,338,2016_Mo Williams
2016,Otto Porter,SF,22,339,717,0.47280334728033474,98,267,0.36704119850187267,241,450,0.5355555555555556,95,126,0.753968253968254,97,294,391,120,105,32,70,163,871,2016_Otto Porter
2016,Richaun Holmes,PF,22,114,222,0.5135135135135135,8,44,0.18181818181818182,106,178,0.5955056179775281,51,74,0.6891891891891891,62,73,135,33,19,40,32,92,287,2016_Richaun Holmes
2016,Shabazz Muhammad,SF,23,317,681,0.4654919236417034,44,152,0.2894736842105263,273,529,0.5160680529300568,185,242,0.7644628099173554,100,167,267,52,24,7,70,94,863,2016_Shabazz Muhammad
2016,Taj Gibson,PF,30,263,500,0.526,0,3,0.0,263,497,0.5291750503018109,101,146,0.6917808219178082,206,298,504,106,47,77,78,180,627,2016_Taj Gibson
2016,Tayshaun Prince,SF,35,102,229,0.44541484716157204,4,23,0.17391304347826086,98,206,0.47572815533980584,13,19,0.6842105263157895,32,115,147,73,36,13,27,62,221,2016_Tayshaun Prince
2016,Tobias Harris,PF,23,834,1778,0.46906636670416196,160,478,0.33472803347280333,674,1300,0.5184615384615384,404,486,0.831275720164609,192,828,1020,338,130,80,216,306,2232,2016_Tobias Harris
2017,Anthony Brown,SF,24,36,100,0.36,14,54,0.25925925925925924,22,46,0.4782608695652174,0,0,NaN,16,50,66,16,10,2,12,30,86,2017_Anthony Brown
2017,Arinze Onuaku,C,29,2,4,0.5,0,0,NaN,2,4,0.5,0,0,NaN,2,4,6,2,0,1,2,3,4,2017_Arinze Onuaku
2017,Chinanu Onuaku,C,20,5,7,0.7142857142857143,0,0,NaN,5,7,0.7142857142857143,4,4,1.0,2,8,10,3,3,1,4,6,14,2017_Chinanu Onuaku
2017,Chris McCullough,PF,21,32,64,0.5,2,14,0.14285714285714285,30,50,0.6,6,10,0.6,18,20,38,4,4,4,6,14,72,2017_Chris McCullough
2017,Delon Wright,PG,24,49,116,0.4224137931034483,10,30,0.3333333333333333,39,86,0.45348837209302323,42,55,0.7636363636363637,16,32,48,57,27,11,25,31,150,2017_Delon Wright
2017,Derrick Rose,PG,28,460,977,0.47082906857727735,13,60,0.21666666666666667,447,917,0.48745910577971646,221,253,0.8735177865612648,66,180,246,283,44,17,147,84,1154,2017_Derrick Rose
2017,Dwight Powell,C,25,194,377,0.5145888594164456,21,74,0.28378378378378377,173,303,0.570957095709571,107,141,0.7588652482269503,93,213,306,49,61,39,34,135,516,2017_Dwight Powell
2017,Jerian Grant,PG,24,128,301,0.42524916943521596,49,134,0.3656716417910448,79,167,0.47305389221556887,65,73,0.8904109589041096,17,94,111,120,47,8,44,93,370,2017_Jerian Grant
2017,Jimmy Butler,SF,27,570,1252,0.45527156549520764,91,248,0.36693548387096775,479,1004,0.4770916334661355,585,676,0.8653846153846154,129,341,470,417,143,32,159,112,1816,2017_Jimmy Butler
2017,Jon Leuer,PF,27,310,646,0.47987616099071206,49,167,0.2934131736526946,261,479,0.5448851774530271,98,113,0.8672566371681416,102,300,402,111,31,26,66,145,767,2017_Jon Leuer
2017,Manny Harris,SG,27,3,15,0.2,0,2,0.0,3,13,0.23076923076923078,2,4,0.5,3,6,9,2,0,0,2,1,8,2017_Manny Harris
2017,Otto Porter,SF,23,414,803,0.5155666251556662,148,341,0.4340175953079179,266,462,0.5757575757575758,99,119,0.8319327731092437,118,397,515,121,116,41,43,193,1075,2017_Otto Porter
2017,Robert Covington,SF,26,292,732,0.3989071038251366,137,412,0.3325242718446602,155,320,0.484375,143,174,0.8218390804597702,92,344,436,102,127,69,131,203,864,2017_Robert Covington
2017,Shelvin Mack,PG,26,170,381,0.4461942257217848,37,120,0.30833333333333335,133,261,0.5095785440613027,53,77,0.6883116883116883,20,108,128,154,42,3,90,100,430,2017_Shelvin Mack
2017,Tobias Harris,PF,24,511,1063,0.48071495766698025,109,314,0.3471337579617834,402,749,0.5367156208277704,190,226,0.8407079646017699,63,353,416,142,60,39,95,133,1321,2017_Tobias Harris
2017,Troy Daniels,SG,25,185,495,0.37373737373737376,138,355,0.38873239436619716,47,140,0.3357142857142857,43,54,0.7962962962962963,21,79,100,46,21,4,45,90,551,2017_Troy Daniels
2017,Tyson Chandler,C,34,153,228,0.6710526315789473,0,0,NaN,153,228,0.6710526315789473,91,124,0.7338709677419355,154,385,539,30,33,24,67,126,397,2017_Tyson Chandler
2003,Bob Sura,SG,29,135,328,0.4115853658536585,28,85,0.32941176470588235,107,243,0.4403292181069959,103,148,0.6959459459459459,58,109,167,177,45,2,82,108,401,2003_Bob Sura
2003,Casey Jacobsen,SF,21,122,327,0.3730886850152905,52,165,0.3151515151515151,70,162,0.43209876543209874,72,105,0.6857142857142857,29,54,83,73,35,6,55,90,368,2003_Casey Jacobsen
2003,Chucky Atkins,PG,28,168,465,0.36129032258064514,86,242,0.35537190082644626,82,223,0.36771300448430494,40,49,0.8163265306122449,21,75,96,175,27,4,77,108,462,2003_Chucky Atkins
2003,Kevin Ollie,PG,30,398,882,0.4512471655328798,4,12,0.3333333333333333,394,870,0.4528735632183908,268,356,0.7528089887640449,50,314,364,582,138,10,144,244,1068,2003_Kevin Ollie
2003,Matt Harpring,SF,26,521,1020,0.5107843137254902,66,160,0.4125,455,860,0.5290697674418605,262,331,0.7915407854984894,190,324,514,133,73,17,160,217,1370,2003_Matt Harpring
2003,Mike James,PG,27,218,585,0.37264957264957266,67,228,0.29385964912280704,151,357,0.42296918767507,104,142,0.7323943661971831,26,123,149,246,64,5,108,176,607,2003_Mike James
2003,Oscar Torres,SG,26,16,36,0.4444444444444444,7,13,0.5384615384615384,9,23,0.391304347826087,14,20,0.7,3,9,12,3,4,2,8,9,53,2003_Oscar Torres
2003,Ray Allen,SG,27,1196,2726,0.4387380777696258,402,1066,0.3771106941838649,794,1660,0.4783132530120482,632,690,0.9159420289855073,188,574,762,668,206,28,396,440,3426,2003_Ray Allen
2003,Robert Horry,PF,32,184,476,0.3865546218487395,51,177,0.288135593220339,133,299,0.44481605351170567,103,134,0.7686567164179104,181,333,514,233,96,61,112,247,522,2003_Robert Horry
2003,Troy Hudson,PG,26,409,956,0.42782426778242677,97,266,0.36466165413533835,312,690,0.45217391304347826,208,231,0.9004329004329005,42,141,183,452,60,7,182,160,1123,2003_Troy Hudson
2003,Troy Murphy,PF,22,338,749,0.4512683578104139,3,14,0.21428571428571427,335,735,0.4557823129251701,244,290,0.8413793103448276,228,578,806,106,65,30,111,246,923,2003_Troy Murphy
2003,Zach Randolph,PF,21,264,515,0.512621359223301,0,5,0.0,264,510,0.5176470588235295,122,161,0.7577639751552795,139,204,343,41,42,14,62,141,650,2003_Zach Randolph
2003,Zydrunas Ilgauskas,C,27,495,1122,0.4411764705882353,0,5,0.0,495,1117,0.4431512981199642,400,512,0.78125,240,371,611,127,56,152,210,274,1390,2003_Zydrunas Ilgauskas
2004,Brian Cardinal,PF,26,220,466,0.4721030042918455,55,124,0.4435483870967742,165,342,0.4824561403508772,238,271,0.8782287822878229,100,217,317,103,66,20,84,206,733,2004_Brian Cardinal
2004,Chucky Atkins,PG,29,384,968,0.39669421487603307,162,482,0.3360995850622407,222,486,0.4567901234567901,146,194,0.7525773195876289,18,168,186,446,90,4,184,204,1076,2004_Chucky Atkins
2004,Donnell Harvey,PF,23,178,402,0.4427860696517413,0,6,0.0,178,396,0.4494949494949495,122,166,0.7349397590361446,96,232,328,42,48,54,90,258,478,2004_Donnell Harvey
2004,Kevin Ollie,PG,31,95,257,0.36964980544747084,4,9,0.4444444444444444,91,248,0.36693548387096775,147,176,0.8352272727272727,23,147,170,234,51,8,81,119,341,2004_Kevin Ollie
2004,Kyle Korver,SF,22,115,327,0.3516819571865443,81,207,0.391304347826087,34,120,0.2833333333333333,19,24,0.7916666666666666,30,81,111,40,25,8,41,102,330,2004_Kyle Korver
2004,Matt Harpring,SF,27,193,410,0.47073170731707314,8,33,0.24242424242424243,185,377,0.4907161803713528,108,157,0.6878980891719745,91,156,247,63,22,2,65,102,502,2004_Matt Harpring
2004,Melvin Ely,PF,25,66,153,0.43137254901960786,0,1,0.0,66,152,0.4342105263157895,25,42,0.5952380952380952,48,53,101,22,9,17,20,68,157,2004_Melvin Ely
2004,Mike Wilks,PG,24,17,36,0.4722222222222222,6,10,0.6,11,26,0.4230769230769231,10,12,0.8333333333333334,3,13,16,17,3,0,7,15,50,2004_Mike Wilks
2004,Rasho Nesterovic,C,27,328,700,0.4685714285714286,0,0,NaN,328,700,0.4685714285714286,54,114,0.47368421052631576,257,376,633,114,51,165,107,247,710,2004_Rasho Nesterovic
2004,Ray Allen,SG,28,447,1017,0.43952802359882004,148,378,0.3915343915343915,299,639,0.4679186228482003,245,271,0.9040590405904059,69,217,286,268,71,11,156,132,1287,2004_Ray Allen
2004,Tim Duncan,PF,27,592,1181,0.5012701100762066,2,12,0.16666666666666666,590,1169,0.504704875962361,352,588,0.5986394557823129,227,632,859,213,62,185,183,164,1538,2004_Tim Duncan
2004,Troy Hudson,PG,27,80,207,0.3864734299516908,31,77,0.4025974025974026,49,130,0.3769230769230769,27,33,0.8181818181818182,4,31,35,70,7,0,34,32,218,2004_Troy Hudson
2004,Troy Murphy,PF,23,107,243,0.4403292181069959,5,17,0.29411764705882354,102,226,0.45132743362831856,60,80,0.75,48,125,173,20,12,17,34,58,279,2004_Troy Murphy
2004,Zach Randolph,PF,22,663,1368,0.48464912280701755,1,5,0.2,662,1363,0.4856933235509905,299,393,0.7608142493638677,242,609,851,163,68,41,247,227,1626,2004_Zach Randolph
2005,Al Jefferson,PF,20,195,369,0.5284552845528455,0,3,0.0,195,366,0.5327868852459017,85,135,0.6296296296296297,119,193,312,24,22,55,66,195,475,2005_Al Jefferson
2005,Bruno Sundov,C,24,11,37,0.2972972972972973,1,3,0.3333333333333333,10,34,0.29411764705882354,2,2,1.0,6,7,13,2,2,2,6,16,25,2005_Bruno Sundov
2005,Chris Duhon,PG,22,172,488,0.3524590163934426,94,265,0.35471698113207545,78,223,0.34977578475336324,49,67,0.7313432835820896,23,190,213,398,82,3,119,205,487,2005_Chris Duhon
2005,Corey Maggette,SG,25,425,986,0.43103448275862066,51,168,0.30357142857142855,374,818,0.4572127139364303,563,657,0.8569254185692542,70,324,394,225,70,8,195,191,1464,2005_Corey Maggette
2005,Dale Davis,C,35,224,468,0.47863247863247865,0,0,NaN,224,468,0.47863247863247865,120,198,0.6060606060606061,304,446,750,94,64,130,86,324,568,2005_Dale Davis
2005,Kevin Ollie,PG,32,11,31,0.3548387096774194,0,0,NaN,11,31,0.3548387096774194,6,9,0.6666666666666666,3,16,19,19,5,0,6,16,28,2005_Kevin Ollie
2005,Kyle Korver,SF,23,317,759,0.4176548089591568,226,558,0.4050179211469534,91,201,0.4527363184079602,82,96,0.8541666666666666,40,339,379,182,103,33,106,265,942,2005_Kyle Korver
2005,Matt Harpring,SF,28,418,855,0.4888888888888889,9,43,0.20930232558139536,409,812,0.5036945812807881,245,315,0.7777777777777778,196,284,480,142,70,16,133,250,1090,2005_Matt Harpring
2005,Peter John,C,19,5,10,0.5,0,0,NaN,5,10,0.5,1,2,0.5,1,3,4,0,0,1,3,4,11,2005_Peter John
2005,Ray Allen,SG,29,640,1494,0.428380187416332,209,556,0.37589928057553956,431,938,0.4594882729211087,378,428,0.883177570093458,79,268,347,289,84,5,171,167,1867,2005_Ray Allen
2005,Reece Gaines,PG,24,34,100,0.34,8,28,0.2857142857142857,26,72,0.3611111111111111,6,8,0.75,2,26,28,14,10,2,14,34,82,2005_Reece Gaines
2005,Troy Hudson,PG,28,266,664,0.4006024096385542,89,258,0.3449612403100775,177,406,0.43596059113300495,70,90,0.7777777777777778,19,86,105,283,27,6,113,121,691,2005_Troy Hudson
2005,Troy Murphy,PF,24,392,947,0.4139387539598733,59,148,0.39864864864864863,333,799,0.4167709637046308,233,319,0.7304075235109718,251,505,756,97,53,33,108,190,1076,2005_Troy Murphy
2005,Vitaly Potapenko,C,29,45,87,0.5172413793103449,0,1,0.0,45,86,0.5232558139534884,27,31,0.8709677419354839,30,48,78,9,7,3,12,53,117,2005_Vitaly Potapenko
2005,Zach Randolph,PF,23,332,741,0.44804318488529016,0,6,0.0,332,735,0.45170068027210886,207,254,0.8149606299212598,142,300,442,86,34,17,112,112,871,2005_Zach Randolph
2006,Andre Miller,PG,29,404,872,0.463302752293578,5,27,0.18518518518518517,399,845,0.47218934911242605,313,424,0.7382075471698113,92,259,351,674,106,18,256,213,1126,2006_Andre Miller
2006,Arvydas Macijauskas,SG,26,14,41,0.34146341463414637,3,12,0.25,11,29,0.3793103448275862,13,15,0.8666666666666667,3,7,10,5,7,0,8,10,44,2006_Arvydas Macijauskas
2006,Austin Croshere,PF,30,132,285,0.4631578947368421,54,140,0.38571428571428573,78,145,0.5379310344827586,90,102,0.8823529411764706,62,203,265,62,22,7,48,105,408,2006_Austin Croshere
2006,Chris Duhon,PG,23,215,538,0.3996282527881041,100,278,0.3597122302158273,115,260,0.4423076923076923,117,143,0.8181818181818182,28,192,220,373,70,3,117,152,647,2006_Chris Duhon
2006,David West,PF,25,530,1036,0.5115830115830116,3,11,0.2727272727272727,527,1025,0.5141463414634146,199,236,0.8432203389830508,168,380,548,92,61,64,105,214,1262,2006_David West
2006,Derrick Zimmerman,PG,24,2,3,0.6666666666666666,0,0,NaN,2,3,0.6666666666666666,0,0,NaN,1,3,4,7,0,0,4,4,4,2006_Derrick Zimmerman
2006,Eddie Basden,SF,22,15,37,0.40540540540540543,1,7,0.14285714285714285,14,30,0.4666666666666667,8,10,0.8,7,21,28,8,9,2,9,17,39,2006_Eddie Basden
2006,Jason Williams,PG,30,268,606,0.44224422442244227,107,288,0.3715277777777778,161,318,0.5062893081761006,85,98,0.8673469387755102,6,133,139,287,53,5,100,101,728,2006_Jason Williams
2006,Kevin Ollie,SG,33,75,174,0.43103448275862066,1,3,0.3333333333333333,74,171,0.4327485380116959,41,49,0.8367346938775511,13,85,98,101,33,3,29,103,192,2006_Kevin Ollie
2006,Kyle Korver,SF,24,327,761,0.4296977660972405,184,438,0.4200913242009132,143,323,0.44272445820433437,101,119,0.8487394957983193,27,243,270,163,65,26,98,224,939,2006_Kyle Korver
2006,Marcus Banks,PG,24,438,936,0.46794871794871795,44,126,0.3492063492063492,394,810,0.48641975308641977,236,294,0.8027210884353742,46,224,270,440,108,22,238,324,1156,2006_Marcus Banks
2006,Mark Blount,C,30,746,1468,0.5081743869209809,0,0,NaN,746,1468,0.5081743869209809,336,444,0.7567567567567568,192,538,730,198,80,152,388,508,1828,2006_Mark Blount
2006,Matt Harpring,SF,29,322,678,0.4749262536873156,14,39,0.358974358974359,308,639,0.48200312989045385,227,313,0.7252396166134185,158,210,368,98,59,14,109,202,885,2006_Matt Harpring
2006,Randy Livingston,PG,30,0,2,0.0,0,0,NaN,0,2,0.0,0,0,NaN,1,3,4,1,1,0,1,6,0,2006_Randy Livingston
2006,Royal Ivey,PG,24,116,264,0.4393939393939394,4,10,0.4,112,254,0.4409448818897638,24,33,0.7272727272727273,31,65,96,74,24,7,23,147,260,2006_Royal Ivey
2006,Sharrod Ford,PF,24,2,3,0.6666666666666666,0,0,NaN,2,3,0.6666666666666666,0,0,NaN,1,2,3,0,0,1,2,7,4,2006_Sharrod Ford
2006,Stephen Graham,SG,23,42,108,0.3888888888888889,4,20,0.2,38,88,0.4318181818181818,28,30,0.9333333333333333,10,44,54,14,10,4,26,62,116,2006_Stephen Graham
2006,Troy Hudson,PG,29,127,333,0.3813813813813814,40,101,0.39603960396039606,87,232,0.375,48,52,0.9230769230769231,8,36,44,106,12,4,40,55,342,2006_Troy Hudson
2006,Troy Murphy,PF,25,363,838,0.4331742243436754,58,181,0.32044198895027626,305,657,0.4642313546423135,251,319,0.786833855799373,195,548,743,101,47,26,108,191,1035,2006_Troy Murphy
2006,Tyronn Lue,PG,28,192,418,0.45933014354066987,58,127,0.4566929133858268,134,291,0.46048109965635736,118,138,0.855072463768116,13,69,82,157,26,3,75,113,560,2006_Tyronn Lue
2006,Zach Randolph,PF,24,536,1229,0.43612693246541906,16,55,0.2909090909090909,520,1174,0.44293015332197616,245,343,0.7142857142857143,193,399,592,144,57,14,165,185,1333,2006_Zach Randolph
2007,Austin Croshere,PF,31,78,222,0.35135135135135137,26,91,0.2857142857142857,52,131,0.3969465648854962,45,52,0.8653846153846154,33,153,186,44,14,6,33,68,227,2007_Austin Croshere
2007,Chris Duhon,PG,24,197,483,0.4078674948240166,88,245,0.35918367346938773,109,238,0.4579831932773109,76,101,0.7524752475247525,23,146,169,310,69,6,105,150,558,2007_Chris Duhon
2007,Chris Wilcox,PF,24,433,819,0.5286935286935287,0,6,0.0,433,813,0.5325953259532595,240,351,0.6837606837606838,178,451,629,82,70,38,127,248,1106,2007_Chris Wilcox
2007,Clifford Robinson,C,40,81,218,0.37155963302752293,25,66,0.3787878787878788,56,152,0.3684210526315789,16,36,0.4444444444444444,31,91,122,51,12,23,30,98,203,2007_Clifford Robinson
2007,Eddy Curry,C,24,585,1016,0.5757874015748031,1,1,1.0,584,1015,0.5753694581280788,405,659,0.6145675265553869,195,376,571,68,34,40,295,265,1576,2007_Eddy Curry
2007,James White,SG,24,18,41,0.43902439024390244,2,7,0.2857142857142857,16,34,0.47058823529411764,12,15,0.8,3,17,20,5,3,1,5,7,50,2007_James White
2007,Jeff McInnis,PG,32,71,181,0.39226519337016574,1,8,0.125,70,173,0.4046242774566474,22,32,0.6875,14,48,62,124,14,0,42,72,165,2007_Jeff McInnis
2007,Kevin Martin,SG,23,505,1067,0.4732895970009372,127,333,0.3813813813813814,378,734,0.5149863760217984,481,570,0.843859649122807,69,273,342,173,98,11,135,181,1618,2007_Kevin Martin
2007,Kevin Ollie,PG,34,81,187,0.43315508021390375,0,2,0.0,81,185,0.43783783783783786,37,45,0.8222222222222222,8,66,74,130,21,1,47,76,199,2007_Kevin Ollie
2007,Kyle Korver,SF,25,372,845,0.44023668639053254,132,307,0.42996742671009774,240,538,0.44609665427509293,191,209,0.9138755980861244,30,229,259,105,57,20,117,188,1067,2007_Kyle Korver
2007,Marc Jackson,PF,32,159,388,0.4097938144329897,0,1,0.0,159,387,0.4108527131782946,90,103,0.8737864077669902,62,130,192,58,21,7,65,89,408,2007_Marc Jackson
2007,Mark Blount,C,31,427,839,0.5089392133492253,9,31,0.2903225806451613,418,808,0.5173267326732673,147,195,0.7538461538461538,136,369,505,67,43,58,159,239,1010,2007_Mark Blount
2007,Maurice Ager,SG,22,22,70,0.3142857142857143,5,15,0.3333333333333333,17,55,0.3090909090909091,20,33,0.6060606060606061,1,20,21,7,4,3,15,27,69,2007_Maurice Ager
2007,Mouhamed Sene,C,20,18,49,0.3673469387755102,0,0,NaN,18,49,0.3673469387755102,17,29,0.5862068965517241,16,29,45,0,3,12,11,33,53,2007_Mouhamed Sene
2007,Rudy Gay,SF,20,321,760,0.42236842105263156,52,143,0.36363636363636365,269,617,0.4359805510534846,152,209,0.7272727272727273,93,255,348,100,71,74,140,192,846,2007_Rudy Gay
2007,Troy Murphy,PF,26,532,1162,0.4578313253012048,116,294,0.3945578231292517,416,868,0.4792626728110599,216,290,0.7448275862068966,200,628,828,252,92,84,156,392,1396,2007_Troy Murphy
2007,Zach Randolph,PF,25,600,1286,0.4665629860031104,14,48,0.2916666666666667,586,1238,0.47334410339256866,394,481,0.8191268191268192,199,489,688,147,53,15,215,184,1608,2007_Zach Randolph
2008,Austin Croshere,PF,32,61,137,0.44525547445255476,22,61,0.36065573770491804,39,76,0.5131578947368421,29,32,0.90625,33,71,104,30,8,6,22,60,173,2008_Austin Croshere
2008,Chris Andersen,C,29,2,7,0.2857142857142857,0,0,NaN,2,7,0.2857142857142857,2,4,0.5,2,7,9,0,0,4,1,6,6,2008_Chris Andersen
2008,Chris Duhon,PG,25,133,344,0.3866279069767442,54,155,0.34838709677419355,79,189,0.41798941798941797,65,80,0.8125,19,97,116,263,48,2,71,92,385,2008_Chris Duhon
2008,Eddie Gill,PG,29,24,62,0.3870967741935484,10,30,0.3333333333333333,14,32,0.4375,18,18,1.0,2,42,44,44,14,4,18,36,76,2008_Eddie Gill
2008,Gordan Giricek,SG,30,266,604,0.44039735099337746,72,198,0.36363636363636365,194,406,0.47783251231527096,46,52,0.8846153846153846,32,160,192,124,48,8,104,164,650,2008_Gordan Giricek
2008,Hilton Armstrong,C,23,67,148,0.4527027027027027,0,0,NaN,67,148,0.4527027027027027,44,70,0.6285714285714286,65,98,163,23,15,34,59,130,178,2008_Hilton Armstrong
2008,Jamal Crawford,SG,27,570,1391,0.4097771387491014,176,494,0.3562753036437247,394,897,0.43924191750278707,329,381,0.863517060367454,37,170,207,398,81,17,192,144,1645,2008_Jamal Crawford
2008,Jerry Stackhouse,SG,33,213,526,0.4049429657794677,60,184,0.32608695652173914,153,342,0.4473684210526316,132,148,0.8918918918918919,33,100,133,145,28,10,86,82,618,2008_Jerry Stackhouse
2008,Kevin Ollie,SG,35,29,69,0.42028985507246375,0,1,0.0,29,68,0.4264705882352941,12,15,0.8,4,15,19,38,10,0,5,28,70,2008_Kevin Ollie
2008,Kyle Korver,SG_PF_SG-PF,26,510,1150,0.4434782608695652,222,592,0.375,288,558,0.5161290322580645,238,260,0.9153846153846154,42,302,344,202,84,58,150,384,1480,2008_Kyle Korver
2008,Kyrylo Fesenko,C,21,6,16,0.375,0,0,NaN,6,16,0.375,2,4,0.5,14,11,25,2,0,3,8,19,14,2008_Kyrylo Fesenko
2008,Mark Blount,C,32,238,515,0.4621359223300971,17,44,0.38636363636363635,221,471,0.4692144373673036,88,138,0.6376811594202898,69,194,263,41,33,34,70,133,581,2008_Mark Blount
2008,Mike Conley,PG,20,189,442,0.4276018099547511,30,91,0.32967032967032966,159,351,0.452991452991453,90,123,0.7317073170731707,21,118,139,222,44,2,89,85,498,2008_Mike Conley
2008,Mouhamed Sene,C,21,11,24,0.4583333333333333,0,0,NaN,11,24,0.4583333333333333,8,17,0.47058823529411764,7,9,16,1,0,7,0,9,30,2008_Mouhamed Sene
2008,Nick Fazekas,PF,22,92,164,0.5609756097560976,0,4,0.0,92,160,0.575,30,44,0.6818181818181818,68,110,178,22,16,22,26,50,214,2008_Nick Fazekas
2008,Ryan Hollins,PF,23,46,94,0.48936170212765956,0,0,NaN,46,94,0.48936170212765956,55,82,0.6707317073170732,53,54,107,14,10,30,25,96,147,2008_Ryan Hollins
2008,Steve Francis,PG,30,19,57,0.3333333333333333,4,17,0.23529411764705882,15,40,0.375,13,23,0.5652173913043478,8,15,23,30,9,5,14,25,55,2008_Steve Francis
2008,Troy Murphy,PF,27,315,693,0.45454545454545453,94,236,0.3983050847457627,221,457,0.48358862144420134,192,241,0.7966804979253111,108,435,543,165,49,32,96,217,916,2008_Troy Murphy
2008,Tyrus Thomas,PF,21,186,440,0.42272727272727273,1,6,0.16666666666666666,185,434,0.42626728110599077,129,174,0.7413793103448276,102,240,342,90,48,72,77,170,502,2008_Tyrus Thomas
2008,Zach Randolph,C,26,486,1058,0.45935727788279773,22,80,0.275,464,978,0.47443762781186094,223,289,0.7716262975778547,184,526,710,140,59,16,186,194,1217,2008_Zach Randolph
2009,Anthony Tolliver,PF,23,19,65,0.2923076923076923,9,41,0.21951219512195122,10,24,0.4166666666666667,5,10,0.5,12,29,41,17,5,1,7,16,52,2009_Anthony Tolliver
2009,Austin Croshere,PF,33,28,78,0.358974358974359,10,30,0.3333333333333333,18,48,0.375,14,24,0.5833333333333334,22,46,68,18,2,2,12,10,80,2009_Austin Croshere
2009,Chris Duhon,PG,26,287,681,0.42143906020558003,127,325,0.39076923076923076,160,356,0.449438202247191,179,209,0.8564593301435407,45,201,246,566,72,7,221,126,880,2009_Chris Duhon
2009,Fred Jones,SF,29,129,317,0.4069400630914827,54,147,0.3673469387755102,75,170,0.4411764705882353,66,81,0.8148148148148148,23,103,126,188,53,11,66,112,378,2009_Fred Jones
2009,Jake Voskuhl,C,31,12,45,0.26666666666666666,0,0,NaN,12,45,0.26666666666666666,11,14,0.7857142857142857,21,38,59,8,3,4,17,60,35,2009_Jake Voskuhl
2009,James White,SF,26,3,5,0.6,1,2,0.5,2,3,0.6666666666666666,0,0,NaN,0,0,0,1,1,1,3,2,7,2009_James White
2009,Jarron Collins,C,30,16,35,0.45714285714285713,0,0,NaN,16,35,0.45714285714285713,8,11,0.7272727272727273,20,17,37,7,2,1,9,35,40,2009_Jarron Collins
2009,Jerryd Bayless,PG,20,69,189,0.36507936507936506,7,27,0.25925925925925924,62,162,0.38271604938271603,83,103,0.8058252427184466,8,49,57,78,16,2,56,81,228,2009_Jerryd Bayless
2009,Kevin Ollie,PG,36,61,150,0.4066666666666667,0,1,0.0,61,149,0.40939597315436244,80,96,0.8333333333333334,13,62,75,117,19,4,34,79,202,2009_Kevin Ollie
2009,Kyle Korver,SF,27,245,560,0.4375,103,267,0.3857677902621723,142,293,0.48464163822525597,112,127,0.8818897637795275,35,223,258,137,47,30,90,170,705,2009_Kyle Korver
2009,Kyle Weaver,SG,22,113,246,0.45934959349593496,32,93,0.34408602150537637,81,153,0.5294117647058824,41,58,0.7068965517241379,31,99,130,101,47,25,69,81,299,2009_Kyle Weaver
2009,Larry Hughes,SF_SG_SF-SG,30,448,1114,0.4021543985637343,150,386,0.38860103626943004,298,728,0.40934065934065933,234,290,0.8068965517241379,32,286,318,238,144,28,142,192,1280,2009_Larry Hughes
2009,Mark Blount,C,33,30,78,0.38461538461538464,11,27,0.4074074074074074,19,51,0.37254901960784315,8,13,0.6153846153846154,10,31,41,4,1,7,14,17,79,2009_Mark Blount
2009,Mike Conley,PG,21,323,730,0.44246575342465755,88,217,0.4055299539170507,235,513,0.4580896686159844,161,197,0.817258883248731,25,251,276,354,90,8,143,146,895,2009_Mike Conley
2009,Mouhamed Sene,C,22,12,18,0.6666666666666666,0,0,NaN,12,18,0.6666666666666666,16,20,0.8,10,18,28,0,2,6,8,4,40,2009_Mouhamed Sene
2009,Troy Murphy,PF,28,364,767,0.4745762711864407,161,358,0.44972067039106145,203,409,0.4963325183374083,152,184,0.8260869565217391,146,715,861,172,58,34,114,226,1041,2009_Troy Murphy
2009,Yakhouba Diawara,SF,26,76,217,0.35023041474654376,51,163,0.3128834355828221,25,54,0.46296296296296297,10,19,0.5263157894736842,26,56,82,27,13,6,16,75,213,2009_Yakhouba Diawara
2009,Zach Randolph,C_PF_PF-C,27,830,1746,0.4753722794959908,64,194,0.32989690721649484,766,1552,0.49355670103092786,358,488,0.7336065573770492,314,694,1008,206,86,32,228,266,2082,2009_Zach Randolph
2010,Chase Budinger,SF,21,249,565,0.4407079646017699,92,249,0.36947791164658633,157,316,0.49683544303797467,67,87,0.7701149425287356,38,182,220,88,34,11,48,85,657,2010_Chase Budinger
2010,Chucky Atkins,PG,35,57,157,0.3630573248407643,22,73,0.3013698630136986,35,84,0.4166666666666667,25,27,0.9259259259259259,5,24,29,91,17,0,32,53,161,2010_Chucky Atkins
2010,DeShawn Stevenson,SG,28,92,326,0.2822085889570552,38,174,0.21839080459770116,54,152,0.35526315789473684,50,70,0.7142857142857143,22,160,182,112,32,12,60,148,272,2010_DeShawn Stevenson
2010,Dwyane Wade,SG,28,719,1511,0.4758438120450033,73,243,0.3004115226337449,646,1268,0.5094637223974764,534,702,0.7606837606837606,107,266,373,501,142,82,252,181,2045,2010_Dwyane Wade
2010,Eric Gordon,SG,21,352,784,0.4489795918367347,119,321,0.3707165109034268,233,463,0.5032397408207343,222,299,0.7424749163879598,25,135,160,186,69,14,144,96,1045,2010_Eric Gordon
2010,Jared Dudley,SF,24,225,490,0.45918367346938777,120,262,0.4580152671755725,105,228,0.4605263157894737,104,138,0.7536231884057971,99,182,281,115,81,16,68,162,674,2010_Jared Dudley
2010,Joakim Noah,C,24,262,520,0.5038461538461538,0,0,NaN,262,520,0.5038461538461538,163,219,0.7442922374429224,220,484,704,132,32,100,117,198,687,2010_Joakim Noah
2010,Jonas Jerebko,PF,22,290,603,0.48092868988391374,36,115,0.3130434782608696,254,488,0.5204918032786885,125,176,0.7102272727272727,194,284,478,58,79,29,82,230,741,2010_Jonas Jerebko
2010,Michael Beasley,PF,21,468,1040,0.45,28,102,0.27450980392156865,440,938,0.4690831556503198,192,240,0.8,123,375,498,100,80,49,131,221,1156,2010_Michael Beasley
2010,Pau Gasol,C,29,452,844,0.5355450236966824,0,5,0.0,452,839,0.5387365911799762,286,362,0.7900552486187845,243,491,734,218,37,113,143,152,1190,2010_Pau Gasol
2010,Ray Allen,SG,34,464,973,0.47687564234326824,145,399,0.3634085213032581,319,574,0.5557491289198606,231,253,0.9130434782608695,45,208,253,210,64,25,129,182,1304,2010_Ray Allen
2011,Anthony Carter,PG,35,90,212,0.42452830188679247,24,80,0.3,66,132,0.5,16,16,1.0,14,88,102,138,54,12,78,98,220,2011_Anthony Carter
2011,Chauncey Billups,PG,34,678,1588,0.4269521410579345,292,726,0.4022038567493113,386,862,0.44779582366589327,768,838,0.9164677804295943,50,330,380,774,142,28,354,292,2416,2011_Chauncey Billups
2011,DeShawn Stevenson,SG,29,128,330,0.3878787878787879,94,249,0.37751004016064255,34,81,0.41975308641975306,33,43,0.7674418604651163,20,86,106,77,21,5,44,71,383,2011_DeShawn Stevenson
2011,Dwyane Wade,SG,29,692,1384,0.5,63,206,0.3058252427184466,629,1178,0.533955857385399,494,652,0.7576687116564417,123,362,485,346,111,87,237,197,1941,2011_Dwyane Wade
2011,Eric Gordon,SG,22,427,949,0.4499473129610116,106,291,0.3642611683848797,321,658,0.4878419452887538,287,348,0.8247126436781609,45,119,164,244,71,18,151,115,1247,2011_Eric Gordon
2011,Joakim Noah,C,25,211,402,0.5248756218905473,0,1,0.0,211,401,0.5261845386533666,139,188,0.7393617021276596,182,316,498,107,48,72,90,156,561,2011_Joakim Noah
2011,John Salmons,SG,31,373,898,0.4153674832962138,83,219,0.3789954337899543,290,679,0.4270986745213549,195,240,0.8125,27,239,266,252,72,28,137,157,1024,2011_John Salmons
2011,Jrue Holiday,PG,20,446,999,0.44644644644644643,81,222,0.36486486486486486,365,777,0.4697554697554698,172,209,0.8229665071770335,68,264,332,531,120,29,218,203,1145,2011_Jrue Holiday
2011,Michael Beasley,SF,22,561,1246,0.45024077046548955,60,164,0.36585365853658536,501,1082,0.4630314232902033,219,291,0.7525773195876289,118,291,409,158,54,52,195,222,1401,2011_Michael Beasley
2011,Quentin Richardson,SF,30,87,255,0.3411764705882353,42,146,0.2876712328767123,45,109,0.41284403669724773,33,44,0.75,39,139,178,38,25,5,33,74,249,2011_Quentin Richardson
2011,Ray Allen,SG,35,480,978,0.49079754601226994,168,378,0.4444444444444444,312,600,0.52,193,219,0.8812785388127854,51,223,274,219,77,16,117,147,1321,2011_Ray Allen
2011,Samuel Dalembert,C,29,268,567,0.47266313932980597,0,2,0.0,268,565,0.4743362831858407,108,148,0.7297297297297297,212,445,657,67,36,116,132,225,644,2011_Samuel Dalembert
2011,Steve Nash,PG,36,399,811,0.4919852034525277,81,205,0.3951219512195122,318,606,0.5247524752475248,227,249,0.9116465863453815,40,220,260,855,48,4,265,87,1106,2011_Steve Nash
2011,Taj Gibson,PF,25,234,502,0.46613545816733065,1,8,0.125,233,494,0.4716599190283401,100,148,0.6756756756756757,162,296,458,58,39,106,71,203,569,2011_Taj Gibson
2011,Troy Murphy,PF,30,84,228,0.3684210526315789,10,66,0.15151515151515152,74,162,0.4567901234567901,40,60,0.6666666666666666,44,182,226,46,30,6,40,94,218,2011_Troy Murphy
2012,Andray Blatche,PF,25,93,245,0.3795918367346939,2,7,0.2857142857142857,91,238,0.38235294117647056,33,49,0.673469387755102,42,108,150,28,20,17,37,54,221,2012_Andray Blatche
2012,Danilo Gallinari,SF,23,193,466,0.41416309012875535,60,183,0.32786885245901637,133,283,0.46996466431095407,182,209,0.8708133971291866,28,174,202,116,42,23,68,86,628,2012_Danilo Gallinari
2012,Eric Gordon,PG,23,63,140,0.45,10,40,0.25,53,100,0.53,49,65,0.7538461538461538,2,23,25,31,13,4,24,20,185,2012_Eric Gordon
2012,Jerome Jordan,C,25,17,33,0.5151515151515151,0,0,NaN,17,33,0.5151515151515151,8,10,0.8,14,13,27,4,1,6,2,15,42,2012_Jerome Jordan
2012,Joakim Noah,C,26,249,490,0.5081632653061224,0,1,0.0,249,489,0.50920245398773,154,206,0.7475728155339806,242,387,629,160,41,92,92,162,652,2012_Joakim Noah
2012,Jonas Jerebko,PF,24,212,453,0.46799116997792495,32,106,0.3018867924528302,180,347,0.5187319884726225,100,124,0.8064516129032258,96,212,308,43,41,21,66,162,556,2012_Jonas Jerebko
2012,Josh McRoberts,PF,24,56,118,0.4745762711864407,3,7,0.42857142857142855,53,111,0.4774774774774775,23,36,0.6388888888888888,61,110,171,51,15,18,31,74,138,2012_Josh McRoberts
2012,Kyle Korver,SG,30,178,412,0.4320388349514563,118,271,0.4354243542435424,60,141,0.425531914893617,55,66,0.8333333333333334,26,133,159,112,36,15,53,110,529,2012_Kyle Korver
2012,Lance Stephenson,SG,21,47,125,0.376,4,30,0.13333333333333333,43,95,0.45263157894736844,8,17,0.47058823529411764,12,41,53,46,21,5,36,30,106,2012_Lance Stephenson
2012,Michael Beasley,SF,23,221,497,0.44466800804828976,38,101,0.37623762376237624,183,396,0.4621212121212121,61,95,0.6421052631578947,39,168,207,45,18,19,80,83,541,2012_Michael Beasley
2012,Ray Allen,SG,36,226,493,0.45841784989858014,106,234,0.452991452991453,120,259,0.46332046332046334,97,106,0.9150943396226415,14,128,142,109,49,8,68,83,655,2012_Ray Allen
2012,Tony Allen,SG,30,210,448,0.46875,8,26,0.3076923076923077,202,422,0.4786729857819905,140,175,0.8,98,135,233,79,104,33,94,142,568,2012_Tony Allen
2012,Troy Murphy,PF,31,77,171,0.4502923976608187,28,67,0.417910447761194,49,104,0.47115384615384615,6,9,0.6666666666666666,40,151,191,51,15,16,26,98,188,2012_Troy Murphy
2012,Tyson Chandler,C,29,241,355,0.6788732394366197,0,2,0.0,241,353,0.6827195467422096,217,315,0.6888888888888889,212,400,612,56,56,89,102,186,699,2012_Tyson Chandler
2012,Zach Randolph,PF,30,132,285,0.4631578947368421,2,8,0.25,130,277,0.4693140794223827,58,88,0.6590909090909091,78,147,225,48,21,4,40,57,324,2012_Zach Randolph
2013,Brandon Bass,PF,27,286,589,0.4855687606112054,0,2,0.0,286,587,0.48722316865417375,129,150,0.86,129,296,425,84,44,64,80,188,701,2013_Brandon Bass
2013,Chris Duhon,PG,30,47,123,0.3821138211382114,33,91,0.3626373626373626,14,32,0.4375,6,13,0.46153846153846156,11,57,68,133,20,1,40,56,133,2013_Chris Duhon
2013,Emeka Okafor,C,30,328,687,0.4774381368267831,0,0,NaN,328,687,0.4774381368267831,109,191,0.5706806282722513,199,493,692,93,45,77,107,145,765,2013_Emeka Okafor
2013,Eric Gordon,SG,24,235,584,0.4023972602739726,56,173,0.3236994219653179,179,411,0.43552311435523117,187,222,0.8423423423423423,10,67,77,137,45,8,117,75,713,2013_Eric Gordon
2013,Fab Melo,C,22,3,6,0.5,0,0,NaN,3,6,0.5,1,4,0.25,0,3,3,0,2,2,1,7,7,2013_Fab Melo
2013,Gerald Henderson,SG,25,382,855,0.44678362573099417,33,100,0.33,349,755,0.46225165562913906,258,313,0.8242811501597445,55,195,250,177,68,34,108,149,1055,2013_Gerald Henderson
2013,James White,SF,30,50,116,0.43103448275862066,14,41,0.34146341463414637,36,75,0.48,11,19,0.5789473684210527,5,43,48,29,13,4,17,44,125,2013_James White
2013,Joakim Noah,C,27,303,630,0.48095238095238096,0,5,0.0,303,625,0.4848,178,237,0.7510548523206751,260,473,733,262,78,141,176,185,784,2013_Joakim Noah
2013,Jonas Jerebko,PF,25,142,316,0.44936708860759494,25,83,0.30120481927710846,117,233,0.5021459227467812,68,88,0.7727272727272727,68,117,185,43,38,8,42,90,377,2013_Jonas Jerebko
2013,Kyle Korver,SF,31,277,601,0.46089850249584025,189,414,0.45652173913043476,88,187,0.47058823529411764,67,78,0.8589743589743589,23,270,293,146,70,37,70,170,810,2013_Kyle Korver
2013,Kyle O'Quinn,C,22,101,197,0.5126903553299492,0,1,0.0,101,196,0.5153061224489796,30,45,0.6666666666666666,65,144,209,52,11,26,37,107,232,2013_Kyle O'Quinn
2013,Michael Beasley,SF,24,310,766,0.4046997389033943,45,144,0.3125,265,622,0.42604501607717044,94,126,0.746031746031746,52,230,282,111,31,34,144,107,759,2013_Michael Beasley
2013,Ray Allen,SG,37,292,651,0.4485407066052227,139,332,0.4186746987951807,153,319,0.47962382445141066,140,158,0.8860759493670886,40,177,217,135,67,15,103,129,863,2013_Ray Allen
2013,Terrence Jones,PF,21,43,94,0.4574468085106383,5,19,0.2631578947368421,38,75,0.5066666666666667,13,17,0.7647058823529411,28,37,65,15,12,19,13,21,104,2013_Terrence Jones
2013,Troy Murphy,PF,32,22,61,0.36065573770491804,11,35,0.3142857142857143,11,26,0.4230769230769231,10,11,0.9090909090909091,7,42,49,7,10,6,7,29,65,2013_Troy Murphy
2013,Zach Randolph,PF,31,471,1024,0.4599609375,2,23,0.08695652173913043,469,1001,0.46853146853146854,225,300,0.75,310,544,854,108,61,31,150,180,1169,2013_Zach Randolph
2014,A.J. Price,SG,27,19,46,0.41304347826086957,6,22,0.2727272727272727,13,24,0.5416666666666666,0,2,0.0,1,9,10,13,1,0,7,5,44,2014_A.J. Price
2014,Alex Len,C,20,33,78,0.4230769230769231,0,0,NaN,33,78,0.4230769230769231,20,31,0.6451612903225806,39,60,99,4,4,18,26,68,86,2014_Alex Len
2014,Dion Waiters,SG,22,430,993,0.43303121852970794,92,250,0.368,338,743,0.4549125168236878,161,235,0.6851063829787234,32,163,195,209,63,17,154,153,1113,2014_Dion Waiters
2014,Donald Sloan,SG,26,44,117,0.37606837606837606,10,42,0.23809523809523808,34,75,0.4533333333333333,12,20,0.6,4,40,44,50,10,1,22,19,110,2014_Donald Sloan
2014,Eric Gordon,SG,25,356,817,0.4357405140758874,101,258,0.39147286821705424,255,559,0.4561717352415027,175,223,0.7847533632286996,30,135,165,208,74,12,134,114,988,2014_Eric Gordon
2014,Joakim Noah,C,28,380,800,0.475,0,2,0.0,380,798,0.47619047619047616,247,335,0.7373134328358208,282,618,900,431,99,121,194,245,1007,2014_Joakim Noah
2014,Jonas Jerebko,PF,26,98,208,0.47115384615384615,31,74,0.4189189189189189,67,134,0.5,43,59,0.7288135593220338,51,124,175,39,21,6,43,85,270,2014_Jonas Jerebko
2014,Kyle Korver,SG,32,289,609,0.4745484400656814,185,392,0.4719387755102041,104,217,0.4792626728110599,87,94,0.925531914893617,22,260,282,208,70,24,102,147,850,2014_Kyle Korver
2014,Maalik Wayns,PG,22,1,2,0.5,0,0,NaN,1,2,0.5,0,0,NaN,0,2,2,2,2,0,0,4,2,2014_Maalik Wayns
2014,Michael Beasley,SF,25,177,355,0.49859154929577465,21,54,0.3888888888888889,156,301,0.5182724252491694,61,79,0.7721518987341772,31,141,172,42,23,21,57,93,436,2014_Michael Beasley
2014,Mike James,PG,38,5,21,0.23809523809523808,1,5,0.2,4,16,0.25,0,2,0.0,0,7,7,17,2,0,5,11,11,2014_Mike James
2014,Nick Young,SG,28,387,889,0.43532058492688414,135,350,0.38571428571428573,252,539,0.4675324675324675,235,285,0.8245614035087719,29,137,166,95,46,12,95,156,1144,2014_Nick Young
2014,Pero Antic,C,31,123,294,0.41836734693877553,56,171,0.32748538011695905,67,123,0.5447154471544715,50,66,0.7575757575757576,57,152,209,58,19,12,55,126,352,2014_Pero Antic
2014,Quincy Acy,SF,23,132,282,0.46808510638297873,8,30,0.26666666666666666,124,252,0.49206349206349204,70,106,0.660377358490566,144,288,432,56,46,52,60,244,342,2014_Quincy Acy
2014,Quincy Pondexter,SG,25,31,79,0.3924050632911392,11,34,0.3235294117647059,20,45,0.4444444444444444,21,26,0.8076923076923077,10,16,26,20,5,1,15,18,94,2014_Quincy Pondexter
2014,Ray Allen,SG,38,240,543,0.4419889502762431,116,309,0.37540453074433655,124,234,0.5299145299145299,105,116,0.9051724137931034,23,182,205,143,54,8,84,115,701,2014_Ray Allen
2014,Zach Randolph,PF,32,560,1198,0.4674457429048414,2,20,0.1,558,1178,0.47368421052631576,250,337,0.7418397626112759,265,530,795,200,54,23,183,210,1372,2014_Zach Randolph
2015,Cole Aldrich,C,26,144,301,0.47840531561461797,0,0,NaN,144,301,0.47840531561461797,50,64,0.78125,101,237,338,75,37,65,59,122,338,2015_Cole Aldrich
2015,Darrell Arthur,PF,26,155,384,0.4036458333333333,26,110,0.23636363636363636,129,274,0.4708029197080292,46,59,0.7796610169491526,53,118,171,57,48,26,47,146,382,2015_Darrell Arthur
2015,DeJuan Blair,PF,25,26,57,0.45614035087719296,0,0,NaN,26,57,0.45614035087719296,4,6,0.6666666666666666,16,40,56,3,7,1,13,41,56,2015_DeJuan Blair
2015,Eric Gordon,SG,26,285,694,0.4106628242074928,141,315,0.44761904761904764,144,379,0.37994722955145116,107,133,0.8045112781954887,28,131,159,229,50,14,122,145,818,2015_Eric Gordon
2015,Jerome Jordan,C,28,50,94,0.5319148936170213,0,0,NaN,50,94,0.5319148936170213,38,44,0.8636363636363636,52,53,105,13,8,15,22,58,138,2015_Jerome Jordan
2015,Joakim Noah,C,29,190,427,0.4449648711943794,0,2,0.0,190,425,0.4470588235294118,105,174,0.603448275862069,219,427,646,312,48,74,123,203,485,2015_Joakim Noah
2015,Jonas Jerebko,PF,27,338,758,0.44591029023746703,108,280,0.38571428571428573,230,478,0.4811715481171548,112,132,0.8484848484848485,186,378,564,142,92,36,88,270,896,2015_Jonas Jerebko
2015,Josh Smith,PF,29,828,1974,0.4194528875379939,144,456,0.3157894736842105,684,1518,0.4505928853754941,254,510,0.4980392156862745,304,756,1060,554,174,232,412,456,2054,2015_Josh Smith
2015,Kyle Korver,SG,33,292,600,0.4866666666666667,221,449,0.4922048997772829,71,151,0.47019867549668876,106,118,0.8983050847457628,15,289,304,196,52,42,107,140,911,2015_Kyle Korver
2015,Lucas Nogueira,C,22,2,8,0.25,0,0,NaN,2,8,0.25,2,4,0.5,2,9,11,1,2,0,2,6,6,2015_Lucas Nogueira
2015,Michael Beasley,PF,26,92,212,0.4339622641509434,8,34,0.23529411764705882,84,178,0.47191011235955055,20,26,0.7692307692307693,12,77,89,32,15,13,37,66,212,2015_Michael Beasley
2015,Tiago Splitter,C,30,169,303,0.5577557755775577,0,0,NaN,169,303,0.5577557755775577,90,120,0.75,91,161,252,78,35,37,60,103,428,2015_Tiago Splitter
2015,Tim Duncan,C,38,419,819,0.5115995115995116,2,7,0.2857142857142857,417,812,0.5135467980295566,230,311,0.7395498392282959,170,534,704,230,63,151,131,165,1070,2015_Tim Duncan
2015,Zach Randolph,PF,33,454,932,0.4871244635193133,7,20,0.35,447,912,0.4901315789473684,228,298,0.7651006711409396,225,522,747,153,69,14,156,175,1143,2015_Zach Randolph
2016,Al Jefferson,C,31,245,505,0.48514851485148514,0,0,NaN,245,505,0.48514851485148514,72,111,0.6486486486486487,57,244,301,70,30,41,34,117,562,2016_Al Jefferson
2016,Chris Copeland,PF,31,17,51,0.3333333333333333,10,36,0.2777777777777778,7,15,0.4666666666666667,6,7,0.8571428571428571,1,9,10,11,2,0,6,17,50,2016_Chris Copeland
2016,Eric Gordon,SG,27,231,552,0.41847826086956524,113,294,0.3843537414965986,118,258,0.4573643410852713,111,125,0.888,10,89,99,121,43,14,73,98,686,2016_Eric Gordon
2016,Jeff Green,SF,29,708,1648,0.42961165048543687,134,426,0.3145539906103286,574,1222,0.469721767594108,328,440,0.7454545454545455,148,516,664,276,116,80,186,328,1878,2016_Jeff Green
2016,Jonas Jerebko,PF,28,118,286,0.4125874125874126,43,108,0.39814814814814814,75,178,0.42134831460674155,61,78,0.782051282051282,77,211,288,62,20,24,52,137,340,2016_Jonas Jerebko
2016,Kyle Korver,SG,34,268,616,0.43506493506493504,158,397,0.3979848866498741,110,219,0.502283105022831,45,54,0.8333333333333334,14,246,260,164,60,35,98,161,739,2016_Kyle Korver
2016,Lou Williams,SG,29,283,693,0.4083694083694084,110,320,0.34375,173,373,0.46380697050938335,352,424,0.8301886792452831,31,138,169,167,62,19,107,107,1028,2016_Lou Williams
2016,Michael Beasley,PF,27,107,205,0.5219512195121951,3,9,0.3333333333333333,104,196,0.5306122448979592,38,49,0.7755102040816326,29,69,98,16,11,9,24,39,255,2016_Michael Beasley
2016,Nemanja Bjelica,PF,27,110,235,0.46808510638297873,48,125,0.384,62,110,0.5636363636363636,40,55,0.7272727272727273,49,161,210,83,26,21,47,154,308,2016_Nemanja Bjelica
2016,Zach Randolph,PF,34,431,907,0.47519294377067256,6,26,0.23076923076923078,425,881,0.48240635641316687,172,216,0.7962962962962963,179,350,529,142,43,13,105,146,1040,2016_Zach Randolph
2017,Ben McLemore,SG,23,180,419,0.4295942720763723,65,170,0.38235294117647056,115,249,0.46184738955823296,70,93,0.7526881720430108,19,111,130,51,29,6,62,108,495,2017_Ben McLemore
2017,Corey Brewer,SF,30,294,696,0.4224137931034483,54,236,0.2288135593220339,240,460,0.5217391304347826,100,136,0.7352941176470589,64,268,332,194,122,38,110,266,742,2017_Corey Brewer
2017,Damian Lillard,PG,26,661,1488,0.4442204301075269,214,578,0.370242214532872,447,910,0.4912087912087912,488,545,0.8954128440366973,46,322,368,439,68,20,197,152,2024,2017_Damian Lillard
2017,David West,C,36,135,252,0.5357142857142857,3,8,0.375,132,244,0.5409836065573771,43,56,0.7678571428571429,47,156,203,151,42,48,78,105,316,2017_David West
2017,Eric Gordon,SG,28,412,1016,0.40551181102362205,246,661,0.3721633888048411,166,355,0.4676056338028169,147,175,0.84,29,172,201,188,48,40,121,150,1217,2017_Eric Gordon
2017,Ersan Ilyasova,PF,29,768,1780,0.4314606741573034,284,804,0.35323383084577115,484,976,0.4959016393442623,322,414,0.7777777777777778,230,732,962,282,116,46,232,422,2142,2017_Ersan Ilyasova
2017,J.J. Barea,PG,32,142,343,0.4139941690962099,53,148,0.3581081081081081,89,195,0.4564102564102564,44,51,0.8627450980392157,9,75,84,193,14,1,63,30,381,2017_J.J. Barea
2017,Jakob Poeltl,C,21,67,115,0.5826086956521739,0,0,NaN,67,115,0.5826086956521739,31,57,0.543859649122807,78,87,165,12,17,20,29,113,165,2017_Jakob Poeltl
2017,Jarnell Stokes,C,23,1,1,1.0,0,0,NaN,1,1,1.0,1,2,0.5,1,1,2,2,1,0,0,3,3,2017_Jarnell Stokes
2017,Jonas Jerebko,PF,29,114,262,0.4351145038167939,45,130,0.34615384615384615,69,132,0.5227272727272727,26,37,0.7027027027027027,60,213,273,71,26,17,39,122,299,2017_Jonas Jerebko
2017,Kevin Seraphin,PF,27,109,198,0.5505050505050505,0,2,0.0,109,196,0.5561224489795918,14,22,0.6363636363636364,41,101,142,23,7,20,29,66,232,2017_Kevin Seraphin
2017,Kosta Koufos,C,27,216,392,0.5510204081632653,0,1,0.0,216,391,0.5524296675191815,38,62,0.6129032258064516,118,285,403,47,36,48,61,172,470,2017_Kosta Koufos
2017,Kyle Korver,SG,35,478,1030,0.4640776699029126,324,718,0.45125348189415043,154,312,0.4935897435897436,76,84,0.9047619047619048,16,358,374,220,68,42,138,214,1356,2017_Kyle Korver
2017,Malcolm Delaney,PG,27,145,388,0.37371134020618557,26,110,0.23636363636363636,119,278,0.42805755395683454,75,93,0.8064516129032258,11,113,124,193,39,1,95,112,391,2017_Malcolm Delaney
2017,Michael Beasley,PF,28,216,406,0.5320197044334976,18,43,0.4186046511627907,198,363,0.5454545454545454,78,105,0.7428571428571429,40,153,193,53,28,27,66,92,528,2017_Michael Beasley
2017,Montrezl Harrell,C,23,225,345,0.6521739130434783,1,7,0.14285714285714285,224,338,0.6627218934911243,76,121,0.628099173553719,81,138,219,64,20,42,44,126,527,2017_Montrezl Harrell
2017,Nemanja Bjelica,PF,28,151,356,0.4241573033707865,56,177,0.3163841807909605,95,179,0.5307262569832403,45,61,0.7377049180327869,57,187,244,79,40,20,59,154,403,2017_Nemanja Bjelica
2017,Omer Asik,C,30,31,65,0.47692307692307695,0,0,NaN,31,65,0.47692307692307695,23,39,0.5897435897435898,48,115,163,15,5,10,14,51,85,2017_Omer Asik
2017,Patrick Beverley,SG,28,228,543,0.4198895027624309,110,288,0.3819444444444444,118,255,0.4627450980392157,73,95,0.7684210526315789,95,299,394,281,99,25,100,222,639,2017_Patrick Beverley
2017,Tristan Thompson,C,25,262,437,0.5995423340961098,0,3,0.0,262,434,0.6036866359447005,106,213,0.49765258215962443,287,429,716,77,39,84,64,176,630,2017_Tristan Thompson
2017,Zach Randolph,PF,35,433,964,0.4491701244813278,21,94,0.22340425531914893,412,870,0.4735632183908046,141,193,0.7305699481865285,182,416,598,122,38,10,99,136,1028,2017_Zach Randolph
2003,Alton Ford,PF,21,3,9,0.3333333333333333,0,0,NaN,3,9,0.3333333333333333,1,3,0.3333333333333333,0,6,6,1,0,0,2,7,7,2003_Alton Ford
2003,Antonio Davis,C,34,261,641,0.40717628705148207,0,0,NaN,261,641,0.40717628705148207,216,280,0.7714285714285715,130,307,437,131,23,62,118,150,738,2003_Antonio Davis
2003,Chris Mills,PF,33,39,106,0.36792452830188677,7,25,0.28,32,81,0.3950617283950617,16,18,0.8888888888888888,19,31,50,22,7,3,10,29,101,2003_Chris Mills
2003,Corey Benjamin,SG,24,13,43,0.3023255813953488,2,13,0.15384615384615385,11,30,0.36666666666666664,12,16,0.75,10,21,31,10,1,2,6,20,40,2003_Corey Benjamin
2003,Dan Gadzuric,C,24,70,145,0.4827586206896552,0,1,0.0,70,144,0.4861111111111111,29,56,0.5178571428571429,66,131,197,9,22,52,27,125,169,2003_Dan Gadzuric
2003,Devin Brown,SG,24,24,70,0.34285714285714286,0,2,0.0,24,68,0.35294117647058826,12,16,0.75,16,20,36,14,8,2,18,28,60,2003_Devin Brown
2003,Evan Eschmeyer,C,27,7,19,0.3684210526315789,0,0,NaN,7,19,0.3684210526315789,3,4,0.75,10,19,29,6,10,7,6,35,17,2003_Evan Eschmeyer
2003,Gordan Giricek,SF_SG_SG-SF,25,700,1606,0.43586550435865506,170,498,0.3413654618473896,530,1108,0.47833935018050544,300,366,0.819672131147541,72,404,476,274,104,16,290,318,1870,2003_Gordan Giricek
2003,Jalen Rose,SF,30,642,1583,0.40555906506632977,133,359,0.37047353760445684,509,1224,0.4158496732026144,399,467,0.854389721627409,68,283,351,395,72,23,285,271,1816,2003_Jalen Rose
2003,Jamaal Magloire,C,24,305,635,0.48031496062992124,0,3,0.0,305,632,0.4825949367088608,231,322,0.717391304347826,260,464,724,88,49,111,158,276,841,2003_Jamaal Magloire
2003,Jerry Stackhouse,SG,28,491,1201,0.40882597835137385,71,245,0.2897959183673469,420,956,0.4393305439330544,455,518,0.8783783783783784,61,197,258,316,65,28,193,130,1508,2003_Jerry Stackhouse
2003,John Crotty,PG,33,14,41,0.34146341463414637,4,13,0.3076923076923077,10,28,0.35714285714285715,9,15,0.6,1,14,15,29,3,0,9,16,41,2003_John Crotty
2003,Tito Maddox,SG,21,3,12,0.25,0,3,0.0,3,9,0.3333333333333333,5,8,0.625,1,6,7,5,3,1,3,4,11,2003_Tito Maddox
2004,Antonio Davis,C,35,532,1320,0.403030303030303,0,0,NaN,532,1320,0.403030303030303,352,460,0.7652173913043478,414,928,1342,274,74,130,228,412,1416,2004_Antonio Davis
2004,Devin Brown,SG,25,85,196,0.4336734693877551,4,14,0.2857142857142857,81,182,0.44505494505494503,60,74,0.8108108108108109,38,92,130,33,15,4,38,61,234,2004_Devin Brown
2004,Hubert Davis,SG,33,2,22,0.09090909090909091,0,2,0.0,2,20,0.1,4,4,1.0,4,12,16,8,4,0,6,24,8,2004_Hubert Davis
2004,Jake Voskuhl,C,26,152,300,0.5066666666666667,0,0,NaN,152,300,0.5066666666666667,134,181,0.7403314917127072,123,220,343,57,42,25,77,258,438,2004_Jake Voskuhl
2004,Jamaal Magloire,C,25,383,809,0.47342398022249693,0,1,0.0,383,808,0.474009900990099,353,470,0.7510638297872341,268,579,847,86,43,101,201,278,1119,2004_Jamaal Magloire
2004,Jarron Collins,C,25,147,295,0.49830508474576274,0,1,0.0,147,294,0.5,188,262,0.7175572519083969,117,199,316,77,26,18,79,255,482,2004_Jarron Collins
2004,Larry Hughes,SG,25,401,1009,0.39742319127849357,79,232,0.34051724137931033,322,777,0.4144144144144144,267,335,0.7970149253731343,96,230,326,148,95,26,152,147,1148,2004_Larry Hughes
2004,Luke Walton,PF,23,65,153,0.42483660130718953,13,39,0.3333333333333333,52,114,0.45614035087719296,31,44,0.7045454545454546,39,88,127,113,28,8,44,70,174,2004_Luke Walton
2004,Mickael Pietrus,PG,21,96,231,0.4155844155844156,35,105,0.3333333333333333,61,126,0.48412698412698413,52,75,0.6933333333333334,48,71,119,27,32,12,40,100,279,2004_Mickael Pietrus
2005,Andre Emmett,SG,22,2,6,0.3333333333333333,0,0,NaN,2,6,0.3333333333333333,3,5,0.6,0,2,2,0,0,0,1,4,7,2005_Andre Emmett
2005,Antonio Davis,PF,36,193,419,0.4606205250596659,0,0,NaN,193,419,0.4606205250596659,115,152,0.756578947368421,152,276,428,80,27,41,96,147,501,2005_Antonio Davis
2005,Devin Brown,SG,26,173,409,0.4229828850855746,45,121,0.371900826446281,128,288,0.4444444444444444,103,130,0.7923076923076923,37,139,176,92,39,12,53,83,494,2005_Devin Brown
2005,Jamaal Magloire,C,26,98,227,0.43171806167400884,0,0,NaN,98,227,0.43171806167400884,74,123,0.6016260162601627,79,126,205,29,8,23,59,74,270,2005_Jamaal Magloire
2005,Luke Walton,SF,24,74,180,0.4111111111111111,16,61,0.26229508196721313,58,119,0.48739495798319327,34,48,0.7083333333333334,55,87,142,93,26,11,58,70,198,2005_Luke Walton
2005,Luol Deng,SF,19,280,645,0.43410852713178294,31,117,0.26495726495726496,249,528,0.4715909090909091,120,162,0.7407407407407407,92,230,322,135,48,27,118,98,711,2005_Luol Deng
2005,Mickael Pietrus,SF,22,214,501,0.42714570858283435,67,195,0.3435897435897436,147,306,0.4803921568627451,141,202,0.698019801980198,65,124,189,82,46,18,92,139,636,2005_Mickael Pietrus
2005,P.J. Brown,PF,35,338,758,0.44591029023746703,0,0,NaN,338,758,0.44591029023746703,210,243,0.8641975308641975,266,471,737,178,74,50,101,233,886,2005_P.J. Brown
2005,Robert Traylor,C,27,177,399,0.44360902255639095,0,8,0.0,177,391,0.45268542199488493,55,102,0.5392156862745098,136,196,332,61,54,50,73,215,409,2005_Robert Traylor
2006,Anthony Carter,PG,30,53,137,0.38686131386861317,4,15,0.26666666666666666,49,122,0.4016393442622951,40,55,0.7272727272727273,9,53,62,101,24,9,40,71,150,2006_Anthony Carter
2006,Antoine Walker,PF,29,391,898,0.4354120267260579,137,383,0.3577023498694517,254,515,0.49320388349514566,81,129,0.627906976744186,103,318,421,166,47,30,150,187,1000,2006_Antoine Walker
2006,Antonio Davis,C_PF_PF-C,37,164,380,0.43157894736842106,0,2,0.0,164,378,0.43386243386243384,104,162,0.6419753086419753,180,236,416,42,46,20,102,250,432,2006_Antonio Davis
2006,Devin Brown,SG,27,207,527,0.3927893738140417,39,118,0.3305084745762712,168,409,0.41075794621026895,158,212,0.7452830188679245,73,134,207,104,44,14,99,153,611,2006_Devin Brown
2006,Jamaal Magloire,C,27,287,615,0.4666666666666667,0,0,NaN,287,615,0.4666666666666667,178,333,0.5345345345345346,220,558,778,56,29,80,166,276,752,2006_Jamaal Magloire
2006,Jamaal Tinsley,PG,27,158,386,0.40932642487046633,16,70,0.22857142857142856,142,316,0.44936708860759494,58,91,0.6373626373626373,35,98,133,211,49,6,109,96,390,2006_Jamaal Tinsley
2006,Jerome James,C,30,56,121,0.4628099173553719,0,0,NaN,56,121,0.4628099173553719,25,40,0.625,39,52,91,12,3,23,51,104,137,2006_Jerome James
2006,Luke Walton,SF,25,135,328,0.4115853658536585,18,55,0.32727272727272727,117,273,0.42857142857142855,57,76,0.75,88,159,247,156,41,15,78,119,345,2006_Luke Walton
2006,Malik Rose,PF,31,105,281,0.3736654804270463,1,1,1.0,104,280,0.37142857142857144,107,137,0.781021897810219,84,175,259,67,43,14,80,145,318,2006_Malik Rose
2006,Marvin Williams,PF,19,235,531,0.4425612052730697,13,53,0.24528301886792453,222,478,0.46443514644351463,189,253,0.7470355731225297,122,261,383,63,48,24,83,227,672,2006_Marvin Williams
2006,Mickael Pietrus,SF,23,169,418,0.4043062200956938,56,176,0.3181818181818182,113,242,0.4669421487603306,87,143,0.6083916083916084,58,105,163,44,33,10,78,132,481,2006_Mickael Pietrus
2006,Robert Swift,C,20,124,241,0.5145228215767634,0,0,NaN,124,241,0.5145228215767634,53,91,0.5824175824175825,94,170,264,8,15,56,49,142,301,2006_Robert Swift
2006,Samuel Dalembert,C,24,196,369,0.5311653116531165,0,1,0.0,196,368,0.532608695652174,93,132,0.7045454545454546,159,382,541,25,34,160,107,244,485,2006_Samuel Dalembert
2006,Steve Nash,PG,31,541,1056,0.5123106060606061,150,342,0.43859649122807015,391,714,0.5476190476190477,257,279,0.921146953405018,47,286,333,826,61,12,276,120,1489,2006_Steve Nash
2007,Adonal Foyle,C,31,48,85,0.5647058823529412,0,0,NaN,48,85,0.5647058823529412,11,25,0.44,51,75,126,19,11,50,23,61,107,2007_Adonal Foyle
2007,Andray Blatche,PF,20,86,197,0.4365482233502538,4,27,0.14814814814814814,82,170,0.4823529411764706,30,49,0.6122448979591837,77,114,191,39,17,32,49,94,206,2007_Andray Blatche
2007,Derek Anderson,SF,32,126,294,0.42857142857142855,54,152,0.35526315789473684,72,142,0.5070422535211268,93,106,0.8773584905660378,29,84,113,133,52,7,56,115,399,2007_Derek Anderson
2007,Devin Brown,SG,28,233,555,0.4198198198198198,81,227,0.3568281938325991,152,328,0.4634146341463415,123,155,0.7935483870967742,55,196,251,149,44,9,91,139,670,2007_Devin Brown
2007,Dwayne Jones,PF,23,0,1,0.0,0,0,NaN,0,1,0.0,3,6,0.5,1,5,6,0,0,0,2,3,3,2007_Dwayne Jones
2007,Jamaal Magloire,C,28,199,395,0.5037974683544304,0,0,NaN,199,395,0.5037974683544304,131,242,0.5413223140495868,151,341,492,30,21,66,129,226,529,2007_Jamaal Magloire
2007,Jason Kapono,SF,25,278,563,0.4937833037300178,108,210,0.5142857142857142,170,353,0.48158640226628896,66,74,0.8918918918918919,26,154,180,81,38,2,70,135,730,2007_Jason Kapono
2007,Kevinn Pinkney,PF,23,12,27,0.4444444444444444,1,2,0.5,11,25,0.44,6,9,0.6666666666666666,7,8,15,5,3,3,4,12,31,2007_Kevinn Pinkney
2007,Luke Walton,SF,26,264,557,0.473967684021544,48,124,0.3870967741935484,216,433,0.49884526558891457,108,145,0.7448275862068966,87,215,302,257,60,21,118,117,684,2007_Luke Walton
2007,Michael Doleac,C,29,82,175,0.4685714285714286,0,1,0.0,82,174,0.47126436781609193,36,41,0.8780487804878049,44,111,155,22,18,15,30,96,200,2007_Michael Doleac
2007,Mickael Pietrus,SF,24,286,586,0.4880546075085324,93,240,0.3875,193,346,0.5578034682080925,136,210,0.6476190476190476,81,246,327,62,48,55,105,220,801,2007_Mickael Pietrus
2007,Tyson Chandler,C,24,292,468,0.6239316239316239,0,1,0.0,292,467,0.6252676659528907,106,201,0.527363184079602,320,584,904,66,37,129,126,244,690,2007_Tyson Chandler
2008,Brandon Bass,C,22,246,493,0.49898580121703856,0,4,0.0,246,489,0.5030674846625767,162,197,0.8223350253807107,120,227,347,58,22,48,82,150,654,2008_Brandon Bass
2008,Damien Wilkins,SF,28,271,673,0.4026745913818722,50,155,0.3225806451612903,221,518,0.4266409266409266,106,144,0.7361111111111112,72,173,245,150,62,19,89,128,698,2008_Damien Wilkins
2008,Devin Brown,SG,29,217,531,0.4086629001883239,45,146,0.3082191780821918,172,385,0.44675324675324674,107,142,0.7535211267605634,65,198,263,175,52,7,99,144,586,2008_Devin Brown
2008,Gilbert Arenas,PG,26,78,196,0.3979591836734694,22,78,0.28205128205128205,56,118,0.4745762711864407,74,96,0.7708333333333334,6,45,51,66,23,1,49,30,252,2008_Gilbert Arenas
2008,Jamaal Magloire,C,29,36,110,0.32727272727272727,0,0,NaN,36,110,0.32727272727272727,40,88,0.45454545454545453,38,140,178,14,2,20,60,100,112,2008_Jamaal Magloire
2008,Jason Hart,PG,29,58,180,0.32222222222222224,11,31,0.3548387096774194,47,149,0.31543624161073824,38,45,0.8444444444444444,5,50,55,86,30,3,28,75,165,2008_Jason Hart
2008,Luke Walton,SF,27,215,478,0.4497907949790795,28,84,0.3333333333333333,187,394,0.4746192893401015,77,109,0.7064220183486238,85,206,291,218,60,18,100,133,535,2008_Luke Walton
2008,Mickael Pietrus,SF,25,170,387,0.4392764857881137,66,183,0.36065573770491804,104,204,0.5098039215686274,66,98,0.673469387755102,67,175,242,49,66,43,48,200,472,2008_Mickael Pietrus
2009,Gerald Wallace,SF,26,389,811,0.4796547472256473,39,131,0.29770992366412213,350,680,0.5147058823529411,365,454,0.8039647577092511,112,441,553,189,121,67,148,210,1182,2009_Gerald Wallace
2009,Jason Richardson,SG,28,930,1948,0.47741273100616016,258,650,0.39692307692307693,672,1298,0.5177195685670262,306,398,0.7688442211055276,154,484,638,292,152,56,190,292,2424,2009_Jason Richardson
2009,Jermaine O'Neal,C,30,730,1540,0.474025974025974,0,2,0.0,730,1538,0.47464239271781533,350,444,0.7882882882882883,252,614,866,244,58,272,288,422,1810,2009_Jermaine O'Neal
2009,Kirk Hinrich,SG,28,183,419,0.43675417661097854,69,169,0.40828402366863903,114,250,0.456,68,86,0.7906976744186046,16,107,123,197,66,19,87,126,503,2009_Kirk Hinrich
2009,Luke Walton,SF,28,134,307,0.4364820846905538,17,57,0.2982456140350877,117,250,0.468,41,57,0.7192982456140351,55,125,180,177,32,10,69,105,326,2009_Luke Walton
2009,Mickael Pietrus,SG,26,176,426,0.4131455399061033,80,223,0.35874439461883406,96,203,0.4729064039408867,78,110,0.7090909090909091,44,132,176,65,31,24,56,126,510,2009_Mickael Pietrus
2009,Mike James,PG,33,394,1028,0.3832684824902724,138,368,0.375,256,660,0.3878787878787879,136,164,0.8292682926829268,50,216,266,402,88,12,188,216,1062,2009_Mike James
2009,Nick Young,SG,23,336,756,0.4444444444444444,56,164,0.34146341463414637,280,592,0.47297297297297297,164,193,0.8497409326424871,31,119,150,95,39,20,92,140,892,2009_Nick Young
2009,O.J. Mayo,SG,21,562,1283,0.4380358534684334,145,378,0.3835978835978836,417,905,0.4607734806629834,247,281,0.8790035587188612,56,252,308,262,91,13,226,204,1516,2009_O.J. Mayo
2009,Zydrunas Ilgauskas,C,33,342,724,0.4723756906077348,15,39,0.38461538461538464,327,685,0.47737226277372263,139,174,0.7988505747126436,157,333,490,64,28,84,90,183,838,2009_Zydrunas Ilgauskas
2010,Al Horford,C,23,467,847,0.551357733175915,1,1,1.0,466,846,0.5508274231678487,213,270,0.7888888888888889,236,563,799,189,59,91,122,225,1148,2010_Al Horford
2010,Antawn Jamison,PF,33,956,2072,0.4613899613899614,170,494,0.3441295546558704,786,1578,0.49809885931558934,388,600,0.6466666666666666,272,838,1110,168,142,42,182,358,2470,2010_Antawn Jamison
2010,Brandon Rush,SG,24,297,702,0.4230769230769231,124,302,0.4105960264900662,173,400,0.4325,56,89,0.6292134831460674,41,305,346,112,56,65,93,159,774,2010_Brandon Rush
2010,Daniel Gibson,PG,23,125,268,0.4664179104477612,71,149,0.47651006711409394,54,119,0.453781512605042,34,49,0.6938775510204082,13,60,73,70,25,7,36,79,355,2010_Daniel Gibson
2010,Delonte West,SG,26,194,436,0.44495412844036697,25,77,0.3246753246753247,169,359,0.47075208913649025,115,142,0.8098591549295775,29,140,169,196,55,28,90,86,528,2010_Delonte West
2010,Devin Brown,SG,31,272,722,0.3767313019390582,116,328,0.35365853658536583,156,394,0.39593908629441626,138,172,0.8023255813953488,58,190,248,130,66,12,124,144,798,2010_Devin Brown
2010,Jamaal Magloire,C,31,28,56,0.5,0,0,NaN,28,56,0.5,21,59,0.3559322033898305,41,80,121,1,9,11,17,59,77,2010_Jamaal Magloire
2010,Josh Boone,PF,25,117,223,0.5246636771300448,0,0,NaN,117,223,0.5246636771300448,19,58,0.3275862068965517,124,191,315,29,30,48,37,111,253,2010_Josh Boone
2010,Luol Deng,SF,24,473,1014,0.46646942800788954,32,83,0.3855421686746988,441,931,0.47368421052631576,252,330,0.7636363636363637,131,381,512,143,66,61,134,129,1230,2010_Luol Deng
2010,Mardy Collins,SG,25,47,128,0.3671875,4,17,0.23529411764705882,43,111,0.38738738738738737,13,21,0.6190476190476191,13,37,50,44,23,1,32,45,111,2010_Mardy Collins
2010,Marvin Williams,SF,23,302,664,0.45481927710843373,40,132,0.30303030303030304,262,532,0.4924812030075188,176,215,0.8186046511627907,106,310,416,93,66,46,72,160,820,2010_Marvin Williams
2010,Trey Gilder,SF,25,1,1,1.0,0,0,NaN,1,1,1.0,0,0,NaN,0,1,1,0,1,0,0,0,2,2010_Trey Gilder
2010,Vince Carter,SG,33,434,1015,0.42758620689655175,119,324,0.36728395061728397,315,691,0.4558610709117221,257,306,0.8398692810457516,33,260,293,236,53,18,106,189,1244,2010_Vince Carter
2011,Al Jefferson,C,26,654,1319,0.49583017437452614,0,0,NaN,654,1319,0.49583017437452614,220,289,0.7612456747404844,235,559,794,149,46,153,105,238,1528,2011_Al Jefferson
2011,Daniel Gibson,SG,24,264,660,0.4,118,293,0.40273037542662116,146,367,0.3978201634877384,134,163,0.8220858895705522,24,153,177,201,48,21,80,154,780,2011_Daniel Gibson
2011,Greg Monroe,C,20,303,550,0.5509090909090909,0,1,0.0,303,549,0.5519125683060109,145,233,0.6223175965665236,248,353,601,105,93,45,81,196,751,2011_Greg Monroe
2011,J.J. Hickson,C,22,429,936,0.4583333333333333,0,5,0.0,429,931,0.4607948442534909,247,367,0.6730245231607629,217,478,695,91,48,54,173,215,1105,2011_J.J. Hickson
2011,Jamaal Magloire,C,32,13,22,0.5909090909090909,0,0,NaN,13,22,0.5909090909090909,9,18,0.5,17,44,61,3,4,2,5,26,35,2011_Jamaal Magloire
2011,James Harden,SG,21,298,684,0.43567251461988304,113,324,0.3487654320987654,185,360,0.5138888888888888,289,343,0.8425655976676385,42,213,255,176,92,24,106,207,998,2011_James Harden
2011,John Lucas,PG,28,1,3,0.3333333333333333,0,1,0.0,1,2,0.5,0,2,0.0,0,0,0,1,0,0,0,0,2,2011_John Lucas
2011,Kevin Love,PF,22,482,1026,0.4697855750487329,88,211,0.41706161137440756,394,815,0.4834355828220859,424,499,0.8496993987975952,330,782,1112,184,45,28,155,148,1476,2011_Kevin Love
2011,Luke Walton,SF,30,38,116,0.3275862068965517,8,34,0.23529411764705882,30,82,0.36585365853658536,7,10,0.7,9,58,67,62,9,4,31,38,91,2011_Luke Walton
2011,Luol Deng,SF,25,531,1155,0.4597402597402597,115,333,0.34534534534534533,416,822,0.5060827250608273,253,336,0.7529761904761905,116,360,476,230,78,48,156,162,1430,2011_Luol Deng
2011,Marvin Williams,SF,24,246,537,0.4581005586592179,37,110,0.33636363636363636,209,427,0.4894613583138173,147,174,0.8448275862068966,68,245,313,88,34,23,62,104,676,2011_Marvin Williams
2011,Samardo Samuels,PF,22,110,241,0.45643153526970953,0,3,0.0,110,238,0.46218487394957986,68,110,0.6181818181818182,75,83,158,17,15,18,53,88,288,2011_Samardo Samuels
2011,Timofey Mozgov,C,24,126,266,0.47368421052631576,0,0,NaN,126,266,0.47368421052631576,74,104,0.7115384615384616,92,150,242,30,30,50,70,168,326,2011_Timofey Mozgov
2011,Yao Ming,C,30,18,37,0.4864864864864865,0,0,NaN,18,37,0.4864864864864865,15,16,0.9375,7,20,27,4,0,8,7,13,51,2011_Yao Ming
2012,Alec Burks,SG,20,153,357,0.42857142857142855,15,45,0.3333333333333333,138,312,0.4423076923076923,104,143,0.7272727272727273,57,75,132,55,27,5,51,84,425,2012_Alec Burks
2012,Ben Uzoh,PG,23,70,198,0.35353535353535354,0,2,0.0,70,196,0.35714285714285715,22,38,0.5789473684210527,38,96,134,122,34,6,38,62,162,2012_Ben Uzoh
2012,Corey Brewer,SF,25,201,463,0.43412526997840173,33,127,0.25984251968503935,168,336,0.5,90,130,0.6923076923076923,43,107,150,88,72,17,56,113,525,2012_Corey Brewer
2012,Daniel Gibson,SG,25,87,248,0.35080645161290325,55,139,0.39568345323741005,32,109,0.29357798165137616,34,43,0.7906976744186046,11,90,101,76,26,16,45,69,263,2012_Daniel Gibson
2012,Greg Monroe,C,21,407,781,0.5211267605633803,0,1,0.0,407,780,0.5217948717948718,201,272,0.7389705882352942,239,398,637,152,83,46,161,180,1015,2012_Greg Monroe
2012,J.J. Barea,PG,27,167,418,0.39952153110047844,53,143,0.3706293706293706,114,275,0.41454545454545455,76,98,0.7755102040816326,14,100,114,232,21,0,103,61,463,2012_J.J. Barea
2012,Jamaal Magloire,C,33,17,45,0.37777777777777777,0,0,NaN,17,45,0.37777777777777777,7,27,0.25925925925925924,25,88,113,6,4,10,22,66,41,2012_Jamaal Magloire
2012,Justin Dentmon,PG,26,20,56,0.35714285714285715,4,28,0.14285714285714285,16,28,0.5714285714285714,8,12,0.6666666666666666,0,16,16,20,4,0,14,20,52,2012_Justin Dentmon
2012,Kenneth Faried,PF,22,181,309,0.5857605177993528,0,0,NaN,181,309,0.5857605177993528,109,164,0.6646341463414634,142,210,352,36,34,47,54,116,471,2012_Kenneth Faried
2012,Luke Walton,SF_PF_PF-SF,31,48,130,0.36923076923076925,14,40,0.35,34,90,0.37777777777777777,0,0,NaN,26,72,98,70,10,2,54,82,110,2012_Luke Walton
2012,Luol Deng,SF,26,311,755,0.4119205298013245,79,215,0.3674418604651163,232,540,0.42962962962962964,127,165,0.7696969696969697,77,273,350,157,56,36,96,81,828,2012_Luol Deng
2012,Marvin Williams,SF,25,203,470,0.4319148936170213,58,149,0.38926174496644295,145,321,0.4517133956386293,115,146,0.7876712328767124,76,218,294,71,47,18,39,84,579,2012_Marvin Williams
2012,Samardo Samuels,C,23,105,231,0.45454545454545453,0,0,NaN,105,231,0.45454545454545453,82,117,0.7008547008547008,63,117,180,20,20,20,56,113,292,2012_Samardo Samuels
2013,Austin Rivers,SG,20,145,390,0.3717948717948718,28,86,0.32558139534883723,117,304,0.3848684210526316,59,108,0.5462962962962963,16,93,109,127,26,9,74,122,377,2013_Austin Rivers
2013,D.J. White,PF,26,12,23,0.5217391304347826,0,0,NaN,12,23,0.5217391304347826,5,9,0.5555555555555556,4,9,13,4,1,6,2,5,29,2013_D.J. White
2013,Daniel Gibson,PG,26,84,247,0.340080971659919,56,163,0.34355828220858897,28,84,0.3333333333333333,26,37,0.7027027027027027,5,55,60,82,30,4,31,89,250,2013_Daniel Gibson
2013,Goran Dragic,PG,26,401,906,0.44260485651214126,88,276,0.3188405797101449,313,630,0.49682539682539684,244,326,0.7484662576687117,60,178,238,569,124,26,212,214,1134,2013_Goran Dragic
2013,Greg Monroe,C,22,514,1058,0.48582230623818523,0,4,0.0,514,1054,0.4876660341555977,270,392,0.6887755102040817,236,541,777,281,105,55,234,190,1298,2013_Greg Monroe
2013,Kevin Martin,SG,29,350,778,0.4498714652956298,158,371,0.42587601078167114,192,407,0.47174447174447176,219,246,0.8902439024390244,31,147,178,106,72,8,101,138,1077,2013_Kevin Martin
2013,Luke Walton,PF,32,71,181,0.39226519337016574,20,67,0.29850746268656714,51,114,0.4473684210526316,10,20,0.5,38,107,145,166,42,13,60,98,172,2013_Luke Walton
2013,Luol Deng,SF,27,466,1093,0.4263494967978042,75,233,0.3218884120171674,391,860,0.45465116279069767,230,282,0.8156028368794326,162,314,476,222,81,32,144,105,1237,2013_Luol Deng
2013,Marquis Teague,PG,19,43,113,0.3805309734513274,4,23,0.17391304347826086,39,90,0.43333333333333335,9,16,0.5625,3,41,44,63,9,7,35,47,99,2013_Marquis Teague
2013,Marvin Williams,SF,26,199,470,0.42340425531914894,54,166,0.3253012048192771,145,304,0.4769736842105263,77,99,0.7777777777777778,55,208,263,77,37,38,60,98,529,2013_Marvin Williams
2013,Mickael Pietrus,SF,30,34,98,0.3469387755102041,20,64,0.3125,14,34,0.4117647058823529,12,18,0.6666666666666666,5,31,36,9,12,6,16,33,100,2013_Mickael Pietrus
2013,Mike Scott,PF,24,70,147,0.47619047619047616,0,1,0.0,70,146,0.4794520547945205,43,56,0.7678571428571429,39,71,110,12,4,2,21,32,183,2013_Mike Scott
2013,Nene Hilario,PF,30,285,594,0.4797979797979798,0,1,0.0,285,593,0.4806070826306914,196,269,0.7286245353159851,101,306,407,177,55,37,139,171,766,2013_Nene Hilario
2013,P.J. Tucker,SG,27,210,444,0.47297297297297297,22,70,0.3142857142857143,188,374,0.5026737967914439,64,86,0.7441860465116279,132,218,350,109,62,19,67,145,506,2013_P.J. Tucker
2013,Rudy Gay,SF,26,1042,2506,0.4158020750199521,168,520,0.3230769230769231,874,1986,0.44008056394763345,480,590,0.8135593220338984,198,724,922,404,226,106,396,364,2732,2013_Rudy Gay
2013,Samardo Samuels,C,24,22,60,0.36666666666666664,0,1,0.0,22,59,0.3728813559322034,14,24,0.5833333333333334,10,18,28,8,3,3,6,30,58,2013_Samardo Samuels
2013,Willie Green,SG,31,178,386,0.46113989637305697,71,166,0.42771084337349397,107,220,0.4863636363636364,23,32,0.71875,17,80,97,55,29,12,31,96,450,2013_Willie Green
2014,Austin Rivers,PG,21,192,474,0.4050632911392405,36,99,0.36363636363636365,156,375,0.416,110,173,0.6358381502890174,26,103,129,160,45,9,77,134,530,2014_Austin Rivers
2014,Carrick Felix,SG,23,7,14,0.5,2,5,0.4,5,9,0.5555555555555556,3,4,0.75,1,5,6,4,0,0,4,4,19,2014_Carrick Felix
2014,Gordon Hayward,SF,23,426,1032,0.4127906976744186,85,280,0.30357142857142855,341,752,0.45345744680851063,311,381,0.8162729658792651,62,329,391,400,110,40,212,155,1248,2014_Gordon Hayward
2014,Greg Monroe,PF,23,504,1015,0.496551724137931,0,1,0.0,504,1014,0.4970414201183432,241,367,0.6566757493188011,256,504,760,171,91,47,166,205,1249,2014_Greg Monroe
2014,Hilton Armstrong,C,29,9,19,0.47368421052631576,0,0,NaN,9,19,0.47368421052631576,7,16,0.4375,19,28,47,5,4,4,6,11,25,2014_Hilton Armstrong
2014,Jarrett Jack,PG,30,286,698,0.40974212034383956,63,185,0.34054054054054056,223,513,0.4346978557504873,125,149,0.8389261744966443,22,201,223,324,56,22,133,133,760,2014_Jarrett Jack
2014,Jason Thompson,PF,27,251,496,0.5060483870967742,0,0,NaN,251,496,0.5060483870967742,84,145,0.5793103448275863,153,374,527,53,32,56,95,251,586,2014_Jason Thompson
2014,Luol Deng,SF,28,742,1720,0.4313953488372093,114,378,0.30158730158730157,628,1342,0.46795827123695977,424,536,0.7910447761194029,198,524,722,366,124,18,228,222,2022,2014_Luol Deng
2014,Marc Gasol,C,29,336,711,0.47257383966244726,2,11,0.18181818181818182,334,700,0.47714285714285715,185,241,0.7676348547717843,84,340,424,215,59,76,111,150,859,2014_Marc Gasol
2014,Marvin Williams,PF,27,231,526,0.4391634980988593,84,234,0.358974358974359,147,292,0.5034246575342466,57,73,0.7808219178082192,82,252,334,78,54,31,53,151,603,2014_Marvin Williams
2014,Mike Muscala,PF,22,31,73,0.4246575342465753,0,3,0.0,31,70,0.44285714285714284,14,14,1.0,17,35,52,7,3,10,12,29,76,2014_Mike Muscala
2014,P.J. Tucker,SF,28,265,615,0.43089430894308944,74,191,0.387434554973822,191,424,0.45047169811320753,156,201,0.7761194029850746,161,368,529,141,110,23,102,204,760,2014_P.J. Tucker
2014,Ryan Hollins,PF,29,53,72,0.7361111111111112,0,0,NaN,53,72,0.7361111111111112,35,56,0.625,31,59,90,8,9,31,29,87,141,2014_Ryan Hollins
2014,Solomon Hill,SF,22,17,40,0.425,7,23,0.30434782608695654,10,17,0.5882352941176471,6,7,0.8571428571428571,9,32,41,12,5,2,13,19,47,2014_Solomon Hill
2015,Andre Drummond,C,21,494,961,0.514047866805411,0,2,0.0,494,959,0.5151199165797706,142,365,0.38904109589041097,437,667,1104,55,73,153,120,285,1130,2015_Andre Drummond
2015,Andre Roberson,SG,23,92,201,0.4577114427860697,21,85,0.24705882352941178,71,116,0.6120689655172413,23,48,0.4791666666666667,60,195,255,70,53,29,46,141,228,2015_Andre Roberson
2015,Anthony Tolliver,PF,29,322,786,0.40966921119592875,212,580,0.36551724137931035,110,206,0.5339805825242718,108,138,0.782608695652174,102,370,472,118,48,32,102,274,964,2015_Anthony Tolliver
2015,Austin Rivers,PG-SG_SG_PG,22,406,992,0.4092741935483871,78,262,0.29770992366412213,328,730,0.44931506849315067,170,252,0.6746031746031746,54,250,304,310,96,28,130,292,1060,2015_Austin Rivers
2015,Greg Monroe,PF,24,423,853,0.4958968347010551,0,0,NaN,423,853,0.4958968347010551,252,336,0.75,229,475,704,142,78,34,149,148,1098,2015_Greg Monroe
2015,Jerel McNeal,PG,27,3,11,0.2727272727272727,1,2,0.5,2,9,0.2222222222222222,2,2,1.0,0,3,3,2,3,1,5,5,9,2015_Jerel McNeal
2015,Jerryd Bayless,PG,26,220,516,0.4263565891472868,37,120,0.30833333333333335,183,396,0.4621212121212121,121,137,0.8832116788321168,22,189,211,233,59,12,133,163,598,2015_Jerryd Bayless
2015,Kyrie Irving,PG,22,578,1235,0.4680161943319838,157,378,0.41534391534391535,421,857,0.4912485414235706,315,365,0.863013698630137,55,182,237,389,114,20,186,146,1628,2015_Kyrie Irving
2015,Luol Deng,SF,29,369,787,0.46886912325285895,78,220,0.35454545454545455,291,567,0.5132275132275133,191,251,0.7609561752988048,103,273,376,139,65,22,108,109,1007,2015_Luol Deng
2015,Marvin Williams,PF,28,210,495,0.42424242424242425,95,265,0.3584905660377358,115,230,0.5,62,87,0.7126436781609196,58,328,386,100,69,36,60,146,577,2015_Marvin Williams
2015,P.J. Tucker,SF,29,261,596,0.43791946308724833,87,252,0.34523809523809523,174,344,0.5058139534883721,104,143,0.7272727272727273,114,388,502,122,107,23,96,179,713,2015_P.J. Tucker
2016,Amir Johnson,PF,28,249,426,0.5845070422535211,10,43,0.23255813953488372,239,383,0.6240208877284595,69,121,0.5702479338842975,178,327,505,138,52,83,94,214,577,2016_Amir Johnson
2016,Austin Rivers,SG,23,226,516,0.437984496124031,62,185,0.33513513513513515,164,331,0.4954682779456193,79,116,0.6810344827586207,22,108,130,99,48,9,61,137,593,2016_Austin Rivers
2016,Christian Wood,PF,20,22,53,0.41509433962264153,4,11,0.36363636363636365,18,42,0.42857142857142855,13,21,0.6190476190476191,13,25,38,3,5,7,2,11,61,2016_Christian Wood
2016,Damjan Rudez,SF,29,25,62,0.4032258064516129,17,50,0.34,8,12,0.6666666666666666,8,8,1.0,5,15,20,11,3,1,13,33,75,2016_Damjan Rudez
2016,DeAndre Jordan,C,27,357,508,0.702755905511811,0,1,0.0,357,507,0.7041420118343196,266,619,0.4297253634894992,267,792,1059,90,51,177,107,207,980,2016_DeAndre Jordan
2016,Greg Monroe,C,25,491,941,0.5217853347502657,0,1,0.0,491,940,0.5223404255319148,228,308,0.7402597402597403,218,478,696,178,72,67,129,163,1210,2016_Greg Monroe
2016,Jabari Parker,PF,20,443,899,0.492769744160178,9,35,0.2571428571428571,434,864,0.5023148148148148,175,228,0.7675438596491229,123,272,395,130,69,29,116,154,1070,2016_Jabari Parker
2016,Jared Dudley,PF,30,233,487,0.4784394250513347,100,238,0.42016806722689076,133,249,0.5341365461847389,72,98,0.7346938775510204,54,232,286,170,75,18,80,190,638,2016_Jared Dudley
2016,Kentavious Caldwell-Pope,SG,22,403,960,0.4197916666666667,114,369,0.3089430894308943,289,591,0.4890016920473773,185,228,0.8114035087719298,70,212,282,138,110,17,105,167,1105,2016_Kentavious Caldwell-Pope
2016,Marvin Williams,PF,29,338,747,0.4524765729585007,152,378,0.4021164021164021,186,369,0.5040650406504065,120,144,0.8333333333333334,127,394,521,110,58,77,62,133,948,2016_Marvin Williams
2016,Nikola Jokic,C,20,307,600,0.5116666666666667,28,84,0.3333333333333333,279,516,0.5406976744186046,154,190,0.8105263157894737,181,379,560,189,79,50,104,208,796,2016_Nikola Jokic
2017,Austin Rivers,SG,24,323,731,0.4418604651162791,111,299,0.3712374581939799,212,432,0.49074074074074076,132,191,0.6910994764397905,20,141,161,204,48,10,115,187,889,2017_Austin Rivers
2017,Doug McDermott,SF,25,444,994,0.44668008048289737,154,414,0.3719806763285024,290,580,0.5,142,168,0.8452380952380952,40,318,358,116,26,10,76,158,1184,2017_Doug McDermott
2017,Greg Monroe,C,26,387,726,0.5330578512396694,0,4,0.0,387,722,0.53601108033241,177,239,0.7405857740585774,167,365,532,187,92,38,140,168,951,2017_Greg Monroe
2017,Jabari Parker,PF,21,399,814,0.49017199017199015,65,178,0.3651685393258427,334,636,0.5251572327044025,162,218,0.7431192660550459,79,235,314,142,51,22,92,111,1025,2017_Jabari Parker
2017,Jamal Murray,SG,19,295,730,0.4041095890410959,115,344,0.33430232558139533,180,386,0.46632124352331605,106,120,0.8833333333333333,41,173,214,170,52,24,113,124,811,2017_Jamal Murray
2017,Richaun Holmes,C,23,230,412,0.558252427184466,27,77,0.35064935064935066,203,335,0.6059701492537314,72,103,0.6990291262135923,94,217,311,58,42,55,55,136,559,2017_Richaun Holmes
2017,Shabazz Muhammad,SF,24,288,598,0.4816053511705686,49,146,0.3356164383561644,239,452,0.5287610619469026,147,190,0.7736842105263158,84,136,220,35,22,6,56,86,772,2017_Shabazz Muhammad
2017,Shawn Long,C,24,61,109,0.5596330275229358,7,19,0.3684210526315789,54,90,0.6,19,35,0.5428571428571428,41,44,85,13,9,9,13,49,148,2017_Shawn Long
2017,Taj Gibson,PF,31,730,1418,0.5148095909732017,6,26,0.23076923076923078,724,1392,0.5201149425287356,226,316,0.7151898734177216,316,656,972,146,84,132,210,326,1692,2017_Taj Gibson
2017,Toney Douglas,PG,30,43,117,0.36752136752136755,7,42,0.16666666666666666,36,75,0.48,24,29,0.8275862068965517,13,48,61,56,18,5,21,50,117,2017_Toney Douglas
2003,Corie Blount,C,34,65,134,0.48507462686567165,0,0,NaN,65,134,0.48507462686567165,20,35,0.5714285714285714,68,137,205,50,33,19,43,121,150,2003_Corie Blount
2003,Darvin Ham,SG,29,71,159,0.44654088050314467,0,3,0.0,71,156,0.4551282051282051,38,79,0.4810126582278481,73,80,153,38,16,19,65,127,180,2003_Darvin Ham
2003,Emanual Davis,SG,34,32,88,0.36363636363636365,7,29,0.2413793103448276,25,59,0.423728813559322,17,22,0.7727272727272727,5,38,43,36,12,2,25,28,88,2003_Emanual Davis
2003,Jonathan Bender,SF,22,112,254,0.4409448818897638,19,53,0.3584905660377358,93,201,0.4626865671641791,60,84,0.7142857142857143,42,91,133,42,8,56,42,86,303,2003_Jonathan Bender
2003,Marcus Haislip,PF,22,66,153,0.43137254901960786,3,12,0.25,63,141,0.44680851063829785,26,38,0.6842105263157895,21,32,53,9,7,18,21,55,161,2003_Marcus Haislip
2003,Mark Bryant,PF,37,10,38,0.2631578947368421,0,0,NaN,10,38,0.2631578947368421,6,8,0.75,16,24,40,8,2,2,14,36,26,2003_Mark Bryant
2003,Mengke Bateer,C,27,4,17,0.23529411764705882,1,3,0.3333333333333333,3,14,0.21428571428571427,0,2,0.0,2,8,10,4,0,0,6,14,9,2003_Mengke Bateer
2003,Michael Curry,SF,34,92,229,0.4017467248908297,16,54,0.2962962962962963,76,175,0.4342857142857143,36,45,0.8,16,111,127,104,44,4,43,163,236,2003_Michael Curry
2003,Ruben Boumtje-Boumtje,C,24,0,1,0.0,0,0,NaN,0,1,0.0,0,0,NaN,1,0,1,1,1,0,0,0,0,2003_Ruben Boumtje-Boumtje
2003,Tracy McGrady,SG,23,829,1813,0.45725317153888584,173,448,0.3861607142857143,656,1365,0.4805860805860806,576,726,0.7933884297520661,121,367,488,411,124,59,195,156,2407,2003_Tracy McGrady
2004,Casey Jacobsen,SF,22,150,360,0.4166666666666667,75,180,0.4166666666666667,75,180,0.4166666666666667,91,111,0.8198198198198198,42,159,201,98,48,9,68,144,466,2004_Casey Jacobsen
2004,Jonathan Bender,SF,23,50,106,0.4716981132075472,9,22,0.4090909090909091,41,84,0.4880952380952381,39,47,0.8297872340425532,9,31,40,9,5,11,33,23,148,2004_Jonathan Bender
2004,Mengke Bateer,C,28,4,7,0.5714285714285714,0,0,NaN,4,7,0.5714285714285714,0,0,NaN,5,3,8,1,1,0,2,10,8,2004_Mengke Bateer
2004,Michael Curry,SF,35,76,196,0.3877551020408163,3,15,0.2,73,181,0.40331491712707185,49,58,0.8448275862068966,22,65,87,53,23,5,48,153,204,2004_Michael Curry
2004,Mike James,PG,28,544,1314,0.4140030441400304,212,562,0.37722419928825623,332,752,0.44148936170212766,206,254,0.8110236220472441,56,412,468,678,192,6,248,312,1506,2004_Mike James
2004,Robert Horry,PF,33,141,348,0.4051724137931034,41,108,0.37962962962962965,100,240,0.4166666666666667,69,107,0.6448598130841121,108,164,272,101,48,49,55,165,392,2004_Robert Horry
2004,Ruben Boumtje-Boumtje,C,25,1,5,0.2,0,0,NaN,1,5,0.2,2,2,1.0,0,1,1,1,0,1,0,2,4,2004_Ruben Boumtje-Boumtje
2004,Tracy McGrady,SG,24,653,1566,0.4169859514687101,174,513,0.3391812865497076,479,1053,0.45489078822412155,398,500,0.796,95,307,402,370,93,42,179,129,1878,2004_Tracy McGrady
2004,Zydrunas Ilgauskas,C,28,466,965,0.48290155440414506,2,7,0.2857142857142857,464,958,0.48434237995824636,303,406,0.7463054187192119,279,374,653,109,39,201,163,277,1237,2004_Zydrunas Ilgauskas
2005,Brian Cardinal,PF,27,160,432,0.37037037037037035,44,125,0.352,116,307,0.3778501628664495,158,181,0.8729281767955801,63,162,225,114,88,19,83,172,522,2005_Brian Cardinal
2005,Delonte West,SG,21,66,155,0.4258064516129032,24,67,0.3582089552238806,42,88,0.4772727272727273,19,27,0.7037037037037037,14,51,65,53,21,8,24,69,175,2005_Delonte West
2005,Donnell Harvey,PF,24,2,2,1.0,0,0,NaN,2,2,1.0,4,4,1.0,2,5,7,1,1,1,1,2,8,2005_Donnell Harvey
2005,Jonathan Bender,SF,24,16,40,0.4,1,5,0.2,15,35,0.42857142857142855,3,6,0.5,5,9,14,4,1,2,10,9,36,2005_Jonathan Bender
2005,Josh Smith,SF,19,274,602,0.45514950166112955,4,23,0.17391304347826086,270,579,0.46632124352331605,163,237,0.6877637130801688,147,310,457,127,59,144,135,157,715,2005_Josh Smith
2005,Luke Jackson,SF,23,10,27,0.37037037037037035,4,6,0.6666666666666666,6,21,0.2857142857142857,5,6,0.8333333333333334,2,4,6,3,0,0,2,4,29,2005_Luke Jackson
2005,Maurice Evans,SG,26,165,373,0.44235924932975873,27,82,0.32926829268292684,138,291,0.4742268041237113,59,78,0.7564102564102564,88,113,201,45,37,8,34,104,416,2005_Maurice Evans
2005,Melvin Ely,PF,26,227,526,0.43155893536121676,0,0,NaN,227,526,0.43155893536121676,122,212,0.5754716981132075,142,184,326,76,32,69,115,199,576,2005_Melvin Ely
2005,Michael Curry,SF,36,13,29,0.4482758620689655,0,0,NaN,13,29,0.4482758620689655,4,8,0.5,8,19,27,15,5,4,5,39,30,2005_Michael Curry
2005,Mike Wilks,PG,25,32,77,0.4155844155844156,5,16,0.3125,27,61,0.4426229508196721,12,16,0.75,4,21,25,33,14,1,14,26,81,2005_Mike Wilks
2005,Rasho Nesterovic,C,28,198,430,0.4604651162790698,0,0,NaN,198,430,0.4604651162790698,14,30,0.4666666666666667,184,275,459,71,31,117,73,207,410,2005_Rasho Nesterovic
2005,Tim Duncan,PF,28,517,1042,0.4961612284069098,3,9,0.3333333333333333,514,1033,0.4975798644724105,305,455,0.6703296703296703,202,530,732,179,45,174,127,144,1342,2005_Tim Duncan
2005,Tracy McGrady,SF,25,715,1660,0.4307228915662651,142,435,0.3264367816091954,573,1225,0.46775510204081633,431,557,0.7737881508078994,71,413,484,448,135,52,201,167,2003,2005_Tracy McGrady
2006,Al Jefferson,PF,21,189,379,0.49868073878627966,0,4,0.0,189,375,0.504,86,134,0.6417910447761194,97,202,299,30,30,46,62,166,464,2006_Al Jefferson
2006,Brevin Knight,PG,30,308,772,0.39896373056994816,3,13,0.23076923076923078,305,759,0.4018445322793149,252,314,0.802547770700637,35,188,223,610,157,4,164,202,871,2006_Brevin Knight
2006,Charles Smith,SG,30,60,144,0.4166666666666667,30,76,0.39473684210526316,30,68,0.4411764705882353,10,16,0.625,6,26,32,18,10,12,8,56,160,2006_Charles Smith
2006,Corey Maggette,SF,26,167,375,0.44533333333333336,24,71,0.3380281690140845,143,304,0.47039473684210525,212,256,0.828125,28,141,169,66,19,4,78,95,570,2006_Corey Maggette
2006,Dale Davis,C,36,9,24,0.375,0,1,0.0,9,23,0.391304347826087,8,15,0.5333333333333333,21,32,53,6,0,9,4,23,26,2006_Dale Davis
2006,John Lucas,PG,23,14,36,0.3888888888888889,2,9,0.2222222222222222,12,27,0.4444444444444444,0,0,NaN,2,3,5,12,5,0,7,6,30,2006_John Lucas
2006,Jonathan Bender,SF,25,4,5,0.8,0,0,NaN,4,5,0.8,2,2,1.0,0,4,4,2,0,1,0,2,10,2006_Jonathan Bender
2006,Lou Williams,PG,19,23,52,0.4423076923076923,2,9,0.2222222222222222,21,43,0.4883720930232558,8,13,0.6153846153846154,3,16,19,10,5,0,13,13,56,2006_Lou Williams
2006,Maurice Evans,SG,27,154,341,0.45161290322580644,43,116,0.3706896551724138,111,225,0.49333333333333335,52,65,0.8,76,87,163,60,41,15,39,122,403,2006_Maurice Evans
2006,Monta Ellis,SG,20,132,318,0.41509433962264153,28,82,0.34146341463414637,104,236,0.4406779661016949,42,59,0.711864406779661,22,83,105,78,32,11,58,69,334,2006_Monta Ellis
2006,Reece Gaines,PG,25,6,12,0.5,0,2,0.0,6,10,0.6,1,4,0.25,0,0,0,3,1,0,1,1,13,2006_Reece Gaines
2006,Shavlik Randolph,PF,22,44,97,0.4536082474226804,0,0,NaN,44,97,0.4536082474226804,43,71,0.6056338028169014,55,78,133,19,19,12,21,83,131,2006_Shavlik Randolph
2006,Tracy McGrady,SF,26,410,1011,0.4055390702274975,73,234,0.31196581196581197,337,777,0.4337194337194337,254,340,0.7470588235294118,46,261,307,225,59,41,120,88,1147,2006_Tracy McGrady
2007,Brevin Knight,PG,31,152,363,0.418732782369146,1,18,0.05555555555555555,151,345,0.43768115942028984,103,128,0.8046875,14,101,115,296,67,3,95,113,408,2007_Brevin Knight
2007,Damir Markota,PF,21,19,52,0.36538461538461536,6,16,0.375,13,36,0.3611111111111111,7,11,0.6363636363636364,11,20,31,6,3,1,15,22,51,2007_Damir Markota
2007,Damon Jones,PG,30,137,355,0.38591549295774646,89,231,0.3852813852813853,48,124,0.3870967741935484,30,44,0.6818181818181818,9,57,66,94,16,2,36,53,393,2007_Damon Jones
2007,David West,PF,26,377,792,0.476010101010101,8,25,0.32,369,767,0.4810951760104302,187,227,0.8237885462555066,126,298,424,114,42,38,98,143,949,2007_David West
2007,Ersan Ilyasova,PF,19,139,363,0.38292011019283745,54,148,0.36486486486486486,85,215,0.3953488372093023,70,89,0.7865168539325843,58,131,189,49,27,17,51,147,402,2007_Ersan Ilyasova
2007,J.J. Barea,PG,22,28,78,0.358974358974359,6,21,0.2857142857142857,22,57,0.38596491228070173,16,24,0.6666666666666666,7,18,25,24,1,1,14,19,78,2007_J.J. Barea
2007,Jason Williams,PG,31,235,569,0.4130052724077329,100,295,0.3389830508474576,135,274,0.4927007299270073,94,103,0.912621359223301,18,123,141,322,58,1,100,68,664,2007_Jason Williams
2007,Marcus Banks,PG,25,84,196,0.42857142857142855,5,29,0.1724137931034483,79,167,0.47305389221556887,48,60,0.8,10,28,38,60,23,3,40,70,221,2007_Marcus Banks
2007,Maurice Evans,SG,28,234,542,0.4317343173431734,48,133,0.3609022556390977,186,409,0.4547677261613692,122,155,0.7870967741935484,93,128,221,74,38,14,57,126,638,2007_Maurice Evans
2007,Monta Ellis,SG,21,480,1010,0.4752475247524752,39,143,0.2727272727272727,441,867,0.5086505190311419,273,358,0.7625698324022346,62,181,243,319,132,21,221,210,1272,2007_Monta Ellis
2007,Randy Livingston,PG,31,0,3,0.0,0,0,NaN,0,3,0.0,0,0,NaN,1,0,1,4,0,0,1,2,0,2007_Randy Livingston
2007,Royal Ivey,PG,25,64,143,0.44755244755244755,5,16,0.3125,59,127,0.4645669291338583,24,35,0.6857142857142857,15,36,51,45,24,4,31,62,157,2007_Royal Ivey
2007,Stephen Graham,SG,24,17,40,0.425,3,11,0.2727272727272727,14,29,0.4827586206896552,8,9,0.8888888888888888,6,15,21,5,4,1,13,25,45,2007_Stephen Graham
2007,Tracy McGrady,SG,27,638,1480,0.43108108108108106,126,381,0.33070866141732286,512,1099,0.4658780709736124,345,488,0.7069672131147541,56,322,378,458,92,36,213,136,1747,2007_Tracy McGrady
2007,Tyronn Lue,PG,29,218,524,0.41603053435114506,56,161,0.34782608695652173,162,363,0.4462809917355372,144,163,0.8834355828220859,19,85,104,201,24,0,85,101,636,2007_Tyronn Lue
2008,Brevin Knight,PG,32,138,342,0.40350877192982454,0,6,0.0,138,336,0.4107142857142857,62,71,0.8732394366197183,15,127,142,328,100,11,71,160,338,2008_Brevin Knight
2008,Chris Wilcox,PF,25,334,638,0.5235109717868338,0,3,0.0,334,635,0.525984251968504,160,248,0.6451612903225806,126,307,433,74,46,36,103,174,828,2008_Chris Wilcox
2008,Damon Jones,SG,31,151,363,0.41597796143250687,115,276,0.4166666666666667,36,87,0.41379310344827586,20,28,0.7142857142857143,5,67,72,126,19,1,36,66,437,2008_Damon Jones
2008,Eddy Curry,C,25,297,544,0.5459558823529411,0,0,NaN,297,544,0.5459558823529411,187,300,0.6233333333333333,111,164,275,32,14,29,126,157,781,2008_Eddy Curry
2008,Javaris Crittenton,SG,20,196,466,0.4206008583690987,20,74,0.2702702702702703,176,392,0.4489795918367347,144,208,0.6923076923076923,54,166,220,102,38,4,110,94,556,2008_Javaris Crittenton
2008,Jeff McInnis,PG,33,108,249,0.43373493975903615,3,19,0.15789473684210525,105,230,0.45652173913043476,23,30,0.7666666666666667,16,80,96,220,23,3,76,120,242,2008_Jeff McInnis
2008,Kevin Martin,SG,24,417,914,0.4562363238512035,107,266,0.40225563909774437,310,648,0.4783950617283951,502,578,0.8685121107266436,48,225,273,129,62,5,131,150,1443,2008_Kevin Martin
2008,Maurice Ager,SG,23,42,130,0.3230769230769231,6,38,0.15789473684210525,36,92,0.391304347826087,12,24,0.5,8,18,26,16,0,2,12,34,102,2008_Maurice Ager
2008,Maurice Evans,SG,29,524,1090,0.48073394495412847,162,418,0.3875598086124402,362,672,0.5386904761904762,118,166,0.7108433734939759,184,252,436,162,92,20,80,284,1328,2008_Maurice Evans
2008,Monta Ellis,SG,22,652,1227,0.5313773431132844,12,52,0.23076923076923078,640,1175,0.5446808510638298,320,417,0.7673860911270983,133,271,404,315,124,27,173,195,1636,2008_Monta Ellis
2008,Rudy Gay,SF,21,625,1355,0.4612546125461255,134,387,0.3462532299741602,491,968,0.5072314049586777,248,316,0.7848101265822784,140,359,499,158,111,79,190,230,1632,2008_Rudy Gay
2008,Tracy McGrady,SG,28,548,1307,0.41928079571537874,86,295,0.29152542372881357,462,1012,0.45652173913043476,245,358,0.6843575418994413,42,297,339,387,68,30,160,91,1427,2008_Tracy McGrady
2008,Yi Jianlian,PF,20,219,520,0.42115384615384616,6,21,0.2857142857142857,213,499,0.42685370741482964,122,145,0.8413793103448276,106,238,344,55,36,56,90,153,566,2008_Yi Jianlian
2009,Anthony Randolph,PF,19,199,431,0.4617169373549884,0,4,0.0,199,427,0.46604215456674475,101,141,0.7163120567375887,128,235,363,49,42,74,80,141,499,2009_Anthony Randolph
2009,Brevin Knight,PG,33,66,189,0.3492063492063492,0,6,0.0,66,183,0.36065573770491804,48,64,0.75,13,75,88,190,68,4,66,98,180,2009_Brevin Knight
2009,Damon Jones,PG,32,11,34,0.3235294117647059,11,28,0.39285714285714285,0,6,0.0,0,0,NaN,0,6,6,7,3,0,6,4,33,2009_Damon Jones
2009,Dan Gadzuric,C,30,117,244,0.47950819672131145,0,2,0.0,117,242,0.4834710743801653,37,68,0.5441176470588235,95,160,255,39,32,43,41,162,271,2009_Dan Gadzuric
2009,Hilton Armstrong,C,24,138,246,0.5609756097560976,0,2,0.0,138,244,0.5655737704918032,62,98,0.6326530612244898,81,114,195,29,26,45,80,181,338,2009_Hilton Armstrong
2009,Jamal Crawford,PG-SG_SG_PG,28,838,2044,0.40998043052837574,284,788,0.3604060913705584,554,1256,0.4410828025477707,600,688,0.872093023255814,46,340,386,576,114,26,296,184,2560,2009_Jamal Crawford
2009,Jason Thompson,PF,22,356,717,0.496513249651325,0,8,0.0,356,709,0.5021156558533145,198,286,0.6923076923076923,234,372,606,93,46,59,146,314,910,2009_Jason Thompson
2009,Jerry Stackhouse,SG,34,16,60,0.26666666666666666,3,19,0.15789473684210525,13,41,0.3170731707317073,7,7,1.0,5,12,17,12,4,1,9,6,42,2009_Jerry Stackhouse
2009,Kyrylo Fesenko,C,22,21,36,0.5833333333333334,0,0,NaN,21,36,0.5833333333333334,7,21,0.3333333333333333,14,23,37,4,7,15,9,35,49,2009_Kyrylo Fesenko
2009,Malik Allen,PF,30,73,170,0.4294117647058823,0,1,0.0,73,169,0.4319526627218935,10,21,0.47619047619047616,35,68,103,35,7,12,20,89,156,2009_Malik Allen
2009,Marc Gasol,C,24,350,661,0.529500756429652,0,1,0.0,350,660,0.5303030303030303,275,375,0.7333333333333333,201,404,605,143,63,90,164,265,975,2009_Marc Gasol
2009,Monta Ellis,SG,23,194,430,0.4511627906976744,8,26,0.3076923076923077,186,404,0.4603960396039604,78,94,0.8297872340425532,14,94,108,93,39,8,67,67,474,2009_Monta Ellis
2009,Ryan Hollins,C,24,100,188,0.5319148936170213,0,0,NaN,100,188,0.5319148936170213,86,144,0.5972222222222222,92,102,194,14,14,64,48,156,286,2009_Ryan Hollins
2009,Tracy McGrady,SG,29,188,485,0.38762886597938145,44,117,0.37606837606837606,144,368,0.391304347826087,125,156,0.8012820512820513,20,134,154,175,42,15,69,38,545,2009_Tracy McGrady
2009,Tyrus Thomas,PF,22,308,683,0.45095168374816985,3,9,0.3333333333333333,305,674,0.45252225519287836,238,304,0.7828947368421053,148,360,508,77,91,151,129,220,857,2009_Tyrus Thomas
2009,Yi Jianlian,PF,21,191,500,0.382,48,140,0.34285714285714286,143,360,0.3972222222222222,95,123,0.7723577235772358,67,259,326,60,29,36,70,157,525,2009_Yi Jianlian
2010,Aaron Gray,C,25,84,164,0.5121951219512195,0,0,NaN,84,164,0.5121951219512195,40,56,0.7142857142857143,90,122,212,44,18,22,36,108,208,2010_Aaron Gray
2010,Andres Nocioni,SF,30,234,587,0.3986371379897785,96,249,0.3855421686746988,138,338,0.40828402366863903,71,99,0.7171717171717171,32,190,222,75,32,26,67,160,635,2010_Andres Nocioni
2010,Anthony Morrow,SG,24,329,703,0.46799431009957326,140,307,0.4560260586319218,189,396,0.4772727272727273,101,114,0.8859649122807017,61,198,259,104,65,16,84,158,899,2010_Anthony Morrow
2010,Chris Paul,PG,24,314,637,0.49293563579277866,52,127,0.4094488188976378,262,510,0.5137254901960784,161,190,0.8473684210526315,20,171,191,480,96,8,112,118,841,2010_Chris Paul
2010,Daequan Cook,SG,22,81,253,0.3201581027667984,40,126,0.31746031746031744,41,127,0.3228346456692913,21,25,0.84,9,73,82,43,14,10,24,50,223,2010_Daequan Cook
2010,Donte Greene,SF,21,244,553,0.4412296564195298,69,183,0.3770491803278688,175,370,0.47297297297297297,90,140,0.6428571428571429,53,181,234,71,41,53,93,150,647,2010_Donte Greene
2010,Glen Davis,PF,24,122,279,0.43727598566308246,0,4,0.0,122,275,0.44363636363636366,96,138,0.6956521739130435,101,104,205,35,21,14,53,132,340,2010_Glen Davis
2010,Greg Oden,C,22,92,152,0.6052631578947368,0,0,NaN,92,152,0.6052631578947368,49,64,0.765625,64,114,178,19,8,48,39,84,233,2010_Greg Oden
2010,Keyon Dooling,PG,29,129,324,0.39814814814814814,59,157,0.37579617834394907,70,167,0.41916167664670656,47,61,0.7704918032786885,8,46,54,135,34,0,59,82,364,2010_Keyon Dooling
2010,Leon Powe,SF,26,21,49,0.42857142857142855,0,0,NaN,21,49,0.42857142857142855,37,63,0.5873015873015873,19,42,61,0,6,2,11,36,79,2010_Leon Powe
2010,Lester Hudson,PG,25,42,106,0.39622641509433965,10,32,0.3125,32,74,0.43243243243243246,22,26,0.8461538461538461,14,22,36,26,16,6,28,24,116,2010_Lester Hudson
2010,Luther Head,SG,27,136,311,0.43729903536977494,37,105,0.3523809523809524,99,206,0.48058252427184467,48,58,0.8275862068965517,6,74,80,72,18,9,54,53,357,2010_Luther Head
2010,Maurice Evans,SF,31,175,393,0.44529262086513993,57,169,0.33727810650887574,118,224,0.5267857142857143,46,61,0.7540983606557377,59,95,154,48,34,17,20,125,453,2010_Maurice Evans
2010,Michael Redd,SG,30,75,213,0.352112676056338,18,60,0.3,57,153,0.37254901960784315,47,66,0.7121212121212122,11,43,54,39,19,2,15,24,215,2010_Michael Redd
2010,Mike Dunleavy,SF,29,229,558,0.4103942652329749,75,236,0.3177966101694915,154,322,0.4782608695652174,133,158,0.8417721518987342,25,211,236,103,38,15,72,105,666,2010_Mike Dunleavy
2010,Thaddeus Young,PF,21,382,813,0.4698646986469865,48,138,0.34782608695652173,334,675,0.4948148148148148,114,165,0.6909090909090909,130,220,350,97,81,15,126,133,926,2010_Thaddeus Young
2010,Tracy McGrady,SG,30,182,470,0.3872340425531915,32,128,0.25,150,342,0.43859649122807015,94,126,0.746031746031746,44,144,188,198,30,28,88,80,490,2010_Tracy McGrady
2010,Trevor Ariza,SF,24,394,999,0.3943943943943944,136,407,0.33415233415233414,258,592,0.4358108108108108,148,228,0.6491228070175439,78,325,403,276,126,40,161,162,1072,2010_Trevor Ariza
2010,Wesley Matthews,SG,23,273,565,0.4831858407079646,63,165,0.38181818181818183,210,400,0.525,160,193,0.8290155440414507,50,141,191,124,64,15,93,152,769,2010_Wesley Matthews
2011,Brandan Wright,PF,23,120,234,0.5128205128205128,0,0,NaN,120,234,0.5128205128205128,42,62,0.6774193548387096,62,116,178,24,22,34,28,68,282,2011_Brandan Wright
2011,Chase Budinger,SF,22,279,656,0.4253048780487805,89,274,0.3248175182481752,190,382,0.4973821989528796,118,138,0.855072463768116,52,229,281,127,41,18,67,114,765,2011_Chase Budinger
2011,Greivis Vasquez,SG,24,95,233,0.40772532188841204,25,86,0.29069767441860467,70,147,0.47619047619047616,34,44,0.7727272727272727,12,61,73,151,22,4,70,83,249,2011_Greivis Vasquez
2011,Jared Dudley,SF,25,300,629,0.4769475357710652,105,253,0.4150197628458498,195,376,0.5186170212765957,162,218,0.7431192660550459,111,207,318,108,87,20,77,139,867,2011_Jared Dudley
2011,Lazar Hayward,SF,24,55,154,0.35714285714285715,17,60,0.2833333333333333,38,94,0.40425531914893614,33,42,0.7857142857142857,23,47,70,28,12,7,19,44,160,2011_Lazar Hayward
2011,Leon Powe,C_PF_C-PF,27,118,238,0.4957983193277311,0,4,0.0,118,234,0.5042735042735043,80,144,0.5555555555555556,48,78,126,14,20,8,24,88,316,2011_Leon Powe
2011,Lester Hudson,PG,26,6,24,0.25,4,15,0.26666666666666666,2,9,0.2222222222222222,2,4,0.5,1,4,5,17,4,1,7,10,18,2011_Lester Hudson
2011,Luther Head,PG,28,68,164,0.4146341463414634,25,64,0.390625,43,100,0.43,39,50,0.78,16,44,60,70,10,9,32,43,200,2011_Luther Head
2011,Maurice Evans,SF,32,354,848,0.41745283018867924,110,334,0.32934131736526945,244,514,0.47470817120622566,104,116,0.896551724137931,104,208,312,90,68,28,66,258,922,2011_Maurice Evans
2011,Sherron Collins,PG,23,7,25,0.28,2,10,0.2,5,15,0.3333333333333333,1,1,1.0,0,5,5,8,2,0,4,2,17,2011_Sherron Collins
2011,Tracy McGrady,SG,31,227,514,0.44163424124513617,30,88,0.3409090909090909,197,426,0.4624413145539906,90,129,0.6976744186046512,49,202,251,252,66,34,102,101,574,2011_Tracy McGrady
2011,Wesley Matthews,SG,24,440,979,0.449438202247191,154,378,0.4074074074074074,286,601,0.47587354409317806,266,315,0.8444444444444444,48,210,258,164,102,9,138,195,1300,2011_Wesley Matthews
2012,Alan Anderson,SF,29,55,142,0.3873239436619718,24,61,0.39344262295081966,31,81,0.38271604938271603,29,34,0.8529411764705882,8,26,34,26,5,3,25,35,163,2012_Alan Anderson
2012,Anthony Carter,PG,36,17,53,0.32075471698113206,5,17,0.29411764705882354,12,36,0.3333333333333333,8,10,0.8,5,28,33,34,8,4,17,20,47,2012_Anthony Carter
2012,Chauncey Billups,SG,35,83,228,0.36403508771929827,48,125,0.384,35,103,0.33980582524271846,85,95,0.8947368421052632,4,46,50,80,9,3,38,40,299,2012_Chauncey Billups
2012,Greg Smith,C,21,7,11,0.6363636363636364,0,0,NaN,7,11,0.6363636363636364,0,0,NaN,5,15,20,1,2,5,1,17,14,2012_Greg Smith
2012,Greivis Vasquez,SG,25,225,523,0.43021032504780116,43,135,0.31851851851851853,182,388,0.4690721649484536,96,117,0.8205128205128205,23,150,173,359,60,8,148,126,589,2012_Greivis Vasquez
2012,John Salmons,SF,32,141,345,0.40869565217391307,33,112,0.29464285714285715,108,233,0.463519313304721,29,45,0.6444444444444445,20,114,134,93,37,7,45,77,344,2012_John Salmons
2012,Jrue Holiday,PG,21,360,834,0.4316546762589928,65,171,0.38011695906432746,295,663,0.444947209653092,94,120,0.7833333333333333,57,155,212,290,103,18,135,137,879,2012_Jrue Holiday
2012,Lazar Hayward,SF,25,13,38,0.34210526315789475,4,14,0.2857142857142857,9,24,0.375,7,12,0.5833333333333334,2,14,16,4,3,1,9,18,37,2012_Lazar Hayward
2012,Lester Hudson,PG,27,124,324,0.38271604938271603,32,128,0.25,92,196,0.46938775510204084,68,82,0.8292682926829268,14,78,92,72,28,6,64,52,348,2012_Lester Hudson
2012,Luke Ridnour,SG,30,242,550,0.44,49,152,0.3223684210526316,193,398,0.4849246231155779,106,119,0.8907563025210085,19,122,141,252,56,16,96,136,639,2012_Luke Ridnour
2012,Maurice Evans,SF,33,45,112,0.4017857142857143,17,45,0.37777777777777777,28,67,0.417910447761194,10,13,0.7692307692307693,8,16,24,9,14,0,10,36,117,2012_Maurice Evans
2012,Quentin Richardson,SF,31,74,197,0.3756345177664975,42,121,0.34710743801652894,32,76,0.42105263157894735,25,30,0.8333333333333334,15,108,123,38,28,6,29,74,215,2012_Quentin Richardson
2012,Steve Nash,PG,37,295,555,0.5315315315315315,55,141,0.3900709219858156,240,414,0.5797101449275363,127,142,0.8943661971830986,26,160,186,664,38,8,229,53,772,2012_Steve Nash
2012,Taj Gibson,PF,26,200,404,0.49504950495049505,0,0,NaN,200,404,0.49504950495049505,84,135,0.6222222222222222,135,197,332,47,27,81,60,131,484,2012_Taj Gibson
2012,Tracy McGrady,SF,32,101,231,0.43722943722943725,15,33,0.45454545454545453,86,198,0.43434343434343436,56,83,0.6746987951807228,23,131,154,110,16,15,53,35,273,2012_Tracy McGrady
2012,Walker Russell,PG,29,33,95,0.3473684210526316,4,13,0.3076923076923077,29,82,0.35365853658536583,14,22,0.6363636363636364,7,19,26,58,18,1,33,29,84,2012_Walker Russell
2012,Wesley Matthews,SG,25,314,763,0.41153342070773263,129,337,0.3827893175074184,185,426,0.43427230046948356,147,171,0.8596491228070176,56,168,224,113,96,15,73,148,904,2012_Wesley Matthews
2013,Andray Blatche,C,26,346,676,0.5118343195266272,3,22,0.13636363636363635,343,654,0.5244648318042814,148,216,0.6851851851851852,161,256,417,85,86,54,123,163,843,2013_Andray Blatche
2013,Aron Baynes,C,26,18,36,0.5,0,1,0.0,18,35,0.5142857142857142,7,12,0.5833333333333334,12,20,32,5,1,6,11,23,43,2013_Aron Baynes
2013,Danilo Gallinari,SF,24,364,871,0.417910447761194,135,362,0.3729281767955801,229,509,0.449901768172888,286,348,0.8218390804597702,65,302,367,176,64,36,111,130,1149,2013_Danilo Gallinari
2013,Greivis Vasquez,PG,26,438,1012,0.43280632411067194,83,243,0.34156378600823045,355,769,0.4616384915474642,124,154,0.8051948051948052,43,294,337,704,66,6,247,190,1083,2013_Greivis Vasquez
2013,Josh McRoberts,PF,25,312,686,0.45481049562682213,48,168,0.2857142857142857,264,518,0.5096525096525096,130,170,0.7647058823529411,186,464,650,282,64,54,132,262,802,2013_Josh McRoberts
2013,Lance Stephenson,SG,22,275,598,0.459866220735786,62,188,0.32978723404255317,213,410,0.5195121951219512,75,115,0.6521739130434783,47,257,304,223,81,16,109,162,687,2013_Lance Stephenson
2013,Lazar Hayward,SF,26,2,10,0.2,0,4,0.0,2,6,0.3333333333333333,6,6,1.0,0,4,4,3,2,0,0,3,10,2013_Lazar Hayward
2013,Tony Allen,SG,31,284,638,0.445141065830721,3,24,0.125,281,614,0.4576547231270358,134,187,0.7165775401069518,121,242,363,98,119,44,94,211,705,2013_Tony Allen
2013,Wesley Matthews,SG,26,352,808,0.43564356435643564,169,425,0.3976470588235294,183,383,0.47780678851174935,149,187,0.7967914438502673,35,156,191,174,90,18,109,172,1022,2013_Wesley Matthews
2013,Will Barton,SG,22,118,309,0.3818770226537217,9,65,0.13846153846153847,109,244,0.44672131147540983,50,65,0.7692307692307693,36,109,145,58,34,9,60,56,295,2013_Will Barton
2014,Aron Baynes,C,27,71,163,0.43558282208588955,0,0,NaN,71,163,0.43558282208588955,19,21,0.9047619047619048,57,88,145,34,2,5,36,77,161,2014_Aron Baynes
2014,Brandon Bass,PF,28,352,725,0.48551724137931035,2,6,0.3333333333333333,350,719,0.48678720445062584,205,239,0.8577405857740585,161,309,470,87,36,71,102,190,911,2014_Brandon Bass
2014,Gerald Henderson,SG,26,403,930,0.43333333333333335,40,115,0.34782608695652173,363,815,0.44539877300613495,235,309,0.7605177993527508,31,279,310,199,51,32,113,159,1081,2014_Gerald Henderson
2014,Greg Oden,C,26,27,49,0.5510204081632653,0,0,NaN,27,49,0.5510204081632653,13,23,0.5652173913043478,23,31,54,1,7,13,12,52,67,2014_Greg Oden
2014,Greivis Vasquez,SG-PG_SG_PG,27,554,1316,0.4209726443768997,218,578,0.3771626297577855,336,738,0.45528455284552843,190,216,0.8796296296296297,40,306,346,646,62,10,256,286,1516,2014_Greivis Vasquez
2014,Kyle O'Quinn,C,23,186,371,0.5013477088948787,0,3,0.0,186,368,0.5054347826086957,57,83,0.6867469879518072,100,264,364,78,39,88,78,165,429,2014_Kyle O'Quinn
2014,Maurice Harkless,SF,20,224,483,0.463768115942029,59,154,0.38311688311688313,165,329,0.5015197568389058,85,143,0.5944055944055944,69,195,264,80,97,50,86,140,592,2014_Maurice Harkless
2014,Michael Kidd-Gilchrist,SF,20,167,353,0.4730878186968839,1,9,0.1111111111111111,166,344,0.48255813953488375,113,184,0.6141304347826086,109,215,324,52,43,39,60,145,448,2014_Michael Kidd-Gilchrist
2014,Reggie Bullock,SF,22,43,121,0.35537190082644626,22,73,0.3013698630136986,21,48,0.4375,7,9,0.7777777777777778,11,43,54,12,9,1,13,26,115,2014_Reggie Bullock
2014,Ryan Kelly,PF,22,157,371,0.42318059299191374,48,142,0.3380281690140845,109,229,0.4759825327510917,110,135,0.8148148148148148,42,177,219,95,32,45,47,147,472,2014_Ryan Kelly
2014,Scotty Hopson,SG,24,0,4,0.0,0,2,0.0,0,2,0.0,1,2,0.5,0,0,0,1,1,0,0,0,1,2014_Scotty Hopson
2014,Terrence Jones,PF,22,386,712,0.5421348314606742,31,101,0.3069306930693069,355,611,0.5810147299509002,118,195,0.6051282051282051,162,366,528,87,53,99,71,139,921,2014_Terrence Jones
2014,Vander Blue,SG,21,2,4,0.5,0,1,0.0,2,3,0.6666666666666666,1,5,0.2,0,3,3,1,0,0,2,1,5,2014_Vander Blue
2014,Wesley Matthews,SG,27,445,1009,0.44103072348860256,201,511,0.3933463796477495,244,498,0.4899598393574297,252,301,0.8372093023255814,51,238,289,197,76,14,110,176,1343,2014_Wesley Matthews
2014,Will Barton,SG,23,65,156,0.4166666666666667,10,33,0.30303030303030304,55,123,0.44715447154471544,26,32,0.8125,16,58,74,33,9,7,18,31,166,2014_Will Barton
2015,A.J. Price,PG,28,102,274,0.3722627737226277,30,114,0.2631578947368421,72,160,0.45,32,48,0.6666666666666666,12,52,64,92,14,0,28,30,266,2015_A.J. Price
2015,Alex Len,C,21,179,353,0.5070821529745042,1,3,0.3333333333333333,178,350,0.5085714285714286,73,104,0.7019230769230769,142,312,454,32,34,105,74,213,432,2015_Alex Len
2015,Aron Baynes,C,28,185,327,0.5657492354740061,1,4,0.25,184,323,0.5696594427244582,90,104,0.8653846153846154,109,209,318,35,16,22,65,162,461,2015_Aron Baynes
2015,Cameron Bairstow,PF,24,3,14,0.21428571428571427,0,0,NaN,3,14,0.21428571428571427,4,5,0.8,6,2,8,1,2,1,3,8,10,2015_Cameron Bairstow
2015,Dion Waiters,SG,23,750,1892,0.3964059196617336,146,492,0.2967479674796748,604,1400,0.43142857142857144,234,344,0.6802325581395349,82,302,384,326,180,42,226,310,1880,2015_Dion Waiters
2015,Donald Sloan,PG,27,145,355,0.4084507042253521,41,131,0.31297709923664124,104,224,0.4642857142857143,60,77,0.7792207792207793,12,131,143,190,23,0,65,47,391,2015_Donald Sloan
2015,Greivis Vasquez,PG,28,296,725,0.40827586206896554,133,351,0.3789173789173789,163,374,0.4358288770053476,50,66,0.7575757575757576,22,194,216,302,46,10,119,177,775,2015_Greivis Vasquez
2015,JaMychal Green,PF,24,54,94,0.574468085106383,0,12,0.0,54,82,0.6585365853658537,16,20,0.8,38,52,90,8,10,10,28,50,124,2015_JaMychal Green
2015,Nick Young,SG,29,174,476,0.36554621848739494,83,225,0.3688888888888889,91,251,0.36254980079681276,132,148,0.8918918918918919,17,79,96,41,23,11,44,83,563,2015_Nick Young
2015,Pero Antic,C,32,108,296,0.36486486486486486,52,173,0.30057803468208094,56,123,0.45528455284552843,88,123,0.7154471544715447,58,131,189,49,18,14,49,132,356,2015_Pero Antic
2015,Quincy Acy,PF,24,152,331,0.459214501510574,18,60,0.3,134,271,0.4944649446494465,76,97,0.7835051546391752,79,222,301,68,27,22,60,147,398,2015_Quincy Acy
2015,Quincy Pondexter,SF_SG_SF-SG,26,376,894,0.42058165548098436,182,488,0.3729508196721312,194,406,0.47783251231527096,142,192,0.7395833333333334,106,284,390,188,38,48,102,300,1076,2015_Quincy Pondexter
2015,Vander Blue,SG,22,9,30,0.3,2,10,0.2,7,20,0.35,2,5,0.4,2,7,9,8,3,0,6,4,22,2015_Vander Blue
2015,Wesley Matthews,SG,28,337,752,0.44813829787234044,173,445,0.3887640449438202,164,307,0.5342019543973942,109,145,0.7517241379310344,38,184,222,139,77,10,81,132,956,2015_Wesley Matthews
2015,Will Barton,SG,24,300,706,0.42492917847025496,46,170,0.27058823529411763,254,536,0.47388059701492535,148,188,0.7872340425531915,52,272,324,162,96,38,122,140,794,2015_Will Barton
2016,Aron Baynes,C,29,194,384,0.5052083333333334,0,2,0.0,194,382,0.5078534031413613,126,165,0.7636363636363637,140,244,384,51,21,52,67,151,514,2016_Aron Baynes
2016,Brandon Rush,SG,30,111,260,0.4269230769230769,65,157,0.4140127388535032,46,103,0.44660194174757284,18,28,0.6428571428571429,21,160,181,57,20,23,33,57,305,2016_Brandon Rush
2016,Cole Aldrich,C,27,134,225,0.5955555555555555,0,0,NaN,134,225,0.5955555555555555,60,84,0.7142857142857143,86,202,288,50,47,68,64,139,328,2016_Cole Aldrich
2016,Darrell Arthur,PF,27,221,489,0.45194274028629855,45,117,0.38461538461538464,176,372,0.4731182795698925,40,53,0.7547169811320755,86,207,293,96,53,48,66,185,527,2016_Darrell Arthur
2016,DeJuan Blair,C,26,28,68,0.4117647058823529,0,1,0.0,28,67,0.417910447761194,5,13,0.38461538461538464,20,37,57,11,8,2,15,53,61,2016_DeJuan Blair
2016,Greivis Vasquez,PG,29,45,138,0.32608695652173914,18,73,0.2465753424657534,27,65,0.4153846153846154,22,26,0.8461538461538461,5,42,47,91,10,0,40,42,130,2016_Greivis Vasquez
2016,Lucas Nogueira,C,23,28,44,0.6363636363636364,1,3,0.3333333333333333,27,41,0.6585365853658537,8,15,0.5333333333333333,18,28,46,7,12,12,11,29,65,2016_Lucas Nogueira
2016,Mirza Teletovic,PF,30,332,777,0.4272844272844273,181,460,0.3934782608695652,151,317,0.47634069400630913,120,155,0.7741935483870968,55,247,302,89,32,21,84,159,965,2016_Mirza Teletovic
2016,Monta Ellis,SG,30,436,1021,0.42703232125367285,87,282,0.30851063829787234,349,739,0.4722598105548038,162,206,0.7864077669902912,42,229,271,383,150,37,203,174,1121,2016_Monta Ellis
2016,Raul Neto,PG,23,180,418,0.430622009569378,64,162,0.3950617283950617,116,256,0.453125,52,70,0.7428571428571429,17,103,120,174,62,2,109,122,476,2016_Raul Neto
2016,Tiago Splitter,C,31,81,155,0.5225806451612903,0,2,0.0,81,153,0.5294117647058824,39,48,0.8125,45,75,120,30,20,12,24,71,201,2016_Tiago Splitter
2016,Tim Duncan,C,39,215,441,0.4875283446712018,0,2,0.0,215,439,0.489749430523918,92,131,0.7022900763358778,115,332,447,163,47,78,90,125,522,2016_Tim Duncan
2016,Wesley Matthews,SF,29,331,854,0.3875878220140515,189,525,0.36,142,329,0.4316109422492401,126,146,0.863013698630137,27,211,238,151,78,17,78,179,977,2016_Wesley Matthews
2016,Will Barton,SG,25,425,983,0.4323499491353001,112,325,0.3446153846153846,313,658,0.4756838905775076,216,268,0.8059701492537313,59,417,476,203,71,39,139,147,1178,2016_Will Barton
2017,Al Jefferson,C,32,235,471,0.4989384288747346,0,1,0.0,235,470,0.5,65,85,0.7647058823529411,75,203,278,57,19,16,33,125,535,2017_Al Jefferson
2017,Domantas Sabonis,PF,20,192,481,0.3991683991683992,51,159,0.32075471698113206,141,322,0.43788819875776397,44,67,0.6567164179104478,45,242,287,82,39,32,83,200,479,2017_Domantas Sabonis
2017,Isaiah Taylor,PG,22,1,7,0.14285714285714285,0,2,0.0,1,5,0.2,1,2,0.5,1,2,3,3,1,1,0,6,3,2017_Isaiah Taylor
2017,John Lucas,PG,34,1,4,0.25,0,1,0.0,1,3,0.3333333333333333,0,0,NaN,0,0,0,1,2,0,0,0,2,2017_John Lucas
2017,Mirza Teletovic,PF,31,156,418,0.37320574162679426,104,305,0.34098360655737703,52,113,0.46017699115044247,35,45,0.7777777777777778,11,151,162,48,12,13,37,109,451,2017_Mirza Teletovic
2017,Monta Ellis,SG,31,247,557,0.44344703770197486,43,135,0.31851851851851853,204,422,0.4834123222748815,93,128,0.7265625,19,185,204,236,79,27,135,149,630,2017_Monta Ellis
2017,Raul Neto,PG,24,41,91,0.45054945054945056,10,31,0.3225806451612903,31,60,0.5166666666666667,8,9,0.8888888888888888,4,26,30,34,21,5,15,48,100,2017_Raul Neto
2017,Semaj Christon,PG,24,77,223,0.3452914798206278,12,63,0.19047619047619047,65,160,0.40625,17,31,0.5483870967741935,19,69,88,130,28,6,43,79,183,2017_Semaj Christon
2017,Skal Labissiere,PF,20,117,218,0.536697247706422,3,8,0.375,114,210,0.5428571428571428,52,74,0.7027027027027027,51,111,162,27,16,13,37,64,289,2017_Skal Labissiere
2017,Tim Quarterman,SG,22,13,29,0.4482758620689655,5,13,0.38461538461538464,8,16,0.5,0,3,0.0,4,10,14,11,2,3,11,6,31,2017_Tim Quarterman
2017,Timofey Mozgov,C,30,169,328,0.5152439024390244,0,1,0.0,169,327,0.5168195718654435,63,78,0.8076923076923077,104,160,264,43,16,31,72,133,401,2017_Timofey Mozgov
2017,Will Barton,SG,26,295,666,0.44294294294294295,87,235,0.3702127659574468,208,431,0.48259860788863107,143,190,0.7526315789473684,58,200,258,206,48,28,97,110,820,2017_Will Barton
2003,Chris Dudley,C,37,0,1,0.0,0,0,NaN,0,1,0.0,0,0,NaN,2,0,2,0,0,0,0,3,0,2003_Chris Dudley
2003,Christian Laettner,PF,33,255,516,0.4941860465116279,2,16,0.125,253,500,0.506,120,144,0.8333333333333334,114,388,502,235,82,40,87,206,632,2003_Christian Laettner
2003,Eric Williams,SF,30,254,575,0.44173913043478263,37,110,0.33636363636363636,217,465,0.4666666666666667,201,268,0.75,143,239,382,140,86,19,97,234,746,2003_Eric Williams
2003,Jeff McInnis,PG,28,188,423,0.4444444444444444,6,35,0.17142857142857143,182,388,0.4690721649484536,50,67,0.746268656716418,22,75,97,170,21,2,75,117,432,2003_Jeff McInnis
2003,Kevin Garnett,PF,26,743,1481,0.5016880486158002,20,71,0.28169014084507044,723,1410,0.5127659574468085,377,502,0.750996015936255,244,858,1102,495,113,129,229,199,1883,2003_Kevin Garnett
2003,Mamadou N'Diaye,C,27,43,96,0.4479166666666667,0,0,NaN,43,96,0.4479166666666667,34,47,0.723404255319149,29,53,82,7,8,32,21,58,120,2003_Mamadou N'Diaye
2003,Marc Jackson,C,28,153,349,0.4383954154727794,1,1,1.0,152,348,0.4367816091954023,114,149,0.7651006711409396,86,139,225,37,24,30,59,137,421,2003_Marc Jackson
2003,Mehmet Okur,PF,23,180,423,0.425531914893617,38,112,0.3392857142857143,142,311,0.4565916398713826,96,131,0.732824427480916,117,218,335,71,25,39,66,167,494,2003_Mehmet Okur
2003,Nazr Mohammed,C,25,67,159,0.42138364779874216,0,0,NaN,67,159,0.42138364779874216,26,41,0.6341463414634146,47,82,129,6,16,21,25,79,160,2003_Nazr Mohammed
2003,Nene Hilario,C,20,321,619,0.518578352180937,0,3,0.0,321,616,0.5211038961038961,197,341,0.5777126099706745,208,283,491,149,127,65,181,295,839,2003_Nene Hilario
2003,Scott Padgett,PF,26,170,423,0.40189125295508277,45,133,0.3383458646616541,125,290,0.43103448275862066,81,107,0.7570093457943925,83,189,272,86,41,24,70,148,466,2003_Scott Padgett
2003,Shareef Abdur-Rahim,PF,26,566,1183,0.47844463229078615,21,60,0.35,545,1123,0.4853072128227961,455,541,0.8410351201478743,175,502,677,242,87,38,212,240,1608,2003_Shareef Abdur-Rahim
2004,Alton Ford,PF,22,6,11,0.5454545454545454,0,0,NaN,6,11,0.5454545454545454,3,6,0.5,3,8,11,3,0,1,3,9,15,2004_Alton Ford
2004,Dajuan Wagner,SG,20,112,306,0.3660130718954248,31,86,0.36046511627906974,81,220,0.36818181818181817,32,47,0.6808510638297872,9,49,58,51,26,7,41,89,287,2004_Dajuan Wagner
2004,Dan Gadzuric,C,25,183,349,0.5243553008595988,0,1,0.0,183,348,0.5258620689655172,58,118,0.4915254237288136,126,220,346,28,51,105,45,186,424,2004_Dan Gadzuric
2004,DerMarr Johnson,SF,23,36,97,0.3711340206185567,13,36,0.3611111111111111,23,61,0.3770491803278688,28,31,0.9032258064516129,5,34,39,11,8,7,16,32,113,2004_DerMarr Johnson
2004,Eric Williams,SF,31,462,1196,0.3862876254180602,70,254,0.2755905511811024,392,942,0.416135881104034,430,566,0.7597173144876325,130,442,572,240,140,18,176,360,1424,2004_Eric Williams
2004,Gordan Giricek,SF_SG_SF-SG,26,632,1448,0.43646408839779005,120,304,0.39473684210526316,512,1144,0.44755244755244755,270,316,0.8544303797468354,102,350,452,244,112,30,206,288,1654,2004_Gordan Giricek
2004,Jalen Rose,PG-SF_SF_PG,31,766,1904,0.4023109243697479,138,404,0.3415841584158416,628,1500,0.4186666666666667,374,462,0.8095238095238095,68,464,532,658,102,44,416,368,2044,2004_Jalen Rose
2004,Jarvis Hayes,SF,22,278,695,0.4,40,131,0.3053435114503817,238,564,0.4219858156028369,77,98,0.7857142857142857,71,193,264,106,71,11,110,157,673,2004_Jarvis Hayes
2004,Jerry Stackhouse,SF,29,128,321,0.3987538940809969,23,65,0.35384615384615387,105,256,0.41015625,83,103,0.8058252427184466,16,78,94,103,24,3,88,49,362,2004_Jerry Stackhouse
2004,Kevin Garnett,PF,27,804,1611,0.49906890130353815,11,43,0.2558139534883721,793,1568,0.5057397959183674,368,465,0.7913978494623656,245,894,1139,409,120,178,212,202,1987,2004_Kevin Garnett
2004,Mamadou N'Diaye,C,28,54,138,0.391304347826087,0,0,NaN,54,138,0.391304347826087,88,118,0.7457627118644068,86,138,224,0,16,50,36,118,196,2004_Mamadou N'Diaye
2004,Mehmet Okur,PF,24,251,542,0.46309963099630996,18,48,0.375,233,494,0.4716599190283401,162,209,0.7751196172248804,160,261,421,69,36,63,101,138,682,2004_Mehmet Okur
2004,Nazr Mohammed,C,26,492,944,0.5211864406779662,0,0,NaN,492,944,0.5211864406779662,200,338,0.591715976331361,356,592,948,72,110,104,192,390,1184,2004_Nazr Mohammed
2004,Olden Polynice,C,39,0,0,NaN,0,0,NaN,0,0,NaN,0,0,NaN,1,1,2,1,1,0,4,2,0,2004_Olden Polynice
2004,Scott Padgett,PF,27,74,167,0.4431137724550898,28,65,0.4307692307692308,46,102,0.45098039215686275,24,32,0.75,46,93,139,23,12,13,22,73,200,2004_Scott Padgett
2004,Shareef Abdur-Rahim,PF,27,1002,2108,0.47533206831119545,18,68,0.2647058823529412,984,2040,0.4823529411764706,746,858,0.8694638694638694,378,900,1278,348,136,74,368,444,2768,2004_Shareef Abdur-Rahim
2004,Zarko Cabarkapa,PF,22,81,197,0.41116751269035534,6,32,0.1875,75,165,0.45454545454545453,35,53,0.660377358490566,26,73,99,40,10,13,54,75,203,2004_Zarko Cabarkapa
2005,Carmelo Anthony,SF,20,530,1230,0.43089430894308944,42,158,0.26582278481012656,488,1072,0.4552238805970149,456,573,0.7958115183246073,141,285,426,194,68,30,224,229,1558,2005_Carmelo Anthony
2005,Dajuan Wagner,SG,21,18,55,0.32727272727272727,5,26,0.19230769230769232,13,29,0.4482758620689655,3,4,0.75,0,2,2,13,5,0,9,15,44,2005_Dajuan Wagner
2005,DerMarr Johnson,SG,24,185,371,0.49865229110512127,53,148,0.3581081081081081,132,223,0.5919282511210763,80,101,0.7920792079207921,43,108,151,75,43,18,65,140,503,2005_DerMarr Johnson
2005,Eric Williams,SG,32,284,660,0.4303030303030303,56,146,0.3835616438356164,228,514,0.44357976653696496,224,322,0.6956521739130435,88,256,344,184,76,8,120,294,848,2005_Eric Williams
2005,Jake Voskuhl,C,27,27,59,0.4576271186440678,0,0,NaN,27,59,0.4576271186440678,26,38,0.6842105263157895,30,62,92,17,4,11,20,60,80,2005_Jake Voskuhl
2005,Jarron Collins,C,26,65,157,0.4140127388535032,0,1,0.0,65,156,0.4166666666666667,83,119,0.6974789915966386,57,107,164,61,11,6,34,146,213,2005_Jarron Collins
2005,Kevin Garnett,PF,28,683,1360,0.5022058823529412,6,25,0.24,677,1335,0.5071161048689139,445,549,0.8105646630236795,247,861,1108,466,121,112,222,207,1817,2005_Kevin Garnett
2005,Larry Hughes,SG,26,467,1086,0.4300184162062615,59,209,0.2822966507177033,408,877,0.4652223489167617,352,453,0.7770419426048565,74,308,382,285,176,18,153,168,1345,2005_Larry Hughes
2005,Mamadou N'Diaye,C,29,8,20,0.4,0,1,0.0,8,19,0.42105263157894735,4,7,0.5714285714285714,9,9,18,1,1,5,0,20,20,2005_Mamadou N'Diaye
2005,Mehmet Okur,C,25,354,756,0.46825396825396826,17,63,0.2698412698412698,337,693,0.4862914862914863,329,387,0.8501291989664083,194,422,616,166,32,68,141,227,1054,2005_Mehmet Okur
2005,Nazr Mohammed,C,27,578,1204,0.48006644518272423,0,2,0.0,578,1202,0.480865224625624,306,454,0.6740088105726872,494,678,1172,68,116,172,216,472,1462,2005_Nazr Mohammed
2005,Pavel Podkolzin,C,20,0,0,NaN,0,0,NaN,0,0,NaN,1,2,0.5,0,2,2,0,0,0,2,4,1,2005_Pavel Podkolzin
2005,Scott Padgett,PF,28,98,233,0.4206008583690987,50,126,0.3968253968253968,48,107,0.4485981308411215,29,40,0.725,47,138,185,55,33,10,30,119,275,2005_Scott Padgett
2005,Shareef Abdur-Rahim,PF,28,337,670,0.5029850746268657,15,39,0.38461538461538464,322,631,0.5103011093502378,220,254,0.8661417322834646,123,269,392,111,49,26,117,150,909,2005_Shareef Abdur-Rahim
2005,Zarko Cabarkapa,PF,23,172,354,0.4858757062146893,26,72,0.3611111111111111,146,282,0.5177304964539007,106,130,0.8153846153846154,70,134,204,50,20,10,60,118,476,2005_Zarko Cabarkapa
2006,Amir Johnson,SF,18,7,10,0.7,2,3,0.6666666666666666,5,7,0.7142857142857143,4,4,1.0,3,1,4,3,0,2,4,7,20,2006_Amir Johnson
2006,Andre Owens,PG,25,27,74,0.36486486486486486,3,16,0.1875,24,58,0.41379310344827586,12,18,0.6666666666666666,11,10,21,8,5,0,13,25,69,2006_Andre Owens
2006,Andrew Bynum,C,18,33,82,0.4024390243902439,0,0,NaN,33,82,0.4024390243902439,8,27,0.2962962962962963,34,46,80,9,4,22,17,56,74,2006_Andrew Bynum
2006,Billy Thomas,SG,30,13,40,0.325,10,30,0.3333333333333333,3,10,0.3,2,2,1.0,5,9,14,9,10,1,6,19,38,2006_Billy Thomas
2006,Carmelo Anthony,SF,21,756,1572,0.48091603053435117,37,152,0.24342105263157895,719,1420,0.5063380281690141,573,709,0.8081805359661495,122,272,394,216,88,42,218,229,2122,2006_Carmelo Anthony
2006,DerMarr Johnson,SG,25,132,306,0.43137254901960786,56,160,0.35,76,146,0.5205479452054794,34,42,0.8095238095238095,19,77,96,55,25,26,46,86,354,2006_DerMarr Johnson
2006,Dorell Wright,SF,20,20,43,0.46511627906976744,3,6,0.5,17,37,0.4594594594594595,15,17,0.8823529411764706,2,30,32,8,3,1,14,12,58,2006_Dorell Wright
2006,Eric Williams,SF,33,29,75,0.38666666666666666,5,18,0.2777777777777778,24,57,0.42105263157894735,28,38,0.7368421052631579,10,40,50,15,7,2,15,55,91,2006_Eric Williams
2006,Jose Calderon,SG,24,132,312,0.4230769230769231,7,43,0.16279069767441862,125,269,0.4646840148698885,78,92,0.8478260869565217,30,111,141,288,42,4,101,93,349,2006_Jose Calderon
2006,Keith Van,SF,30,164,387,0.42377260981912146,50,136,0.36764705882352944,114,251,0.4541832669322709,94,113,0.831858407079646,54,138,192,37,31,11,71,121,472,2006_Keith Van
2006,Kevin Burleson,PG,26,22,88,0.25,10,54,0.18518518518518517,12,34,0.35294117647058826,16,17,0.9411764705882353,4,22,26,48,26,2,25,63,70,2006_Kevin Burleson
2006,Kevin Garnett,PF,29,626,1191,0.5256087321578505,8,30,0.26666666666666666,618,1161,0.5322997416020672,396,489,0.8098159509202454,214,752,966,308,104,107,180,206,1656,2006_Kevin Garnett
2006,Martell Webster,SF,19,139,348,0.3994252873563218,65,182,0.35714285714285715,74,166,0.4457831325301205,61,71,0.8591549295774648,29,101,130,34,21,14,43,90,404,2006_Martell Webster
2006,Mehmet Okur,PF,26,519,1128,0.4601063829787234,80,234,0.3418803418803419,439,894,0.49105145413870244,354,454,0.7797356828193832,211,535,746,194,40,73,163,285,1472,2006_Mehmet Okur
2006,Nazr Mohammed,C,28,190,377,0.5039787798408488,0,0,NaN,190,377,0.5039787798408488,113,144,0.7847222222222222,163,255,418,40,21,49,91,220,493,2006_Nazr Mohammed
2006,P.J. Brown,C,36,269,583,0.4614065180102916,0,0,NaN,269,583,0.4614065180102916,139,168,0.8273809523809523,182,365,547,90,46,50,90,216,677,2006_P.J. Brown
2006,Pavel Podkolzin,C,21,0,2,0.0,0,0,NaN,0,2,0.0,3,6,0.5,0,7,7,0,0,1,2,0,3,2006_Pavel Podkolzin
2006,Scott Padgett,PF,29,71,201,0.35323383084577115,42,121,0.34710743801652894,29,80,0.3625,27,34,0.7941176470588235,56,109,165,41,28,12,21,90,211,2006_Scott Padgett
2006,Shareef Abdur-Rahim,PF,29,332,632,0.5253164556962026,5,22,0.22727272727272727,327,610,0.5360655737704918,218,278,0.7841726618705036,106,251,357,149,48,42,108,227,887,2006_Shareef Abdur-Rahim
2006,Wayne Simien,PF,22,58,120,0.48333333333333334,0,0,NaN,58,120,0.48333333333333334,30,34,0.8823529411764706,38,50,88,7,13,1,24,70,146,2006_Wayne Simien
2006,Zarko Cabarkapa,PF,24,67,174,0.3850574712643678,5,20,0.25,62,154,0.4025974025974026,60,84,0.7142857142857143,37,74,111,20,13,7,35,87,199,2006_Zarko Cabarkapa
2007,Anthony Carter,PG,31,3,8,0.375,0,2,0.0,3,6,0.5,0,0,NaN,0,3,3,11,0,1,6,4,6,2007_Anthony Carter
2007,Carmelo Anthony,SF,22,691,1453,0.4755677907777013,40,149,0.2684563758389262,651,1304,0.49923312883435583,459,568,0.8080985915492958,143,248,391,249,77,23,234,203,1881,2007_Carmelo Anthony
2007,Chauncey Billups,PG,30,348,815,0.4269938650306748,109,316,0.3449367088607595,239,499,0.4789579158316633,386,437,0.8832951945080092,23,214,237,502,84,17,140,161,1191,2007_Chauncey Billups
2007,Dajuan Wagner,SG,23,1,1,1.0,1,1,1.0,0,0,NaN,1,2,0.5,0,0,0,1,0,0,1,1,4,2007_Dajuan Wagner
2007,DerMarr Johnson,SF,26,50,154,0.3246753246753247,19,88,0.2159090909090909,31,66,0.4696969696969697,16,21,0.7619047619047619,10,47,57,17,16,12,27,39,135,2007_DerMarr Johnson
2007,Dorell Wright,SF,21,162,364,0.44505494505494503,5,34,0.14705882352941177,157,330,0.47575757575757577,64,86,0.7441860465116279,40,232,272,95,41,46,65,112,393,2007_Dorell Wright
2007,Eric Williams,SF,34,38,94,0.40425531914893614,16,38,0.42105263157894735,22,56,0.39285714285714285,16,28,0.5714285714285714,6,28,34,14,6,0,14,24,108,2007_Eric Williams
2007,Jamaal Tinsley,PG,28,346,889,0.3892013498312711,61,193,0.3160621761658031,285,696,0.40948275862068967,172,239,0.7196652719665272,60,180,240,494,117,25,200,190,925,2007_Jamaal Tinsley
2007,Jerome James,C,31,33,79,0.4177215189873418,0,0,NaN,33,79,0.4177215189873418,10,18,0.5555555555555556,21,45,66,3,6,15,23,73,76,2007_Jerome James
2007,Jose Calderon,PG,25,263,505,0.5207920792079208,25,75,0.3333333333333333,238,430,0.5534883720930233,117,143,0.8181818181818182,21,113,134,387,63,5,110,136,668,2007_Jose Calderon
2007,Malik Rose,PF,32,74,186,0.3978494623655914,2,8,0.25,72,178,0.4044943820224719,42,52,0.8076923076923077,47,128,175,65,26,9,65,120,192,2007_Malik Rose
2007,Mehmet Okur,C,27,490,1061,0.46182846371347785,129,336,0.38392857142857145,361,725,0.4979310344827586,296,387,0.7648578811369509,160,419,579,156,36,38,125,257,1405,2007_Mehmet Okur
2007,Mile Ilic,C,22,0,3,0.0,0,0,NaN,0,3,0.0,0,0,NaN,0,1,1,0,0,0,3,1,0,2007_Mile Ilic
2007,Nazr Mohammed,C,29,118,222,0.5315315315315315,0,0,NaN,118,222,0.5315315315315315,50,82,0.6097560975609756,89,140,229,9,27,40,43,133,286,2007_Nazr Mohammed
2007,Patrick O'Bryant,C,20,10,32,0.3125,0,0,NaN,10,32,0.3125,11,17,0.6470588235294118,7,14,21,9,6,8,8,26,31,2007_Patrick O'Bryant
2007,Renaldo Major,PF,24,2,10,0.2,0,0,NaN,2,10,0.2,1,2,0.5,0,2,2,0,2,0,1,4,5,2007_Renaldo Major
2007,Samuel Dalembert,C,25,356,658,0.541033434650456,0,2,0.0,356,656,0.5426829268292683,167,224,0.7455357142857143,239,494,733,64,47,159,161,287,879,2007_Samuel Dalembert
2007,Steve Nash,PG,32,517,971,0.5324407826982492,156,343,0.45481049562682213,361,628,0.5748407643312102,222,247,0.8987854251012146,30,239,269,884,57,6,287,117,1412,2007_Steve Nash
2007,Thabo Sefolosha,SG,22,109,256,0.42578125,15,42,0.35714285714285715,94,214,0.4392523364485981,23,45,0.5111111111111111,35,118,153,60,33,11,60,100,256,2007_Thabo Sefolosha
2008,Adonal Foyle,C,32,70,153,0.45751633986928103,0,0,NaN,70,153,0.45751633986928103,16,34,0.47058823529411764,71,137,208,18,16,45,32,94,156,2008_Adonal Foyle
2008,Andray Blatche,PF,21,254,536,0.47388059701492535,3,13,0.23076923076923078,251,523,0.47992351816443596,107,154,0.6948051948051948,164,261,425,92,53,114,112,258,618,2008_Andray Blatche
2008,Andre Owens,PG,27,40,107,0.37383177570093457,18,40,0.45,22,67,0.3283582089552239,25,34,0.7352941176470589,13,34,47,47,13,3,24,37,123,2008_Andre Owens
2008,Carmelo Anthony,SF,23,728,1481,0.49155975692099935,58,164,0.35365853658536583,670,1317,0.5087319665907365,464,590,0.7864406779661017,178,393,571,259,98,39,253,253,1978,2008_Carmelo Anthony
2008,DerMarr Johnson,SF,27,7,14,0.5,3,9,0.3333333333333333,4,5,0.8,0,2,0.0,0,1,1,1,1,0,0,4,17,2008_DerMarr Johnson
2008,Derek Anderson,SG,33,47,125,0.376,19,52,0.36538461538461536,28,73,0.3835616438356164,28,38,0.7368421052631579,9,43,52,44,12,1,25,49,141,2008_Derek Anderson
2008,Dorell Wright,SF,22,143,293,0.4880546075085324,4,11,0.36363636363636365,139,282,0.4929078014184397,57,69,0.8260869565217391,48,172,220,60,29,41,29,79,347,2008_Dorell Wright
2008,Dwayne Jones,PF,24,25,47,0.5319148936170213,0,1,0.0,25,46,0.5434782608695652,28,58,0.4827586206896552,69,71,140,10,10,25,17,88,78,2008_Dwayne Jones
2008,Jason Kapono,SF,26,243,498,0.4879518072289157,57,118,0.4830508474576271,186,380,0.48947368421052634,37,43,0.8604651162790697,31,89,120,65,34,2,58,131,580,2008_Jason Kapono
2008,Jose Calderon,PG,26,367,707,0.5190947666195191,79,184,0.42934782608695654,288,523,0.5506692160611855,109,120,0.9083333333333333,34,202,236,678,87,6,126,134,922,2008_Jose Calderon
2008,Josh McRoberts,PF,20,6,10,0.6,0,1,0.0,6,9,0.6666666666666666,0,0,NaN,2,8,10,2,1,0,2,1,12,2008_Josh McRoberts
2008,Mehmet Okur,C,28,374,841,0.4447086801426873,114,294,0.3877551020408163,260,547,0.4753199268738574,185,230,0.8043478260869565,132,424,556,145,55,29,104,236,1047,2008_Mehmet Okur
2008,Thabo Sefolosha,SG,23,180,421,0.42755344418052255,29,88,0.32954545454545453,151,333,0.45345345345345345,75,104,0.7211538461538461,50,205,255,129,61,30,93,128,464,2008_Thabo Sefolosha
2008,Tyson Chandler,C,25,377,605,0.6231404958677685,0,1,0.0,377,604,0.6241721854304636,175,295,0.5932203389830508,322,606,928,81,45,84,136,243,929,2008_Tyson Chandler
2009,Alexis Ajinca,PF,20,25,69,0.36231884057971014,0,2,0.0,25,67,0.373134328358209,20,28,0.7142857142857143,9,21,30,3,7,6,12,34,70,2009_Alexis Ajinca
2009,Brandon Bass,C,23,252,508,0.49606299212598426,0,6,0.0,252,502,0.50199203187251,182,210,0.8666666666666667,129,238,367,43,27,55,86,140,686,2009_Brandon Bass
2009,Carmelo Anthony,SF,24,535,1207,0.44324772162386084,63,170,0.37058823529411766,472,1037,0.45515911282545807,371,468,0.7927350427350427,106,344,450,222,75,24,199,195,1504,2009_Carmelo Anthony
2009,Damien Wilkins,SG,29,77,213,0.3615023474178404,27,72,0.375,50,141,0.3546099290780142,37,46,0.8043478260869565,20,50,70,37,22,7,37,55,218,2009_Damien Wilkins
2009,Dorell Wright,SF,23,8,20,0.4,0,0,NaN,8,20,0.4,2,6,0.3333333333333333,2,18,20,2,2,0,6,8,18,2009_Dorell Wright
2009,Gilbert Arenas,PG,27,6,23,0.2608695652173913,2,7,0.2857142857142857,4,16,0.25,12,16,0.75,1,8,9,20,0,1,1,4,26,2009_Gilbert Arenas
2009,Joe Alexander,SF,22,102,245,0.4163265306122449,16,46,0.34782608695652173,86,199,0.4321608040201005,58,83,0.6987951807228916,44,71,115,42,15,29,52,107,278,2009_Joe Alexander
2009,Jose Calderon,PG,27,320,644,0.4968944099378882,82,202,0.40594059405940597,238,442,0.5384615384615384,151,154,0.9805194805194806,16,178,194,607,74,7,143,114,873,2009_Jose Calderon
2009,Mehmet Okur,C,29,431,888,0.48536036036036034,90,202,0.44554455445544555,341,686,0.4970845481049563,273,334,0.8173652694610778,124,433,557,120,54,53,132,219,1225,2009_Mehmet Okur
2009,Nicolas Batum,SF,20,161,361,0.44598337950138506,62,168,0.36904761904761907,99,193,0.5129533678756477,42,52,0.8076923076923077,84,136,220,74,50,40,50,139,426,2009_Nicolas Batum
2009,Thabo Sefolosha,SF_SG_SF-SG,24,304,714,0.4257703081232493,48,174,0.27586206896551724,256,540,0.4740740740740741,122,146,0.8356164383561644,108,376,484,222,150,90,128,208,778,2009_Thabo Sefolosha
2010,Alando Tucker,SF,25,34,78,0.4358974358974359,2,14,0.14285714285714285,32,64,0.5,32,42,0.7619047619047619,12,8,20,8,0,0,10,12,102,2010_Alando Tucker
2010,Austin Daye,SF,21,137,295,0.46440677966101696,29,95,0.30526315789473685,108,200,0.54,46,56,0.8214285714285714,34,140,174,34,25,26,48,114,349,2010_Austin Daye
2010,Jodie Meeks,SG,22,208,536,0.3880597014925373,84,264,0.3181818181818182,124,272,0.45588235294117646,62,78,0.7948717948717948,18,180,198,78,36,10,50,104,562,2010_Jodie Meeks
2010,Julian Wright,SF,22,116,232,0.5,2,6,0.3333333333333333,114,226,0.504424778761062,25,41,0.6097560975609756,58,86,144,41,29,18,44,45,259,2010_Julian Wright
2010,Kevin Garnett,PF,33,402,772,0.5207253886010362,1,5,0.2,401,767,0.5228161668839635,185,221,0.8371040723981901,78,428,506,185,68,57,101,170,990,2010_Kevin Garnett
2010,Marcin Gortat,C,25,121,227,0.5330396475770925,0,3,0.0,121,224,0.5401785714285714,51,75,0.68,104,237,341,17,17,70,46,138,293,2010_Marcin Gortat
2010,Martell Webster,SF,23,259,639,0.405320813771518,124,332,0.37349397590361444,135,307,0.43973941368078173,126,155,0.8129032258064516,47,221,268,62,45,40,60,153,768,2010_Martell Webster
2010,Mehmet Okur,C,30,355,775,0.45806451612903226,82,213,0.38497652582159625,273,562,0.48576512455516013,196,239,0.8200836820083682,132,383,515,119,38,81,127,223,988,2010_Mehmet Okur
2010,Nazr Mohammed,C,32,189,342,0.5526315789473685,0,0,NaN,189,342,0.5526315789473685,81,125,0.648,114,190,304,28,15,43,53,105,459,2010_Nazr Mohammed
2010,Randolph Morris,PF,24,23,41,0.5609756097560976,0,0,NaN,23,41,0.5609756097560976,16,27,0.5925925925925926,10,28,38,2,5,3,12,34,62,2010_Randolph Morris
2010,Rodney Carney,SG,25,113,282,0.40070921985815605,41,135,0.3037037037037037,72,147,0.4897959183673469,52,63,0.8253968253968254,26,111,137,37,25,20,21,79,319,2010_Rodney Carney
2010,Sean Williams,PF,23,21,49,0.42857142857142855,0,1,0.0,21,48,0.4375,10,19,0.5263157894736842,21,25,46,1,8,19,20,41,52,2010_Sean Williams
2011,Al Horford,C,24,513,921,0.5570032573289903,2,4,0.5,511,917,0.5572519083969466,150,188,0.7978723404255319,182,536,718,266,59,80,119,193,1178,2011_Al Horford
2011,Antawn Jamison,PF,34,374,876,0.4269406392694064,91,263,0.34600760456273766,283,613,0.46166394779771613,171,234,0.7307692307692307,86,289,375,93,50,30,77,137,1010,2011_Antawn Jamison
2011,Austin Daye,SF,22,193,471,0.40976645435244163,69,172,0.4011627906976744,124,299,0.41471571906354515,82,108,0.7592592592592593,64,210,274,78,39,39,59,165,537,2011_Austin Daye
2011,Brandon Rush,SG,25,217,515,0.42135922330097086,93,223,0.4170403587443946,124,292,0.4246575342465753,80,106,0.7547169811320755,33,184,217,62,41,35,69,107,607,2011_Brandon Rush
2011,Delonte West,PG,27,55,120,0.4583333333333333,12,33,0.36363636363636365,43,87,0.4942528735632184,13,15,0.8666666666666667,6,31,37,64,20,10,30,29,135,2011_Delonte West
2011,Hamady N'Diaye,C,24,4,5,0.8,0,0,NaN,4,5,0.8,6,12,0.5,2,5,7,0,2,5,3,18,14,2011_Hamady N'Diaye
2011,Jodie Meeks,SG,23,242,570,0.4245614035087719,138,348,0.39655172413793105,104,222,0.46846846846846846,152,170,0.8941176470588236,21,150,171,78,63,4,60,97,774,2011_Jodie Meeks
2011,Julian Wright,SF,23,82,160,0.5125,2,10,0.2,80,150,0.5333333333333333,22,43,0.5116279069767442,47,71,118,58,39,20,43,45,188,2011_Julian Wright
2011,Kevin Garnett,PF,34,434,822,0.5279805352798054,1,5,0.2,433,817,0.5299877600979193,187,217,0.8617511520737328,83,548,631,171,95,57,115,148,1056,2011_Kevin Garnett
2011,Marcin Gortat,C,26,676,1206,0.560530679933665,2,8,0.25,674,1198,0.5626043405676127,280,386,0.7253886010362695,296,966,1262,140,72,182,162,376,1634,2011_Marcin Gortat
2011,Martell Webster,SF,24,152,340,0.4470588235294118,55,132,0.4166666666666667,97,208,0.46634615384615385,94,122,0.7704918032786885,36,111,147,53,28,9,58,101,453,2011_Martell Webster
2011,Mehmet Okur,C,31,22,62,0.3548387096774194,5,16,0.3125,17,46,0.3695652173913043,15,20,0.75,9,21,30,19,4,4,7,18,64,2011_Mehmet Okur
2011,Nazr Mohammed,C,33,468,896,0.5223214285714286,0,2,0.0,468,894,0.5234899328859061,134,224,0.5982142857142857,280,456,736,46,60,112,140,368,1070,2011_Nazr Mohammed
2011,Rodney Carney,SF,26,92,220,0.41818181818181815,34,76,0.4473684210526316,58,144,0.4027777777777778,36,54,0.6666666666666666,26,70,96,22,24,10,32,66,254,2011_Rodney Carney
2011,Tiago Splitter,C,26,101,191,0.5287958115183246,0,1,0.0,101,190,0.531578947368421,76,140,0.5428571428571428,72,129,201,26,29,17,32,91,278,2011_Tiago Splitter
2011,Vince Carter,SG,34,778,1782,0.43658810325476993,232,642,0.3613707165109034,546,1140,0.4789473684210526,256,346,0.7398843930635838,108,442,550,292,134,40,180,386,2044,2011_Vince Carter
2012,Al Jefferson,C,27,516,1048,0.49236641221374045,1,4,0.25,515,1044,0.4932950191570881,137,177,0.7740112994350282,133,452,585,134,47,101,62,155,1170,2012_Al Jefferson
2012,Austin Daye,SF,23,73,227,0.32158590308370044,13,62,0.20967741935483872,60,165,0.36363636363636365,35,43,0.813953488372093,14,77,91,33,22,21,40,62,194,2012_Austin Daye
2012,Daniel Orton,PF,21,17,30,0.5666666666666667,0,1,0.0,17,29,0.5862068965517241,11,25,0.44,19,20,39,5,8,9,7,30,45,2012_Daniel Orton
2012,J.J. Hickson,PF,23,366,784,0.46683673469387754,0,4,0.0,366,780,0.46923076923076923,172,268,0.6417910447761194,266,404,670,90,60,70,140,170,904,2012_J.J. Hickson
2012,James Harden,SG,22,309,629,0.4912559618441971,114,292,0.3904109589041096,195,337,0.5786350148367952,312,369,0.8455284552845529,30,222,252,229,62,15,137,150,1044,2012_James Harden
2012,Jeff Foote,C,24,2,6,0.3333333333333333,0,0,NaN,2,6,0.3333333333333333,0,0,NaN,1,5,6,0,0,1,2,5,4,2012_Jeff Foote
2012,Jeremy Tyler,C,20,88,209,0.42105263157894735,0,1,0.0,88,208,0.4230769230769231,29,52,0.5576923076923077,54,86,140,16,16,20,36,84,205,2012_Jeremy Tyler
2012,Jodie Meeks,SG,24,191,467,0.4089935760171306,97,266,0.36466165413533835,94,201,0.46766169154228854,77,85,0.9058823529411765,17,144,161,54,40,3,29,82,556,2012_Jodie Meeks
2012,John Lucas,PG,29,143,358,0.3994413407821229,55,140,0.39285714285714285,88,218,0.4036697247706422,28,32,0.875,22,54,76,108,19,1,42,42,369,2012_John Lucas
2012,Jose Calderon,PG,30,218,477,0.4570230607966457,59,159,0.3710691823899371,159,318,0.5,60,68,0.8823529411764706,19,141,160,468,47,3,104,94,555,2012_Jose Calderon
2012,Kevin Garnett,C,35,391,777,0.5032175032175032,3,9,0.3333333333333333,388,768,0.5052083333333334,162,189,0.8571428571428571,66,428,494,175,56,61,107,141,947,2012_Kevin Garnett
2012,Kevin Love,PF,23,474,1059,0.4475920679886686,105,282,0.3723404255319149,369,777,0.4749034749034749,379,460,0.8239130434782609,226,508,734,111,47,28,128,152,1432,2012_Kevin Love
2012,Marcin Gortat,C,27,427,769,0.5552665799739922,0,2,0.0,427,767,0.5567144719687093,163,251,0.649402390438247,185,474,659,59,48,99,90,142,1017,2012_Marcin Gortat
2012,Martell Webster,SF,25,115,272,0.4227941176470588,37,109,0.3394495412844037,78,163,0.4785276073619632,57,72,0.7916666666666666,42,126,168,40,31,17,46,86,324,2012_Martell Webster
2012,Mehmet Okur,C,32,52,139,0.37410071942446044,23,72,0.3194444444444444,29,67,0.43283582089552236,3,5,0.6,22,59,81,30,9,5,25,45,130,2012_Mehmet Okur
2012,Nazr Mohammed,C,34,79,169,0.46745562130177515,0,1,0.0,79,168,0.47023809523809523,13,23,0.5652173913043478,59,111,170,14,20,37,26,101,171,2012_Nazr Mohammed
2012,Sean Williams,C,25,28,44,0.6363636363636364,0,0,NaN,28,44,0.6363636363636364,24,26,0.9230769230769231,26,24,50,10,8,16,20,36,80,2012_Sean Williams
2012,Timofey Mozgov,C,25,100,190,0.5263157894736842,0,0,NaN,100,190,0.5263157894736842,39,57,0.6842105263157895,53,126,179,22,15,42,53,86,239,2012_Timofey Mozgov
2013,Alec Burks,SG,21,163,388,0.42010309278350516,33,92,0.358695652173913,130,296,0.4391891891891892,92,129,0.7131782945736435,37,108,145,92,35,13,74,114,451,2013_Alec Burks
2013,Austin Daye,SF,24,180,416,0.4326923076923077,82,196,0.41836734693877553,98,220,0.44545454545454544,52,68,0.7647058823529411,32,214,246,84,28,44,58,164,494,2013_Austin Daye
2013,Corey Brewer,SF,26,375,883,0.4246885617214043,91,307,0.2964169381107492,284,576,0.4930555555555556,149,216,0.6898148148148148,55,180,235,124,118,23,102,154,990,2013_Corey Brewer
2013,J.J. Barea,PG,28,316,758,0.41688654353562005,97,280,0.3464285714285714,219,478,0.4581589958158996,105,134,0.7835820895522388,34,173,207,294,32,0,145,131,834,2013_J.J. Barea
2013,Jeffery Taylor,SF,23,172,399,0.43107769423558895,53,154,0.34415584415584416,119,245,0.4857142857142857,75,103,0.7281553398058253,51,99,150,63,47,15,48,136,472,2013_Jeffery Taylor
2013,Jodie Meeks,SG,25,205,530,0.3867924528301887,122,342,0.3567251461988304,83,188,0.44148936170212766,86,96,0.8958333333333334,37,134,171,69,58,5,52,103,618,2013_Jodie Meeks
2013,Jose Calderon,PG,31,624,1270,0.49133858267716535,260,564,0.46099290780141844,364,706,0.5155807365439093,144,160,0.9,40,312,352,1036,116,16,252,198,1652,2013_Jose Calderon
2013,Justin Dentmon,PG,27,0,2,0.0,0,0,NaN,0,2,0.0,0,0,NaN,0,0,0,0,0,0,0,0,0,2013_Justin Dentmon
2013,Kenneth Faried,PF,23,380,689,0.5515239477503628,0,0,NaN,380,689,0.5515239477503628,163,266,0.6127819548872181,260,474,734,77,81,83,113,234,923,2013_Kenneth Faried
2013,Kevin Garnett,C,36,422,850,0.4964705882352941,2,16,0.125,420,834,0.5035971223021583,158,201,0.7860696517412935,75,455,530,159,78,62,110,154,1004,2013_Kevin Garnett
2013,Marcin Gortat,C,28,295,566,0.5212014134275619,0,3,0.0,295,563,0.5239786856127886,90,138,0.6521739130434783,128,388,516,75,40,98,99,127,680,2013_Marcin Gortat
2013,Martell Webster,SF,26,281,636,0.4418238993710692,139,329,0.42249240121580545,142,307,0.46254071661237783,168,198,0.8484848484848485,53,241,294,143,49,17,90,166,869,2013_Martell Webster
2013,Nazr Mohammed,C,35,66,180,0.36666666666666664,0,2,0.0,66,178,0.3707865168539326,34,47,0.723404255319149,73,122,195,26,21,32,24,97,166,2013_Nazr Mohammed
2014,Austin Daye,SF,25,48,136,0.35294117647058826,24,74,0.32432432432432434,24,62,0.3870967741935484,12,20,0.6,10,44,54,16,8,8,10,36,132,2014_Austin Daye
2014,D.J. White,PF,27,0,1,0.0,0,0,NaN,0,1,0.0,0,0,NaN,0,2,2,0,1,0,0,1,0,2014_D.J. White
2014,Dionte Christmas,SF,27,22,62,0.3548387096774194,9,31,0.2903225806451613,13,31,0.41935483870967744,18,24,0.75,13,25,38,8,2,3,6,19,71,2014_Dionte Christmas
2014,Goran Dragic,SG,27,552,1093,0.505032021957914,122,299,0.4080267558528428,430,794,0.5415617128463476,316,416,0.7596153846153846,69,176,245,447,104,22,213,206,1542,2014_Goran Dragic
2014,Jodie Meeks,SG,26,413,892,0.46300448430493274,162,404,0.400990099009901,251,488,0.514344262295082,221,258,0.8565891472868217,30,164,194,138,111,4,111,119,1209,2014_Jodie Meeks
2014,Jose Calderon,PG,32,341,748,0.45588235294117646,191,425,0.44941176470588234,150,323,0.46439628482972134,52,63,0.8253968253968254,29,163,192,377,69,11,103,136,925,2014_Jose Calderon
2014,Kevin Garnett,C,37,157,356,0.4410112359550562,0,3,0.0,157,353,0.4447592067988669,38,47,0.8085106382978723,60,298,358,82,43,40,69,123,352,2014_Kevin Garnett
2014,Marcin Gortat,C,29,455,840,0.5416666666666666,1,1,1.0,454,839,0.5411203814064363,157,229,0.6855895196506551,202,565,767,138,41,121,126,201,1068,2014_Marcin Gortat
2014,Martell Webster,SF,27,254,587,0.43270868824531517,146,372,0.3924731182795699,108,215,0.5023255813953489,105,125,0.84,38,184,222,97,41,15,58,150,759,2014_Martell Webster
2014,Mike Scott,PF,25,301,628,0.47929936305732485,62,200,0.31,239,428,0.5584112149532711,103,132,0.7803030303030303,62,222,284,75,30,7,79,121,767,2014_Mike Scott
2014,Nazr Mohammed,C,36,54,126,0.42857142857142855,0,0,NaN,54,126,0.42857142857142855,16,30,0.5333333333333333,66,109,175,20,14,30,37,77,124,2014_Nazr Mohammed
2014,Nene Hilario,PF,31,299,594,0.5033670033670034,1,5,0.2,298,589,0.5059422750424448,155,266,0.5827067669172933,65,229,294,153,64,47,117,164,754,2014_Nene Hilario
2014,Phil Pressey,PG,22,78,253,0.308300395256917,28,106,0.2641509433962264,50,147,0.3401360544217687,29,45,0.6444444444444445,20,85,105,241,68,5,87,97,213,2014_Phil Pressey
2014,Rudy Gay,SF,27,1074,2358,0.455470737913486,130,394,0.3299492385786802,944,1964,0.48065173116089616,636,774,0.8217054263565892,226,648,874,418,190,112,448,342,2914,2014_Rudy Gay
2014,Willie Green,SG,32,102,271,0.3763837638376384,41,121,0.33884297520661155,61,150,0.4066666666666667,28,34,0.8235294117647058,12,66,78,50,22,11,34,96,273,2014_Willie Green
2015,Archie Goodwin,SG,20,79,201,0.39303482587064675,12,41,0.2926829268292683,67,160,0.41875,61,83,0.7349397590361446,27,47,74,44,18,9,48,55,231,2015_Archie Goodwin
2015,Austin Daye,SF,26,100,282,0.3546099290780142,48,142,0.3380281690140845,52,140,0.37142857142857144,10,12,0.8333333333333334,20,130,150,34,24,10,46,78,258,2015_Austin Daye
2015,Carmelo Anthony,SF,30,358,806,0.4441687344913151,61,179,0.3407821229050279,297,627,0.47368421052631576,189,237,0.7974683544303798,72,192,264,122,40,17,89,87,966,2015_Carmelo Anthony
2015,Devyn Marble,SG,22,14,44,0.3181818181818182,4,22,0.18181818181818182,10,22,0.45454545454545453,5,16,0.3125,5,26,31,17,9,2,9,14,37,2015_Devyn Marble
2015,Gordon Hayward,SF,24,484,1087,0.4452621895124195,120,330,0.36363636363636365,364,757,0.4808454425363276,375,462,0.8116883116883117,54,319,373,313,108,30,206,131,1463,2015_Gordon Hayward
2015,James Michael,PF,22,24,44,0.5454545454545454,0,0,NaN,24,44,0.5454545454545454,14,25,0.56,15,22,37,2,5,9,6,21,62,2015_James Michael
2015,Jarrett Jack,PG,31,359,817,0.4394124847001224,39,146,0.2671232876712329,320,671,0.47690014903129657,200,227,0.8810572687224669,19,226,245,373,75,13,191,143,957,2015_Jarrett Jack
2015,Jason Thompson,PF,28,201,428,0.4696261682242991,0,1,0.0,201,427,0.4707259953161593,89,143,0.6223776223776224,139,391,530,85,33,57,84,239,491,2015_Jason Thompson
2015,Jodie Meeks,SG,27,222,534,0.4157303370786517,74,212,0.3490566037735849,148,322,0.45962732919254656,145,160,0.90625,12,92,104,79,59,6,57,76,663,2015_Jodie Meeks
2015,Joe Ingles,SF,27,147,354,0.4152542372881356,72,202,0.3564356435643564,75,152,0.4934210526315789,30,40,0.75,22,153,175,182,72,10,98,124,396,2015_Joe Ingles
2015,Jose Calderon,PG,33,147,354,0.4152542372881356,59,142,0.4154929577464789,88,212,0.41509433962264153,29,32,0.90625,19,105,124,198,31,0,75,76,382,2015_Jose Calderon
2015,Kevin Garnett,PF,38,286,612,0.4673202614379085,2,14,0.14285714285714285,284,598,0.47491638795986624,72,90,0.8,96,526,622,154,92,34,92,218,646,2015_Kevin Garnett
2015,Langston Galloway,PG,23,204,511,0.39921722113502933,62,176,0.3522727272727273,142,335,0.42388059701492536,63,78,0.8076923076923077,37,153,190,150,52,12,61,129,533,2015_Langston Galloway
2015,Martell Webster,SF,28,24,91,0.26373626373626374,10,43,0.23255813953488372,14,48,0.2916666666666667,48,64,0.75,10,36,46,17,7,1,22,24,106,2015_Martell Webster
2015,Mike Muscala,PF,23,83,151,0.5496688741721855,9,22,0.4090909090909091,74,129,0.5736434108527132,22,25,0.88,52,67,119,25,16,19,21,52,197,2015_Mike Muscala
2015,Nazr Mohammed,C,37,13,30,0.43333333333333335,0,0,NaN,13,30,0.43333333333333335,1,3,0.3333333333333333,11,27,38,3,4,5,7,16,27,2015_Nazr Mohammed
2015,Solomon Hill,SF,23,251,634,0.39589905362776023,68,208,0.3269230769230769,183,426,0.4295774647887324,159,193,0.8238341968911918,70,244,314,184,66,18,115,177,729,2015_Solomon Hill
2015,Thabo Sefolosha,SF,30,104,249,0.41767068273092367,25,78,0.32051282051282054,79,171,0.4619883040935672,45,58,0.7758620689655172,53,170,223,75,53,21,38,67,278,2015_Thabo Sefolosha
2015,Tyrus Thomas,PF,28,1,1,1.0,0,0,NaN,1,1,1.0,2,2,1.0,0,0,0,1,0,0,0,0,4,2015_Tyrus Thomas
2015,Zach LaVine,PG,19,286,677,0.4224519940915805,57,167,0.3413173652694611,229,510,0.44901960784313727,149,177,0.8418079096045198,27,187,214,276,54,10,193,158,778,2015_Zach LaVine
2016,Andre Drummond,C,22,552,1060,0.5207547169811321,2,6,0.3333333333333333,550,1054,0.5218216318785579,208,586,0.35494880546075086,395,803,1198,67,119,112,155,245,1314,2016_Andre Drummond
2016,Andre Roberson,SG,24,136,274,0.49635036496350365,32,103,0.3106796116504854,104,171,0.6081871345029239,33,54,0.6111111111111112,79,172,251,47,53,42,35,133,337,2016_Andre Roberson
2016,Anthony Morrow,SG,30,136,333,0.4084084084084084,79,204,0.3872549019607843,57,129,0.4418604651162791,29,39,0.7435897435897436,10,52,62,24,22,5,17,64,380,2016_Anthony Morrow
2016,Carmelo Anthony,SF,31,567,1307,0.4338179035960214,105,310,0.3387096774193548,462,997,0.4633901705115346,334,403,0.8287841191066998,98,458,556,299,62,38,176,180,1573,2016_Carmelo Anthony
2016,Chris Paul,PG,30,515,1114,0.4622980251346499,122,329,0.3708206686930091,393,785,0.5006369426751592,294,328,0.8963414634146342,39,271,310,738,152,13,194,185,1446,2016_Chris Paul
2016,Devin Booker,SG,19,367,867,0.4232987312572088,99,289,0.34256055363321797,268,578,0.46366782006920415,215,256,0.83984375,27,160,187,200,44,20,160,225,1048,2016_Devin Booker
2016,James Michael,PF,23,45,84,0.5357142857142857,1,2,0.5,44,82,0.5365853658536586,26,49,0.5306122448979592,30,28,58,17,10,8,16,39,117,2016_James Michael
2016,Jerryd Bayless,SG,27,185,437,0.4233409610983982,101,231,0.43722943722943725,84,206,0.4077669902912621,70,90,0.7777777777777778,21,120,141,163,47,11,73,111,541,2016_Jerryd Bayless
2016,Jodie Meeks,SG,28,7,20,0.35,4,9,0.4444444444444444,3,11,0.2727272727272727,4,4,1.0,1,4,5,3,0,0,1,2,22,2016_Jodie Meeks
2016,Jose Calderon,PG,34,209,455,0.4593406593406593,84,203,0.41379310344827586,125,252,0.49603174603174605,42,48,0.875,22,207,229,298,63,7,87,135,544,2016_Jose Calderon
2016,Kevin Garnett,PF,39,54,115,0.46956521739130436,0,1,0.0,54,114,0.47368421052631576,14,21,0.6666666666666666,15,135,150,62,28,10,16,70,122,2016_Kevin Garnett
2016,Kyrie Irving,PG,23,394,879,0.4482366325369738,84,262,0.32061068702290074,310,617,0.5024311183144247,169,191,0.8848167539267016,44,113,157,249,56,18,124,107,1041,2016_Kyrie Irving
2016,Langston Galloway,PG,24,231,588,0.39285714285714285,77,224,0.34375,154,364,0.4230769230769231,86,114,0.7543859649122807,43,245,288,207,77,22,61,177,625,2016_Langston Galloway
2016,Myles Turner,C,19,264,530,0.4981132075471698,3,14,0.21428571428571427,261,516,0.5058139534883721,88,121,0.7272727272727273,68,264,332,41,25,86,67,158,619,2016_Myles Turner
2016,Nazr Mohammed,C,38,3,5,0.6,0,0,NaN,3,5,0.6,2,2,1.0,1,3,4,0,0,0,3,4,8,2016_Nazr Mohammed
2016,Sasha Kaun,C,30,9,17,0.5294117647058824,0,0,NaN,9,17,0.5294117647058824,5,11,0.45454545454545453,12,14,26,3,4,5,7,11,23,2016_Sasha Kaun
2016,Thabo Sefolosha,SF,31,188,372,0.5053763440860215,42,124,0.3387096774193548,146,248,0.5887096774193549,62,99,0.6262626262626263,52,282,334,107,85,37,68,109,480,2016_Thabo Sefolosha
2016,Trevor Ariza,SF,30,357,859,0.41559953434225844,185,499,0.37074148296593185,172,360,0.4777777777777778,126,161,0.782608695652174,67,299,366,188,160,26,113,177,1025,2016_Trevor Ariza
2017,Amir Johnson,PF,29,213,370,0.5756756756756757,27,66,0.4090909090909091,186,304,0.6118421052631579,67,100,0.67,117,248,365,140,52,62,77,211,520,2017_Amir Johnson
2017,Carmelo Anthony,SF,32,602,1389,0.4334053275737941,151,421,0.3586698337292161,451,968,0.4659090909090909,304,365,0.8328767123287671,62,374,436,213,60,34,153,198,1659,2017_Carmelo Anthony
2017,Christian Wood,PF,21,12,23,0.5217391304347826,0,5,0.0,12,18,0.6666666666666666,11,15,0.7333333333333333,14,15,29,2,3,6,7,11,35,2017_Christian Wood
2017,D'Angelo Russell,PG,20,351,867,0.40484429065743943,135,384,0.3515625,216,483,0.4472049689440994,147,188,0.7819148936170213,31,191,222,303,87,16,176,130,984,2017_D'Angelo Russell
2017,David Nwaba,SG,24,47,81,0.5802469135802469,1,5,0.2,46,76,0.6052631578947368,25,39,0.6410256410256411,16,46,62,14,13,7,11,36,120,2017_David Nwaba
2017,DeAndre Jordan,C,28,412,577,0.7140381282495667,0,2,0.0,412,575,0.7165217391304348,205,425,0.4823529411764706,297,817,1114,96,52,135,116,212,1029,2017_DeAndre Jordan
2017,Deyonta Davis,C,20,24,47,0.5106382978723404,0,0,NaN,24,47,0.5106382978723404,10,18,0.5555555555555556,20,40,60,2,3,17,8,40,58,2017_Deyonta Davis
2017,James Michael,PF,24,62,117,0.5299145299145299,2,8,0.25,60,109,0.5504587155963303,21,42,0.5,34,56,90,17,18,29,19,47,147,2017_James Michael
2017,Jared Dudley,PF,31,157,346,0.45375722543352603,77,203,0.3793103448275862,80,143,0.5594405594405595,43,65,0.6615384615384615,31,194,225,121,42,16,72,154,434,2017_Jared Dudley
2017,Jodie Meeks,SG,29,103,256,0.40234375,56,137,0.40875912408759124,47,119,0.3949579831932773,65,74,0.8783783783783784,5,72,77,45,34,4,36,41,327,2017_Jodie Meeks
2017,Jose Calderon,PG,35,110,268,0.41044776119402987,40,128,0.3125,70,140,0.5,22,24,0.9166666666666666,30,118,148,176,22,2,82,72,282,2017_Jose Calderon
2017,Kentavious Caldwell-Pope,SG,23,370,928,0.39870689655172414,153,437,0.3501144164759725,217,491,0.4419551934826884,154,185,0.8324324324324325,55,193,248,193,89,12,86,118,1047,2017_Kentavious Caldwell-Pope
2017,Langston Galloway,PG,25,414,1090,0.3798165137614679,240,616,0.38961038961038963,174,474,0.3670886075949367,102,128,0.796875,54,258,312,186,92,12,92,192,1170,2017_Langston Galloway
2017,Marcus Georges-Hunt,SG,22,2,7,0.2857142857142857,1,2,0.5,1,5,0.2,9,10,0.9,1,8,9,3,1,0,2,5,14,2017_Marcus Georges-Hunt
2017,Michael Gbinije,SG,24,1,10,0.1,0,4,0.0,1,6,0.16666666666666666,2,2,1.0,2,1,3,2,0,0,0,2,4,2017_Michael Gbinije
2017,Nikola Jokic,C,21,494,854,0.5784543325526932,45,139,0.3237410071942446,449,715,0.627972027972028,188,228,0.8245614035087719,212,506,718,359,61,56,171,214,1221,2017_Nikola Jokic
2017,Okaro White,PF,24,33,87,0.3793103448275862,12,34,0.35294117647058826,21,53,0.39622641509433965,20,22,0.9090909090909091,25,57,82,21,10,10,18,52,98,2017_Okaro White
2017,Ron Baker,SG,23,82,217,0.3778801843317972,23,86,0.26744186046511625,59,131,0.45038167938931295,28,43,0.6511627906976745,12,86,98,107,34,8,56,74,215,2017_Ron Baker
2017,Thabo Sefolosha,SF,32,174,395,0.44050632911392407,41,120,0.3416666666666667,133,275,0.48363636363636364,55,75,0.7333333333333333,54,216,270,107,96,31,58,97,444,2017_Thabo Sefolosha
2003,Adonal Foyle,C,27,185,345,0.5362318840579711,0,1,0.0,185,344,0.5377906976744186,70,104,0.6730769230769231,176,314,490,37,40,205,73,214,440,2003_Adonal Foyle
2003,Bryon Russell,SF,32,108,306,0.35294117647058826,46,140,0.32857142857142857,62,166,0.37349397590361444,53,69,0.7681159420289855,43,165,208,72,70,7,55,130,315,2003_Bryon Russell
2003,Darius Miles,SF,21,263,642,0.40965732087227413,0,14,0.0,263,628,0.41878980891719747,92,155,0.5935483870967742,113,250,363,176,67,69,178,159,618,2003_Darius Miles
2003,DeSagana Diop,PF,21,54,154,0.35064935064935066,0,0,NaN,54,154,0.35064935064935066,11,30,0.36666666666666664,63,152,215,43,33,81,56,148,119,2003_DeSagana Diop
2003,Derek Anderson,PG,28,355,832,0.4266826923076923,116,331,0.3504531722054381,239,501,0.47704590818363274,231,269,0.8587360594795539,53,211,264,325,90,16,128,141,1057,2003_Derek Anderson
2003,Jerome Moiso,C,24,89,171,0.52046783625731,0,0,NaN,89,171,0.52046783625731,27,41,0.6585365853658537,59,119,178,22,19,44,46,87,205,2003_Jerome Moiso
2003,Reggie Slater,PF,32,27,50,0.54,0,0,NaN,27,50,0.54,27,45,0.6,18,13,31,4,6,1,9,31,81,2003_Reggie Slater
2003,Shaquille O'Neal,C,30,695,1211,0.573905862923204,0,0,NaN,695,1211,0.573905862923204,451,725,0.6220689655172413,259,483,742,206,38,159,196,229,1841,2003_Shaquille O'Neal
2004,Bryon Russell,SF,33,98,244,0.4016393442622951,43,112,0.38392857142857145,55,132,0.4166666666666667,50,65,0.7692307692307693,32,114,146,71,32,12,37,110,289,2004_Bryon Russell
2004,Corie Blount,C_PF_PF-C,35,230,506,0.45454545454545453,0,6,0.0,230,500,0.46,30,54,0.5555555555555556,196,354,550,110,98,48,86,270,490,2004_Corie Blount
2004,DeSagana Diop,C,22,57,147,0.3877551020408163,0,0,NaN,57,147,0.3877551020408163,12,20,0.6,72,127,199,34,26,51,29,116,126,2004_DeSagana Diop
2004,Kaniel Dickens,PF,25,3,3,1.0,0,0,NaN,3,3,1.0,1,2,0.5,2,0,2,0,0,0,1,3,7,2004_Kaniel Dickens
2004,Leandro Barbosa,PG,21,210,470,0.44680851063829785,83,210,0.3952380952380952,127,260,0.48846153846153845,47,61,0.7704918032786885,23,100,123,165,93,7,120,184,550,2004_Leandro Barbosa
2004,Marcus Haislip,PF,23,36,74,0.4864864864864865,1,2,0.5,35,72,0.4861111111111111,20,28,0.7142857142857143,21,32,53,4,6,12,9,25,93,2004_Marcus Haislip
2004,Ronald Dupree,SF,23,111,282,0.39361702127659576,4,9,0.4444444444444444,107,273,0.39194139194139194,66,105,0.6285714285714286,55,112,167,55,32,18,51,134,292,2004_Ronald Dupree
2005,Antonio McDyess,PF,30,307,598,0.5133779264214047,0,1,0.0,307,597,0.5142378559463987,126,192,0.65625,177,305,482,71,46,52,93,204,740,2005_Antonio McDyess
2005,Awvee Storey,SG,27,3,10,0.3,1,2,0.5,2,8,0.25,1,2,0.5,4,1,5,1,0,0,0,3,8,2005_Awvee Storey
2005,Bryon Russell,SF,34,95,252,0.376984126984127,56,149,0.37583892617449666,39,103,0.3786407766990291,61,77,0.7922077922077922,50,122,172,72,44,11,35,130,307,2005_Bryon Russell
2005,Casey Jacobsen,SF_SG_SG-SF,23,330,816,0.40441176470588236,132,354,0.3728813559322034,198,462,0.42857142857142855,302,384,0.7864583333333334,70,264,334,226,66,16,142,208,1094,2005_Casey Jacobsen
2005,DeSagana Diop,C,23,20,69,0.2898550724637681,0,2,0.0,20,67,0.29850746268656714,0,5,0.0,30,40,70,15,8,27,12,53,40,2005_DeSagana Diop
2005,Jackson Vroman,C_PF_C-PF,23,164,398,0.4120603015075377,0,6,0.0,164,392,0.41836734693877553,96,150,0.64,128,222,350,80,50,38,128,210,424,2005_Jackson Vroman
2005,Leandro Barbosa,PG,22,168,354,0.4745762711864407,51,139,0.3669064748201439,117,215,0.5441860465116279,55,69,0.7971014492753623,32,98,130,126,30,7,87,127,442,2005_Leandro Barbosa
2005,Mike James,PG,29,662,1502,0.440745672436751,200,518,0.3861003861003861,462,984,0.4695121951219512,218,290,0.7517241379310344,70,346,416,526,130,12,212,348,1742,2005_Mike James
2005,Robert Horry,PF,34,157,375,0.4186666666666667,51,138,0.3695652173913043,106,237,0.4472573839662447,86,109,0.7889908256880734,91,177,268,80,67,60,69,138,451,2005_Robert Horry
2005,Ronald Dupree,SF,24,61,127,0.48031496062992124,1,2,0.5,60,125,0.48,29,47,0.6170212765957447,34,61,95,24,7,10,22,60,152,2005_Ronald Dupree
2005,Zydrunas Ilgauskas,C,29,458,979,0.46782431052093976,2,7,0.2857142857142857,456,972,0.4691358024691358,402,503,0.7992047713717694,299,373,672,100,53,165,191,313,1320,2005_Zydrunas Ilgauskas
2006,Antonio McDyess,PF,31,285,560,0.5089285714285714,0,2,0.0,285,558,0.510752688172043,68,122,0.5573770491803278,156,280,436,90,46,48,76,220,638,2006_Antonio McDyess
2006,Brian Cardinal,PF,28,46,111,0.4144144144144144,13,29,0.4482758620689655,33,82,0.4024390243902439,19,27,0.7037037037037037,11,44,55,33,23,0,27,65,124,2006_Brian Cardinal
2006,Bryon Russell,SF,35,0,0,NaN,0,0,NaN,0,0,NaN,0,0,NaN,0,1,1,1,0,0,0,0,0,2006_Bryon Russell
2006,DeSagana Diop,C,24,75,154,0.487012987012987,1,2,0.5,74,152,0.4868421052631579,39,72,0.5416666666666666,145,229,374,23,44,146,36,253,190,2006_DeSagana Diop
2006,Delonte West,PG,22,333,684,0.4868421052631579,84,218,0.3853211009174312,249,466,0.5343347639484979,86,101,0.8514851485148515,57,232,289,329,84,46,133,197,836,2006_Delonte West
2006,Dwight Howard,PF,20,468,881,0.5312145289443814,0,2,0.0,468,879,0.5324232081911263,356,598,0.5953177257525084,288,734,1022,125,65,115,217,277,1292,2006_Dwight Howard
2006,Leandro Barbosa,SG,23,273,567,0.48148148148148145,87,196,0.44387755102040816,186,371,0.5013477088948787,111,147,0.7551020408163265,31,119,150,158,48,6,89,145,744,2006_Leandro Barbosa
2006,Luke Jackson,SF,24,29,85,0.3411764705882353,12,36,0.3333333333333333,17,49,0.3469387755102041,26,33,0.7878787878787878,16,24,40,25,11,2,31,30,96,2006_Luke Jackson
2006,Melvin Ely,PF,27,216,425,0.508235294117647,0,2,0.0,216,423,0.5106382978723404,128,192,0.6666666666666666,94,183,277,76,29,44,100,160,560,2006_Melvin Ely
2006,Mike Wilks,PG,26,58,180,0.32222222222222224,6,38,0.15789473684210525,52,142,0.36619718309859156,50,82,0.6097560975609756,18,60,78,64,28,2,48,68,172,2006_Mike Wilks
2006,Rasho Nesterovic,C,29,172,334,0.5149700598802395,0,2,0.0,172,332,0.5180722891566265,18,30,0.6,114,195,309,33,21,88,53,209,362,2006_Rasho Nesterovic
2006,Ronald Dupree,SF,25,33,63,0.5238095238095238,0,1,0.0,33,62,0.532258064516129,14,41,0.34146341463414637,21,28,49,14,12,0,14,44,80,2006_Ronald Dupree
2006,Tim Duncan,PF,29,574,1185,0.48438818565400843,2,5,0.4,572,1180,0.4847457627118644,335,533,0.6285178236397748,231,650,881,253,70,162,198,219,1485,2006_Tim Duncan
2007,Al Jefferson,C,22,453,882,0.5136054421768708,0,1,0.0,453,881,0.5141884222474461,201,295,0.6813559322033899,237,519,756,88,48,106,136,232,1107,2007_Al Jefferson
2007,Antonio McDyess,PF,32,284,540,0.5259259259259259,0,0,NaN,284,540,0.5259259259259259,96,139,0.6906474820143885,165,331,496,72,61,65,75,240,664,2007_Antonio McDyess
2007,Brian Skinner,PF,30,124,253,0.4901185770750988,0,0,NaN,124,253,0.4901185770750988,46,79,0.5822784810126582,106,279,385,58,18,64,75,195,294,2007_Brian Skinner
2007,Corey Maggette,SF,27,367,808,0.4542079207920792,13,65,0.2,354,743,0.47644683714670255,519,633,0.8199052132701422,90,352,442,208,65,14,201,244,1266,2007_Corey Maggette
2007,Dale Davis,C,37,33,74,0.44594594594594594,0,0,NaN,33,74,0.44594594594594594,17,26,0.6538461538461539,59,78,137,12,10,34,15,59,83,2007_Dale Davis
2007,DeSagana Diop,C,25,71,151,0.47019867549668876,0,1,0.0,71,150,0.47333333333333333,48,86,0.5581395348837209,166,272,438,30,40,113,63,244,190,2007_DeSagana Diop
2007,Dwight Howard,C,21,526,873,0.6025200458190149,1,2,0.5,525,871,0.6027554535017221,390,666,0.5855855855855856,283,725,1008,158,70,156,317,245,1443,2007_Dwight Howard
2007,John Lucas,PG,24,62,156,0.3974358974358974,15,59,0.2542372881355932,47,97,0.4845360824742268,15,19,0.7894736842105263,9,27,36,33,17,0,15,38,154,2007_John Lucas
2007,Leandro Barbosa,SG,24,529,1111,0.47614761476147616,190,438,0.4337899543378995,339,673,0.5037147102526003,196,232,0.8448275862068966,22,192,214,317,96,15,146,210,1444,2007_Leandro Barbosa
2007,Ronald Dupree,SF,26,11,31,0.3548387096774194,0,0,NaN,11,31,0.3548387096774194,3,9,0.3333333333333333,5,12,17,5,5,1,3,12,25,2007_Ronald Dupree
2007,Shavlik Randolph,PF,23,23,48,0.4791666666666667,0,0,NaN,23,48,0.4791666666666667,12,22,0.5454545454545454,19,35,54,4,7,10,9,23,58,2007_Shavlik Randolph
2008,Antonio McDyess,PF,33,293,600,0.48833333333333334,0,2,0.0,293,598,0.4899665551839465,97,156,0.6217948717948718,204,462,666,89,61,53,75,246,683,2008_Antonio McDyess
2008,Brian Skinner,C,31,92,198,0.46464646464646464,2,3,0.6666666666666666,90,195,0.46153846153846156,33,63,0.5238095238095238,63,175,238,15,21,77,39,112,219,2008_Brian Skinner
2008,Corey Brewer,SF,21,182,486,0.37448559670781895,7,36,0.19444444444444445,175,450,0.3888888888888889,88,110,0.8,82,210,292,111,76,25,89,188,459,2008_Corey Brewer
2008,David West,PF,27,629,1305,0.481992337164751,6,25,0.24,623,1280,0.48671875,300,353,0.8498583569405099,180,495,675,177,62,99,165,208,1564,2008_David West
2008,DeSagana Diop,C,26,188,360,0.5222222222222223,0,0,NaN,188,360,0.5222222222222223,76,140,0.5428571428571428,320,464,784,80,52,176,116,292,452,2008_DeSagana Diop
2008,Demetris Nichols,SF,23,12,46,0.2608695652173913,6,26,0.23076923076923078,6,20,0.3,0,0,NaN,0,10,10,2,0,6,8,8,30,2008_Demetris Nichols
2008,Dwight Howard,C,22,583,974,0.5985626283367557,0,4,0.0,583,970,0.6010309278350515,529,897,0.5897435897435898,279,882,1161,110,74,176,263,274,1695,2008_Dwight Howard
2008,J.J. Barea,PG,23,71,170,0.4176470588235294,21,54,0.3888888888888889,50,116,0.43103448275862066,28,35,0.8,4,43,47,58,14,1,35,48,191,2008_J.J. Barea
2008,Jason Terry,SG,30,471,1008,0.46726190476190477,136,363,0.3746556473829201,335,645,0.5193798449612403,191,223,0.8565022421524664,30,178,208,264,88,18,92,170,1269,2008_Jason Terry
2008,Jason Williams,PG,32,211,550,0.3836363636363636,97,275,0.3527272727272727,114,275,0.41454545454545455,69,80,0.8625,12,118,130,307,83,5,91,93,588,2008_Jason Williams
2008,Leandro Barbosa,SG,25,472,1021,0.4622918707149853,164,422,0.3886255924170616,308,599,0.5141903171953256,175,213,0.8215962441314554,40,191,231,216,75,18,117,195,1283,2008_Leandro Barbosa
2008,Marcus Banks,PG,26,172,382,0.450261780104712,80,204,0.39215686274509803,92,178,0.5168539325842697,54,70,0.7714285714285715,8,82,90,122,28,26,74,130,478,2008_Marcus Banks
2008,Ronald Dupree,SF,27,2,6,0.3333333333333333,0,0,NaN,2,6,0.3333333333333333,4,4,1.0,2,14,16,2,2,0,0,0,8,2008_Ronald Dupree
2008,Royal Ivey,PG,26,149,378,0.3941798941798942,35,107,0.32710280373831774,114,271,0.42066420664206644,85,117,0.7264957264957265,38,80,118,160,45,7,75,166,418,2008_Royal Ivey
2008,Stephen Graham,SF,25,34,58,0.5862068965517241,7,14,0.5,27,44,0.6136363636363636,12,16,0.75,4,18,22,9,4,1,10,14,87,2008_Stephen Graham
2009,Antonio McDyess,PF,34,268,525,0.5104761904761905,0,0,NaN,268,525,0.5104761904761905,60,86,0.6976744186046512,185,422,607,83,41,50,51,191,596,2009_Antonio McDyess
2009,Brian Skinner,PF,32,92,205,0.44878048780487806,0,2,0.0,92,203,0.45320197044334976,30,47,0.6382978723404256,72,131,203,27,17,52,43,94,214,2009_Brian Skinner
2009,Chris Wilcox,C,26,368,740,0.4972972972972973,0,8,0.0,368,732,0.5027322404371585,158,280,0.5642857142857143,192,362,554,94,52,32,150,274,894,2009_Chris Wilcox
2009,D.J. White,PF,22,26,50,0.52,0,0,NaN,26,50,0.52,10,13,0.7692307692307693,10,22,32,6,3,5,3,10,62,2009_D.J. White
2009,DeSagana Diop,C,27,148,342,0.4327485380116959,0,0,NaN,148,342,0.4327485380116959,44,132,0.3333333333333333,228,318,546,64,58,112,78,256,340,2009_DeSagana Diop
2009,Dwight Howard,C,23,560,979,0.5720122574055159,0,2,0.0,560,977,0.5731832139201638,504,849,0.5936395759717314,336,757,1093,112,77,231,240,270,1624,2009_Dwight Howard
2009,Eddy Curry,C,26,2,2,1.0,0,0,NaN,2,2,1.0,1,3,0.3333333333333333,0,4,4,0,0,0,2,5,5,2009_Eddy Curry
2009,Goran Dragic,PG,22,88,224,0.39285714285714285,20,54,0.37037037037037035,68,170,0.4,50,65,0.7692307692307693,33,70,103,111,29,3,73,87,246,2009_Goran Dragic
2009,Jason Terry,SG,31,541,1168,0.4631849315068493,167,456,0.36622807017543857,374,712,0.5252808988764045,198,225,0.88,39,138,177,251,97,20,119,141,1447,2009_Jason Terry
2009,Javaris Crittenton,PG-SG_SG_PG,21,262,570,0.45964912280701753,4,30,0.13333333333333333,258,540,0.4777777777777778,106,184,0.5760869565217391,114,218,332,300,80,12,164,202,634,2009_Javaris Crittenton
2009,Kevin Martin,SG,25,341,811,0.4204685573366215,115,277,0.4151624548736462,226,534,0.4232209737827715,457,527,0.8671726755218216,29,154,183,138,61,8,146,116,1254,2009_Kevin Martin
2009,Leandro Barbosa,SG,26,366,759,0.48221343873517786,90,240,0.375,276,519,0.5317919075144508,171,194,0.8814432989690721,34,147,181,162,82,7,93,115,993,2009_Leandro Barbosa
2009,Maurice Ager,SG,24,15,43,0.3488372093023256,0,6,0.0,15,37,0.40540540540540543,4,8,0.5,3,7,10,3,1,2,4,17,34,2009_Maurice Ager
2009,Rudy Gay,SF,22,572,1262,0.4532488114104596,85,242,0.3512396694214876,487,1020,0.4774509803921569,264,344,0.7674418604651163,109,328,437,135,98,59,203,221,1493,2009_Rudy Gay
2009,Steven Hill,PF,23,1,1,1.0,0,0,NaN,1,1,1.0,0,0,NaN,2,1,3,0,0,0,0,0,2,2009_Steven Hill
2009,Trey Johnson,SG,24,0,5,0.0,0,0,NaN,0,5,0.0,4,4,1.0,0,1,1,0,0,0,1,4,4,2009_Trey Johnson
2010,C.J. Miles,SF,22,241,562,0.4288256227758007,74,217,0.34101382488479265,167,345,0.48405797101449277,66,95,0.6947368421052632,42,126,168,105,58,17,81,190,622,2010_C.J. Miles
2010,Craig Smith,PF,26,226,397,0.5692695214105793,1,5,0.2,225,392,0.5739795918367347,132,208,0.6346153846153846,97,190,287,84,33,25,88,194,585,2010_Craig Smith
2010,Darren Collison,PG,22,376,789,0.47655259822560203,46,115,0.4,330,674,0.4896142433234421,148,174,0.8505747126436781,41,151,192,432,78,4,202,92,946,2010_Darren Collison
2010,Fabricio Oberto,C,34,35,56,0.625,0,0,NaN,35,56,0.625,13,17,0.7647058823529411,34,71,105,51,11,9,36,121,83,2010_Fabricio Oberto
2010,Jamario Moon,SF,29,114,247,0.46153846153846156,32,100,0.32,82,147,0.5578231292517006,36,45,0.8,26,165,191,49,34,30,23,69,296,2010_Jamario Moon
2010,Jarrett Jack,PG,26,323,671,0.481371087928465,82,199,0.4120603015075377,241,472,0.510593220338983,203,241,0.8423236514522822,30,192,222,413,60,6,163,151,931,2010_Jarrett Jack
2010,Jarvis Hayes,SF,28,138,328,0.42073170731707316,60,179,0.33519553072625696,78,149,0.5234899328859061,14,18,0.7777777777777778,9,99,108,40,29,9,28,91,350,2010_Jarvis Hayes
2010,Lamar Odom,PF,30,342,739,0.462787550744249,58,182,0.31868131868131866,284,557,0.5098743267504489,140,202,0.693069306930693,184,618,802,267,75,59,150,227,882,2010_Lamar Odom
2010,Quinton Ross,SF_SG_SF-SG,28,80,222,0.36036036036036034,8,42,0.19047619047619047,72,180,0.4,16,28,0.5714285714285714,34,64,98,24,26,12,22,138,184,2010_Quinton Ross
2010,Russell Westbrook,PG,21,485,1160,0.41810344827586204,23,104,0.22115384615384615,462,1056,0.4375,329,422,0.7796208530805687,143,258,401,652,108,34,268,204,1322,2010_Russell Westbrook
2010,Sergio Rodriguez,PG,23,334,702,0.4757834757834758,64,182,0.3516483516483517,270,520,0.5192307692307693,136,186,0.7311827956989247,48,130,178,424,100,10,228,168,868,2010_Sergio Rodriguez
2010,Sundiata Gaines,PG,23,38,82,0.4634146341463415,7,26,0.2692307692307692,31,56,0.5535714285714286,23,46,0.5,6,23,29,39,12,0,14,17,106,2010_Sundiata Gaines
2010,Tim Thomas,SF,32,49,106,0.46226415094339623,16,43,0.37209302325581395,33,63,0.5238095238095238,21,24,0.875,13,28,41,14,10,2,14,31,135,2010_Tim Thomas
2010,Wilson Chandler,SG,22,412,860,0.4790697674418605,40,150,0.26666666666666666,372,710,0.523943661971831,129,160,0.80625,93,255,348,138,46,49,108,184,993,2010_Wilson Chandler
2011,Aaron Gray,C,26,56,99,0.5656565656565656,0,0,NaN,56,99,0.5656565656565656,17,34,0.5,59,112,171,16,11,12,32,96,129,2011_Aaron Gray
2011,Andres Nocioni,SF,31,118,277,0.4259927797833935,42,118,0.3559322033898305,76,159,0.4779874213836478,49,61,0.8032786885245902,19,150,169,45,14,15,47,100,327,2011_Andres Nocioni
2011,Anthony Morrow,SG,25,279,620,0.45,110,260,0.4230769230769231,169,360,0.46944444444444444,96,107,0.897196261682243,37,135,172,68,19,7,54,135,764,2011_Anthony Morrow
2011,Chris Paul,PG,25,430,928,0.46336206896551724,71,183,0.3879781420765027,359,745,0.4818791946308725,337,384,0.8776041666666666,38,289,327,782,188,5,177,196,1268,2011_Chris Paul
2011,Craig Smith,PF,27,104,188,0.5531914893617021,0,5,0.0,104,183,0.5683060109289617,50,68,0.7352941176470589,43,74,117,31,16,7,33,84,258,2011_Craig Smith
2011,Daequan Cook,SG,23,79,181,0.43646408839779005,65,154,0.42207792207792205,14,27,0.5185185185185185,16,20,0.8,8,64,72,20,14,1,17,51,239,2011_Daequan Cook
2011,Darren Collison,PG,23,398,870,0.4574712643678161,41,124,0.33064516129032256,357,746,0.4785522788203753,202,232,0.8706896551724138,40,185,225,403,87,14,194,109,1039,2011_Darren Collison
2011,Donte Greene,SF,22,156,386,0.40414507772020725,45,154,0.2922077922077922,111,232,0.47844827586206895,43,65,0.6615384615384615,49,98,147,48,36,20,60,88,400,2011_Donte Greene
2011,Fabricio Oberto,C,35,3,5,0.6,0,0,NaN,3,5,0.6,1,2,0.5,3,4,7,0,0,0,3,10,7,2011_Fabricio Oberto
2011,Glen Davis,C,25,359,801,0.44818976279650435,2,15,0.13333333333333333,357,786,0.4541984732824427,195,265,0.7358490566037735,101,324,425,92,78,30,85,231,915,2011_Glen Davis
2011,Jeremy Evans,SF,23,76,115,0.6608695652173913,0,1,0.0,76,114,0.6666666666666666,26,37,0.7027027027027027,36,61,97,24,17,17,19,50,178,2011_Jeremy Evans
2011,Luke Babbitt,SF,21,15,55,0.2727272727272727,3,16,0.1875,12,39,0.3076923076923077,3,9,0.3333333333333333,6,24,30,6,2,2,8,15,36,2011_Luke Babbitt
2011,Michael Redd,SG,31,18,45,0.4,4,17,0.23529411764705882,14,28,0.5,4,4,1.0,0,8,8,12,2,1,4,4,44,2011_Michael Redd
2011,Patrick Ewing,SF,26,0,5,0.0,0,2,0.0,0,3,0.0,3,4,0.75,1,1,2,2,0,1,1,1,3,2011_Patrick Ewing
2011,Ronald Dupree,SF,30,1,4,0.25,0,1,0.0,1,3,0.3333333333333333,0,0,NaN,0,3,3,1,0,0,0,2,2,2011_Ronald Dupree
2011,Russell Westbrook,PG,22,614,1390,0.441726618705036,34,103,0.3300970873786408,580,1287,0.4506604506604507,531,631,0.8415213946117274,121,258,379,670,155,30,316,207,1793,2011_Russell Westbrook
2011,Sundiata Gaines,PG,24,84,210,0.4,18,76,0.23684210526315788,66,134,0.4925373134328358,36,72,0.5,26,50,76,84,32,2,54,50,222,2011_Sundiata Gaines
2011,Thaddeus Young,PF,22,458,847,0.5407319952774499,6,22,0.2727272727272727,452,825,0.5478787878787879,123,174,0.7068965517241379,153,281,434,82,90,26,99,170,1045,2011_Thaddeus Young
2011,Trevor Ariza,SF,25,303,762,0.39763779527559057,82,271,0.3025830258302583,221,491,0.45010183299389,138,197,0.700507614213198,61,347,408,162,120,31,118,180,826,2011_Trevor Ariza
2011,Wilson Chandler,SF,23,858,1906,0.45015739769150054,224,640,0.35,634,1266,0.5007898894154819,260,322,0.8074534161490683,150,666,816,240,96,188,208,398,2200,2011_Wilson Chandler
2012,Andre Emmett,SF,29,4,7,0.5714285714285714,0,1,0.0,4,6,0.6666666666666666,5,8,0.625,2,4,6,1,2,1,2,2,13,2012_Andre Emmett
2012,Brandan Wright,C,24,144,233,0.6180257510729614,0,1,0.0,144,232,0.6206896551724138,52,82,0.6341463414634146,62,112,174,13,22,63,21,61,340,2012_Brandan Wright
2012,Chase Budinger,SF,23,208,471,0.4416135881104034,88,219,0.4018264840182648,120,252,0.47619047619047616,54,70,0.7714285714285715,38,179,217,74,29,7,55,65,558,2012_Chase Budinger
2012,Craig Smith,PF,28,59,117,0.5042735042735043,0,1,0.0,59,116,0.5086206896551724,38,53,0.7169811320754716,33,77,110,19,16,5,24,55,156,2012_Craig Smith
2012,Darington Hobson,SG,24,2,13,0.15384615384615385,0,6,0.0,2,7,0.2857142857142857,0,0,NaN,0,3,3,6,0,0,2,1,4,2012_Darington Hobson
2012,Darren Collison,PG,24,230,523,0.4397705544933078,34,94,0.3617021276595745,196,429,0.4568764568764569,127,153,0.8300653594771242,30,157,187,287,49,14,114,101,621,2012_Darren Collison
2012,DeSagana Diop,C,30,15,42,0.35714285714285715,0,0,NaN,15,42,0.35714285714285715,1,6,0.16666666666666666,33,52,85,23,6,13,19,36,31,2012_DeSagana Diop
2012,Jared Dudley,SG,26,312,643,0.48522550544323484,80,209,0.3827751196172249,232,434,0.5345622119815668,119,164,0.725609756097561,95,206,301,112,49,19,72,107,823,2012_Jared Dudley
2012,Jordan Williams,C,21,77,152,0.506578947368421,0,0,NaN,77,152,0.506578947368421,43,66,0.6515151515151515,66,90,156,11,21,15,23,61,197,2012_Jordan Williams
2012,Russell Westbrook,PG,23,578,1266,0.4565560821484992,62,196,0.3163265306122449,516,1070,0.4822429906542056,340,413,0.8232445520581114,96,205,301,362,112,21,239,147,1558,2012_Russell Westbrook
2012,Sundiata Gaines,SG,25,102,271,0.3763837638376384,28,82,0.34146341463414637,74,189,0.3915343915343915,59,96,0.6145833333333334,27,81,108,126,55,2,52,58,291,2012_Sundiata Gaines
2012,Wilson Chandler,SF,24,31,79,0.3924050632911392,3,12,0.25,28,67,0.417910447761194,10,12,0.8333333333333334,6,35,41,17,6,6,18,18,75,2012_Wilson Chandler
2012,Xavier Silas,SG,24,4,15,0.26666666666666666,1,6,0.16666666666666666,3,9,0.3333333333333333,2,3,0.6666666666666666,2,2,4,3,0,0,3,5,11,2012_Xavier Silas
2013,Alexey Shved,SG,24,236,635,0.3716535433070866,85,288,0.2951388888888889,151,347,0.43515850144092216,108,150,0.72,41,134,175,286,54,27,147,117,665,2013_Alexey Shved
2013,Chauncey Billups,SG,36,53,132,0.4015151515151515,33,90,0.36666666666666664,20,42,0.47619047619047616,45,48,0.9375,2,30,32,49,12,1,26,25,184,2013_Chauncey Billups
2013,Darren Collison,PG,25,341,724,0.47099447513812154,48,136,0.35294117647058826,293,588,0.49829931972789115,242,275,0.88,31,188,219,415,100,8,173,139,972,2013_Darren Collison
2013,DeSagana Diop,C,31,8,27,0.2962962962962963,0,1,0.0,8,26,0.3076923076923077,0,1,0.0,10,41,51,13,5,16,8,19,16,2013_DeSagana Diop
2013,Greg Smith,C,22,170,274,0.6204379562043796,0,1,0.0,170,273,0.6227106227106227,81,130,0.6230769230769231,111,210,321,25,18,40,41,175,421,2013_Greg Smith
2013,John Salmons,SF,33,244,612,0.39869281045751637,99,267,0.3707865168539326,145,345,0.42028985507246375,85,110,0.7727272727272727,33,174,207,226,51,25,85,143,672,2013_John Salmons
2013,Jrue Holiday,PG,22,555,1288,0.4309006211180124,91,247,0.3684210526315789,464,1041,0.4457252641690682,182,242,0.7520661157024794,89,240,329,625,123,32,292,170,1383,2013_Jrue Holiday
2013,Leandro Barbosa,PG,30,83,193,0.43005181347150256,18,47,0.3829787234042553,65,146,0.4452054794520548,31,41,0.7560975609756098,8,38,46,58,17,6,21,51,215,2013_Leandro Barbosa
2013,Luke Ridnour,SG,31,367,811,0.4525277435265105,66,212,0.3113207547169811,301,599,0.5025041736227045,139,164,0.8475609756097561,41,165,206,311,82,15,130,187,939,2013_Luke Ridnour
2013,Quentin Richardson,SF,32,1,11,0.09090909090909091,1,4,0.25,0,7,0.0,2,2,1.0,5,5,10,1,0,0,2,1,5,2013_Quentin Richardson
2013,Quincy Miller,PF,20,4,12,0.3333333333333333,0,1,0.0,4,11,0.36363636363636365,1,2,0.5,1,1,2,3,1,0,1,3,9,2013_Quincy Miller
2013,Russell Westbrook,PG,24,673,1535,0.43843648208469055,97,300,0.3233333333333333,576,1235,0.46639676113360323,460,575,0.8,111,317,428,607,145,24,273,189,1903,2013_Russell Westbrook
2013,Steve Nash,PG,38,236,475,0.4968421052631579,57,130,0.43846153846153846,179,345,0.518840579710145,107,116,0.9224137931034483,26,116,142,333,30,5,126,70,636,2013_Steve Nash
2013,Taj Gibson,PF,27,214,441,0.4852607709750567,0,4,0.0,214,437,0.4897025171624714,89,131,0.6793893129770993,125,220,345,61,27,90,76,166,517,2013_Taj Gibson
2013,Wilson Chandler,PF,25,210,455,0.46153846153846156,52,126,0.4126984126984127,158,329,0.48024316109422494,88,111,0.7927927927927928,45,173,218,58,45,12,60,119,560,2013_Wilson Chandler
2014,Andray Blatche,PF,27,321,674,0.4762611275964392,15,54,0.2777777777777778,306,620,0.4935483870967742,164,221,0.7420814479638009,120,270,390,112,75,38,110,166,821,2014_Andray Blatche
2014,Ben Gordon,SG,30,37,108,0.3425925925925926,8,29,0.27586206896551724,29,79,0.3670886075949367,17,21,0.8095238095238095,3,24,27,21,10,2,21,18,99,2014_Ben Gordon
2014,C.J. McCollum,SG,22,74,178,0.4157303370786517,30,80,0.375,44,98,0.4489795918367347,23,34,0.6764705882352942,7,41,48,27,14,2,35,53,201,2014_C.J. McCollum
2014,Darren Collison,PG,26,324,694,0.4668587896253602,71,189,0.37566137566137564,253,505,0.500990099009901,192,224,0.8571428571428571,47,141,188,297,93,15,132,150,911,2014_Darren Collison
2014,Josh McRoberts,PF,26,247,566,0.4363957597173145,105,291,0.36082474226804123,142,275,0.5163636363636364,62,85,0.7294117647058823,85,288,373,333,58,46,83,189,661,2014_Josh McRoberts
2014,Lance Stephenson,SG,23,427,870,0.4908045977011494,86,244,0.3524590163934426,341,626,0.5447284345047924,140,197,0.7106598984771574,95,463,558,359,54,7,210,195,1080,2014_Lance Stephenson
2014,Leandro Barbosa,PG,31,56,131,0.42748091603053434,7,25,0.28,49,106,0.46226415094339623,31,39,0.7948717948717948,5,32,37,32,7,4,19,30,150,2014_Leandro Barbosa
2014,Quincy Miller,PF,21,94,256,0.3671875,30,94,0.3191489361702128,64,162,0.3950617283950617,39,55,0.7090909090909091,36,111,147,26,22,32,48,70,257,2014_Quincy Miller
2014,Russell Westbrook,PG,25,346,791,0.43742098609355246,68,214,0.3177570093457944,278,577,0.48180242634315423,242,293,0.825938566552901,55,208,263,319,88,7,177,104,1002,2014_Russell Westbrook
2014,Shane Larkin,PG,21,52,137,0.3795620437956204,12,38,0.3157894736842105,40,99,0.40404040404040403,16,25,0.64,11,31,42,71,26,1,39,46,132,2014_Shane Larkin
2014,Tony Allen,SG,32,204,413,0.4939467312348668,11,47,0.23404255319148937,193,366,0.5273224043715847,76,121,0.628099173553719,79,129,208,94,90,19,90,121,495,2014_Tony Allen
2014,Wilson Chandler,SF,26,307,738,0.4159891598915989,122,351,0.3475783475783476,185,387,0.4780361757105943,110,152,0.7236842105263158,58,236,294,114,46,31,79,193,846,2014_Wilson Chandler
2015,Brandon Bass,PF,29,344,683,0.5036603221083455,9,32,0.28125,335,651,0.5145929339477726,169,214,0.7897196261682243,139,259,398,104,41,32,83,140,866,2015_Brandon Bass
2015,C.J. McCollum,SG,23,159,365,0.43561643835616437,55,139,0.39568345323741005,104,226,0.46017699115044247,51,73,0.6986301369863014,14,77,91,64,43,8,48,81,424,2015_C.J. McCollum
2015,Darren Collison,PG,27,260,550,0.4727272727272727,60,161,0.37267080745341613,200,389,0.5141388174807198,145,184,0.7880434782608695,19,124,143,252,67,14,112,95,725,2015_Darren Collison
2015,Gerald Henderson,SG,27,370,847,0.43683589138134593,45,136,0.33088235294117646,325,711,0.4571026722925457,184,217,0.847926267281106,36,237,273,206,51,22,110,135,969,2015_Gerald Henderson
2015,Kendrick Perkins,C,30,204,454,0.44933920704845814,0,2,0.0,204,452,0.45132743362831856,84,166,0.5060240963855421,182,458,640,102,32,84,190,324,492,2015_Kendrick Perkins
2015,Kyle O'Quinn,PF,24,119,242,0.49173553719008267,12,43,0.27906976744186046,107,199,0.5376884422110553,44,57,0.7719298245614035,46,153,199,59,31,39,55,110,294,2015_Kyle O'Quinn
2015,Leandro Barbosa,SG,32,183,386,0.4740932642487047,43,112,0.38392857142857145,140,274,0.5109489051094891,58,74,0.7837837837837838,23,68,91,99,41,8,44,87,467,2015_Leandro Barbosa
2015,Maurice Harkless,SF,21,63,158,0.3987341772151899,10,56,0.17857142857142858,53,102,0.5196078431372549,22,41,0.5365853658536586,38,68,106,25,32,9,27,66,158,2015_Maurice Harkless
2015,Michael Kidd-Gilchrist,SF,21,224,482,0.46473029045643155,0,0,NaN,224,482,0.46473029045643155,150,214,0.7009345794392523,109,307,416,77,30,38,63,115,598,2015_Michael Kidd-Gilchrist
2015,Noah Vonleh,PF,19,30,76,0.39473684210526316,5,13,0.38461538461538464,25,63,0.3968253968253968,18,26,0.6923076923076923,28,58,86,4,4,9,11,20,83,2015_Noah Vonleh
2015,Quincy Miller,PF,22,18,76,0.23684210526315788,6,36,0.16666666666666666,12,40,0.3,16,22,0.7272727272727273,8,32,40,16,14,10,10,18,58,2015_Quincy Miller
2015,Reggie Bullock,SF,23,48,140,0.34285714285714286,30,92,0.32608695652173914,18,48,0.375,12,18,0.6666666666666666,2,98,100,16,20,8,16,38,138,2015_Reggie Bullock
2015,Russell Westbrook,PG,26,627,1471,0.4262406526172672,86,288,0.2986111111111111,541,1183,0.45731191885038036,546,654,0.8348623853211009,124,364,488,574,140,14,293,184,1886,2015_Russell Westbrook
2015,Ryan Kelly,PF,23,104,309,0.3365695792880259,45,134,0.3358208955223881,59,175,0.33714285714285713,79,95,0.8315789473684211,13,133,146,92,30,24,37,118,332,2015_Ryan Kelly
2015,Terrence Jones,PF,23,158,299,0.5284280936454849,13,37,0.35135135135135137,145,262,0.5534351145038168,57,94,0.6063829787234043,78,142,220,36,18,59,37,78,386,2015_Terrence Jones
2015,Wilson Chandler,SF,27,418,975,0.4287179487179487,139,406,0.34236453201970446,279,569,0.4903339191564148,110,142,0.7746478873239436,96,379,475,134,58,29,110,231,1085,2015_Wilson Chandler
2016,Alex Len,C,22,264,624,0.4230769230769231,1,7,0.14285714285714285,263,617,0.42625607779578606,174,239,0.7280334728033473,178,416,594,97,38,62,145,230,703,2016_Alex Len
2016,Boban Marjanovic,C,27,105,174,0.603448275862069,0,0,NaN,105,174,0.603448275862069,87,114,0.7631578947368421,73,121,194,21,12,23,29,54,297,2016_Boban Marjanovic
2016,C.J. McCollum,SG,24,641,1431,0.4479385045422781,197,472,0.4173728813559322,444,959,0.4629822732012513,187,226,0.827433628318584,47,212,259,341,97,23,196,187,1666,2016_C.J. McCollum
2016,Cameron Bairstow,C,25,13,40,0.325,1,5,0.2,12,35,0.34285714285714286,7,8,0.875,4,24,28,6,2,3,4,19,34,2016_Cameron Bairstow
2016,Darren Collison,PG,28,377,776,0.48582474226804123,87,217,0.4009216589861751,290,559,0.518783542039356,194,226,0.8584070796460177,28,141,169,318,76,4,130,142,1035,2016_Darren Collison
2016,Dion Waiters,SG,24,282,706,0.39943342776203966,86,240,0.35833333333333334,196,466,0.4206008583690987,112,157,0.7133757961783439,36,166,202,154,81,15,120,143,762,2016_Dion Waiters
2016,Donald Sloan,PG,28,154,350,0.44,38,99,0.3838383838383838,116,251,0.46215139442231074,78,104,0.75,17,156,173,268,32,4,80,73,424,2016_Donald Sloan
2016,Dwight Howard,C,30,372,600,0.62,0,6,0.0,372,594,0.6262626262626263,232,474,0.48945147679324896,238,597,835,98,69,113,166,219,976,2016_Dwight Howard
2016,Frank Kaminsky,C,22,215,525,0.4095238095238095,68,202,0.33663366336633666,147,323,0.4551083591331269,108,148,0.7297297297297297,69,266,335,98,38,43,58,126,606,2016_Frank Kaminsky
2016,JaMychal Green,PF,25,230,495,0.46464646464646464,15,45,0.3333333333333333,215,450,0.4777777777777778,103,137,0.7518248175182481,139,234,373,67,46,33,83,189,578,2016_JaMychal Green
2016,Kevon Looney,PF,19,4,7,0.5714285714285714,1,2,0.5,3,5,0.6,0,0,NaN,4,6,10,0,0,0,1,2,9,2016_Kevon Looney
2016,Leandro Barbosa,SG,33,171,370,0.46216216216216216,39,110,0.35454545454545455,132,260,0.5076923076923077,52,62,0.8387096774193549,28,89,117,82,44,10,53,107,433,2016_Leandro Barbosa
2016,Quincy Acy,PF,25,119,214,0.5560747663551402,19,49,0.3877551020408163,100,165,0.6060606060606061,50,68,0.7352941176470589,65,123,188,27,29,24,27,103,307,2016_Quincy Acy
2016,Russell Westbrook,PG,27,656,1444,0.45429362880886426,101,341,0.2961876832844575,555,1103,0.5031731640979148,465,573,0.8115183246073299,145,481,626,834,163,20,342,200,1878,2016_Russell Westbrook
2017,Al Horford,C,30,379,801,0.4731585518102372,86,242,0.35537190082644626,293,559,0.5241502683363148,108,135,0.8,95,369,464,337,52,87,116,138,952,2017_Al Horford
2017,Brandon Rush,SG,31,70,187,0.37433155080213903,44,114,0.38596491228070173,26,73,0.3561643835616438,13,18,0.7222222222222222,16,83,99,45,22,23,28,42,197,2017_Brandon Rush
2017,C.J. McCollum,SG,25,692,1441,0.48022206800832756,185,440,0.42045454545454547,507,1001,0.5064935064935064,268,294,0.9115646258503401,60,231,291,285,72,42,172,202,1837,2017_C.J. McCollum
2017,Cole Aldrich,C,28,45,86,0.5232558139534884,0,0,NaN,45,86,0.5232558139534884,15,22,0.6818181818181818,51,107,158,25,25,23,17,85,105,2017_Cole Aldrich
2017,Darrell Arthur,PF,28,95,215,0.4418604651162791,53,117,0.452991452991453,42,98,0.42857142857142855,19,22,0.8636363636363636,25,87,112,42,19,21,36,76,262,2017_Darrell Arthur
2017,Darren Collison,PG,29,340,714,0.47619047619047616,73,175,0.41714285714285715,267,539,0.49536178107606677,147,171,0.8596491228070176,23,130,153,312,67,9,114,119,900,2017_Darren Collison
2017,Dwight Howard,C,31,388,613,0.632952691680261,0,2,0.0,388,611,0.6350245499181669,226,424,0.5330188679245284,296,644,940,104,64,92,170,203,1002,2017_Dwight Howard
2017,Gary Payton,PG,24,8,22,0.36363636363636365,1,9,0.1111111111111111,7,13,0.5384615384615384,3,5,0.6,0,12,12,13,3,4,10,9,20,2017_Gary Payton
2017,Leandro Barbosa,SG,34,172,392,0.4387755102040816,35,98,0.35714285714285715,137,294,0.46598639455782315,40,45,0.8888888888888888,15,89,104,81,31,8,48,82,419,2017_Leandro Barbosa
2017,Lucas Nogueira,C,24,103,156,0.6602564102564102,3,12,0.25,100,144,0.6944444444444444,44,67,0.6567164179104478,82,161,243,42,52,90,46,137,253,2017_Lucas Nogueira
2017,Mindaugas Kuzminskas,SF,27,158,369,0.4281842818428184,54,168,0.32142857142857145,104,201,0.5174129353233831,55,68,0.8088235294117647,47,79,126,69,29,11,51,79,425,2017_Mindaugas Kuzminskas
2017,Russell Westbrook,PG,28,824,1941,0.4245234415249871,200,583,0.34305317324185247,624,1358,0.45949926362297494,710,840,0.8452380952380952,137,727,864,840,133,31,438,190,2558,2017_Russell Westbrook
2017,Tiago Splitter,C,32,14,31,0.45161290322580644,2,6,0.3333333333333333,12,25,0.48,9,11,0.8181818181818182,8,14,22,4,1,1,6,8,39,2017_Tiago Splitter
2017,Troy Williams,SF,22,146,334,0.437125748502994,36,124,0.2903225806451613,110,210,0.5238095238095238,42,64,0.65625,30,108,138,50,54,20,66,120,370,2017_Troy Williams
2017,Vince Carter,SF,40,193,490,0.39387755102040817,112,296,0.3783783783783784,81,194,0.4175257731958763,88,115,0.7652173913043478,36,191,227,133,60,36,50,163,586,2017_Vince Carter
2017,Wilson Chandler,SF,29,433,939,0.46112886048988283,110,326,0.3374233128834356,323,613,0.5269168026101142,141,194,0.7268041237113402,103,356,459,141,52,30,114,172,1117,2017_Wilson Chandler
2003,Anthony Peeler,SG,33,252,609,0.41379310344827586,87,212,0.41037735849056606,165,397,0.4156171284634761,39,50,0.78,40,201,241,244,72,13,82,161,630,2003_Anthony Peeler
2003,Bobby Simmons,SG,22,44,112,0.39285714285714285,0,5,0.0,44,107,0.411214953271028,32,35,0.9142857142857143,33,44,77,20,10,3,8,51,120,2003_Bobby Simmons
2003,Carlos Boozer,PF,21,331,618,0.5355987055016181,0,1,0.0,331,617,0.5364667747163695,148,192,0.7708333333333334,202,407,609,106,59,50,103,224,810,2003_Carlos Boozer
2003,David Robinson,C,37,197,420,0.46904761904761905,0,0,NaN,197,420,0.46904761904761905,152,214,0.7102803738317757,163,345,508,61,52,111,83,126,546,2003_David Robinson
2003,Horace Grant,PF,37,13,25,0.52,0,0,NaN,13,25,0.52,0,0,NaN,2,6,8,7,3,0,1,5,26,2003_Horace Grant
2003,Jamison Brewer,PG,22,9,17,0.5294117647058824,0,2,0.0,9,15,0.6,4,9,0.4444444444444444,5,4,9,18,2,1,6,11,22,2003_Jamison Brewer
2003,Jason Caffey,PF,29,113,248,0.45564516129032256,0,0,NaN,113,248,0.45564516129032256,69,106,0.6509433962264151,68,108,176,38,19,15,56,122,295,2003_Jason Caffey
2003,Jason Williams,PG,27,333,859,0.38766006984866125,143,404,0.35396039603960394,190,455,0.4175824175824176,110,131,0.8396946564885496,25,187,212,631,91,10,168,130,919,2003_Jason Williams
2003,Jeryl Sasser,SG,23,64,207,0.30917874396135264,13,44,0.29545454545454547,51,163,0.3128834355828221,53,78,0.6794871794871795,64,120,184,65,45,12,39,91,194,2003_Jeryl Sasser
2003,Kelvin Cato,C,28,133,256,0.51953125,0,4,0.0,133,252,0.5277777777777778,66,124,0.532258064516129,132,296,428,20,38,85,56,176,332,2003_Kelvin Cato
2003,Kendall Gill,SG,34,286,677,0.4224519940915805,19,59,0.3220338983050847,267,618,0.4320388349514563,123,161,0.7639751552795031,51,197,248,156,78,15,108,176,714,2003_Kendall Gill
2003,Kenny Anderson,PG,32,326,764,0.42670157068062825,2,14,0.14285714285714285,324,750,0.432,90,114,0.7894736842105263,62,202,264,396,116,10,150,212,744,2003_Kenny Anderson
2003,Lonny Baxter,C,24,96,206,0.46601941747572817,0,2,0.0,96,204,0.47058823529411764,70,103,0.6796116504854369,65,100,165,16,9,22,46,135,262,2003_Lonny Baxter
2003,Randy Livingston,PG,27,2,4,0.5,0,0,NaN,2,4,0.5,2,2,1.0,0,0,0,1,0,0,0,0,6,2003_Randy Livingston
2003,Scott Williams,C,34,120,292,0.410958904109589,0,2,0.0,120,290,0.41379310344827586,33,42,0.7857142857142857,72,121,193,22,27,21,32,159,273,2003_Scott Williams
2003,Travis Best,PG,30,231,583,0.39622641509433965,36,109,0.3302752293577982,195,474,0.41139240506329117,105,123,0.8536585365853658,26,121,147,255,44,7,106,174,603,2003_Travis Best
2003,Travis Knight,C,28,25,65,0.38461538461538464,0,1,0.0,25,64,0.390625,10,13,0.7692307692307693,18,44,62,14,8,9,10,44,60,2003_Travis Knight
2003,Voshon Lenard,SG,29,325,809,0.40173053152039556,92,252,0.36507936507936506,233,557,0.41831238779174146,156,194,0.8041237113402062,48,164,212,144,59,21,103,156,898,2003_Voshon Lenard
2004,Bobby Simmons,SF,23,147,373,0.3941018766756032,2,12,0.16666666666666666,145,361,0.40166204986149584,141,169,0.834319526627219,115,147,262,96,51,17,73,169,437,2004_Bobby Simmons
2004,Carlos Boozer,PF,22,471,900,0.5233333333333333,1,6,0.16666666666666666,470,894,0.5257270693512305,219,285,0.7684210526315789,230,627,857,148,74,55,134,199,1162,2004_Carlos Boozer
2004,Christian Laettner,PF,34,119,256,0.46484375,6,21,0.2857142857142857,113,235,0.4808510638297872,40,50,0.8,50,182,232,89,37,28,42,102,284,2004_Christian Laettner
2004,Jeff McInnis,SG-PG_SG_PG,29,668,1494,0.44712182061579653,92,254,0.36220472440944884,576,1240,0.4645161290322581,228,286,0.7972027972027972,66,286,352,860,144,12,240,326,1656,2004_Jeff McInnis
2004,Kelvin Cato,PF,29,161,360,0.44722222222222224,0,0,NaN,161,360,0.44722222222222224,96,142,0.676056338028169,153,319,472,72,52,96,84,203,418,2004_Kelvin Cato
2004,Marc Jackson,PF,29,71,171,0.4152046783625731,0,1,0.0,71,170,0.4176470588235294,64,81,0.7901234567901234,45,81,126,18,12,6,24,45,206,2004_Marc Jackson
2004,Mark Pope,PF,31,1,2,0.5,0,0,NaN,1,2,0.5,0,1,0.0,0,3,3,0,1,0,3,8,2,2004_Mark Pope
2004,Michael Finley,SG,30,514,1159,0.44348576358930114,150,370,0.40540540540540543,364,789,0.46134347275031684,164,193,0.8497409326424871,78,247,325,212,84,39,83,118,1342,2004_Michael Finley
2004,Nene Hilario,PF,21,334,630,0.5301587301587302,0,2,0.0,334,628,0.5318471337579618,240,352,0.6818181818181818,154,349,503,168,116,41,183,280,908,2004_Nene Hilario
2004,Travis Best,PG,31,64,172,0.37209302325581395,3,20,0.15,61,152,0.40131578947368424,40,46,0.8695652173913043,17,51,68,112,31,4,33,66,171,2004_Travis Best
2004,Willie Green,SG,22,143,357,0.4005602240896359,19,61,0.3114754098360656,124,296,0.4189189189189189,59,81,0.7283950617283951,16,49,65,53,26,5,59,83,364,2004_Willie Green
2005,Bernard Robinson,SG,24,36,81,0.4444444444444444,3,8,0.375,33,73,0.4520547945205479,18,26,0.6923076923076923,14,34,48,30,11,4,20,42,93,2005_Bernard Robinson
2005,Bobby Simmons,SF,24,474,1017,0.46607669616519176,50,115,0.43478260869565216,424,902,0.4700665188470067,231,273,0.8461538461538461,128,318,446,205,106,16,135,227,1229,2005_Bobby Simmons
2005,Carlos Boozer,PF,23,361,693,0.5209235209235209,0,1,0.0,361,692,0.5216763005780347,187,268,0.6977611940298507,141,316,457,144,41,24,137,179,909,2005_Carlos Boozer
2005,Corsley Edwards,C,25,10,31,0.3225806451612903,0,0,NaN,10,31,0.3225806451612903,7,12,0.5833333333333334,12,13,25,3,3,4,2,19,27,2005_Corsley Edwards
2005,Dan Gadzuric,C,26,243,451,0.5388026607538803,0,0,NaN,243,451,0.5388026607538803,107,199,0.5376884422110553,261,413,674,30,47,106,81,224,593,2005_Dan Gadzuric
2005,Gordan Giricek,SG,27,283,632,0.4477848101265823,38,105,0.3619047619047619,245,527,0.4648956356736243,111,137,0.8102189781021898,25,157,182,137,46,11,90,155,715,2005_Gordan Giricek
2005,Jalen Rose,SF,32,527,1159,0.454702329594478,108,274,0.39416058394160586,419,885,0.47344632768361583,333,390,0.8538461538461538,44,232,276,209,63,10,180,190,1495,2005_Jalen Rose
2005,Jarvis Hayes,SF,23,206,530,0.3886792452830189,42,123,0.34146341463414637,164,407,0.40294840294840295,99,118,0.8389830508474576,41,186,227,90,49,9,62,107,553,2005_Jarvis Hayes
2005,Mark Pope,PF,32,2,6,0.3333333333333333,0,0,NaN,2,6,0.3333333333333333,0,0,NaN,5,3,8,1,1,2,1,5,4,2005_Mark Pope
2005,Quinton Ross,SG,23,161,373,0.4316353887399464,1,4,0.25,160,369,0.43360433604336046,74,110,0.6727272727272727,59,151,210,109,51,22,54,165,397,2005_Quinton Ross
2005,Travis Best,PG,32,190,452,0.42035398230088494,26,85,0.3058823529411765,164,367,0.44686648501362397,108,122,0.8852459016393442,19,88,107,143,66,9,67,148,514,2005_Travis Best
2006,Alex Acker,SG,23,4,16,0.25,1,5,0.2,3,11,0.2727272727272727,0,0,NaN,1,4,5,4,1,0,4,4,9,2006_Alex Acker
2006,Bobby Simmons,SF,25,366,808,0.452970297029703,105,250,0.42,261,558,0.46774193548387094,165,200,0.825,91,242,333,172,86,21,123,254,1002,2006_Bobby Simmons
2006,Carlos Boozer,PF,24,219,399,0.5488721804511278,0,0,NaN,219,399,0.5488721804511278,99,137,0.7226277372262774,73,212,285,88,30,8,69,105,537,2006_Carlos Boozer
2006,Chris Paul,PG,20,407,947,0.4297782470960929,50,177,0.2824858757062147,357,770,0.4636363636363636,394,465,0.8473118279569892,61,339,400,611,175,6,183,218,1258,2006_Chris Paul
2006,Jake Voskuhl,C,28,114,261,0.4367816091954023,1,3,0.3333333333333333,113,258,0.437984496124031,41,60,0.6833333333333333,62,121,183,39,26,23,33,157,270,2006_Jake Voskuhl
2006,Jarron Collins,C,27,129,280,0.4607142857142857,0,0,NaN,129,280,0.4607142857142857,157,219,0.7168949771689498,134,199,333,97,36,27,61,252,415,2006_Jarron Collins
2006,Larry Hughes,SG,27,192,469,0.4093816631130064,28,76,0.3684210526315789,164,393,0.4173027989821883,146,193,0.7564766839378239,26,135,161,131,53,21,99,117,558,2006_Larry Hughes
2006,Trevor Ariza,SF,20,186,452,0.41150442477876104,2,10,0.2,184,442,0.416289592760181,154,254,0.6062992125984252,156,280,436,122,114,22,124,200,528,2006_Trevor Ariza
2007,Amir Johnson,PF,19,18,33,0.5454545454545454,0,3,0.0,18,30,0.6,11,14,0.7857142857142857,15,22,37,3,5,13,9,19,47,2007_Amir Johnson
2007,Andrew Bynum,C,19,247,443,0.5575620767494357,0,3,0.0,247,440,0.5613636363636364,143,214,0.6682242990654206,139,345,484,94,12,128,115,249,637,2007_Andrew Bynum
2007,Carlos Boozer,PF,25,647,1154,0.5606585788561526,0,0,NaN,647,1154,0.5606585788561526,255,372,0.6854838709677419,235,632,867,221,70,21,194,217,1549,2007_Carlos Boozer
2007,Danny Fortson,C,30,15,30,0.5,0,1,0.0,15,29,0.5172413793103449,10,13,0.7692307692307693,13,30,43,1,1,0,15,38,40,2007_Danny Fortson
2007,David Noel,PF,22,65,177,0.3672316384180791,17,53,0.32075471698113206,48,124,0.3870967741935484,37,43,0.8604651162790697,42,81,123,65,25,9,40,77,184,2007_David Noel
2007,Desmon Farmer,SG,25,5,15,0.3333333333333333,2,8,0.25,3,7,0.42857142857142855,1,1,1.0,0,1,1,9,1,0,1,2,13,2007_Desmon Farmer
2007,P.J. Brown,PF,37,170,418,0.40669856459330145,0,2,0.0,170,416,0.40865384615384615,96,122,0.7868852459016393,129,218,347,48,24,52,85,187,436,2007_P.J. Brown
2007,Roger Powell,SF,24,0,3,0.0,0,1,0.0,0,2,0.0,2,2,1.0,3,0,3,0,0,0,3,2,2,2007_Roger Powell
2007,Wayne Simien,PF,23,9,23,0.391304347826087,0,0,NaN,9,23,0.391304347826087,5,7,0.7142857142857143,5,6,11,4,2,0,3,13,23,2007_Wayne Simien
2007,Will Conroy,PG-SG_SG_PG,24,0,6,0.0,0,0,NaN,0,6,0.0,0,8,0.0,6,8,14,18,0,0,4,14,0,2007_Will Conroy
2008,Anthony Carter,PG,32,218,476,0.4579831932773109,45,129,0.3488372093023256,173,347,0.49855907780979825,64,85,0.7529411764705882,27,173,200,388,107,28,124,172,545,2008_Anthony Carter
2008,Bobby Simmons,SF,27,209,496,0.4213709677419355,60,171,0.3508771929824561,149,325,0.4584615384615385,53,70,0.7571428571428571,67,159,226,80,50,5,78,140,531,2008_Bobby Simmons
2008,Carlos Boozer,PF,26,709,1297,0.5466461063993832,0,1,0.0,709,1296,0.5470679012345679,290,393,0.7379134860050891,197,647,844,233,100,41,210,293,1708,2008_Carlos Boozer
2008,Chauncey Billups,PG,31,393,877,0.44811858608893956,137,342,0.40058479532163743,256,535,0.4785046728971963,401,437,0.9176201372997712,42,170,212,529,101,17,160,130,1324,2008_Chauncey Billups
2008,Devean George,SF,30,74,207,0.357487922705314,22,68,0.3235294117647059,52,139,0.37410071942446044,24,34,0.7058823529411765,28,109,137,35,19,13,24,90,194,2008_Devean George
2008,Jamaal Tinsley,PG,29,176,463,0.3801295896328294,40,141,0.28368794326241137,136,322,0.422360248447205,72,100,0.72,24,117,141,326,66,10,130,97,464,2008_Jamaal Tinsley
2008,Jerome James,C,32,1,1,1.0,0,0,NaN,1,1,1.0,2,2,1.0,0,3,3,0,0,0,0,0,4,2008_Jerome James
2008,Malik Rose,PF,33,66,180,0.36666666666666664,2,7,0.2857142857142857,64,173,0.3699421965317919,37,51,0.7254901960784313,31,72,103,28,16,7,40,80,171,2008_Malik Rose
2008,Patrick O'Bryant,C,21,16,29,0.5517241379310345,0,0,NaN,16,29,0.5517241379310345,3,5,0.6,10,19,29,4,4,9,7,27,35,2008_Patrick O'Bryant
2008,Richie Frahm,SG,30,20,54,0.37037037037037035,7,25,0.28,13,29,0.4482758620689655,0,2,0.0,4,10,14,8,2,0,6,7,47,2008_Richie Frahm
2008,Robert Swift,C,22,6,17,0.35294117647058826,0,0,NaN,6,17,0.35294117647058826,2,2,1.0,6,12,18,1,5,6,10,16,14,2008_Robert Swift
2008,Samuel Dalembert,C,26,339,661,0.5128593040847201,0,1,0.0,339,660,0.5136363636363637,186,263,0.7072243346007605,304,545,849,45,40,192,155,269,864,2008_Samuel Dalembert
2008,Steve Nash,PG,33,485,962,0.5041580041580042,179,381,0.46981627296587924,306,581,0.5266781411359724,222,245,0.9061224489795918,28,254,282,898,53,5,295,113,1371,2008_Steve Nash
2009,Adonal Foyle,C,33,14,22,0.6363636363636364,0,0,NaN,14,22,0.6363636363636364,6,12,0.5,18,34,52,2,0,16,6,10,34,2009_Adonal Foyle
2009,Andray Blatche,C,22,297,630,0.4714285714285714,5,21,0.23809523809523808,292,609,0.4794745484400657,114,162,0.7037037037037037,126,252,378,118,53,74,117,211,713,2009_Andray Blatche
2009,Bobby Simmons,SF,28,198,441,0.4489795918367347,117,262,0.44656488549618323,81,179,0.45251396648044695,43,58,0.7413793103448276,72,205,277,92,50,10,62,186,556,2009_Bobby Simmons
2009,Carlos Boozer,PF,27,251,512,0.490234375,0,0,NaN,251,512,0.490234375,97,139,0.697841726618705,111,274,385,79,39,7,79,132,599,2009_Carlos Boozer
2009,Danilo Gallinari,SG,20,56,125,0.448,32,72,0.4444444444444444,24,53,0.4528301886792453,26,27,0.9629629629629629,13,42,55,15,14,4,15,48,170,2009_Danilo Gallinari
2009,Desmon Farmer,SG,27,4,14,0.2857142857142857,3,12,0.25,1,2,0.5,2,2,1.0,0,6,6,2,0,0,4,6,13,2009_Desmon Farmer
2009,Devean George,SF,31,54,142,0.38028169014084506,22,76,0.2894736842105263,32,66,0.48484848484848486,17,22,0.7727272727272727,25,53,78,15,23,11,17,57,147,2009_Devean George
2009,Dwayne Jones,PF,25,4,7,0.5714285714285714,0,0,NaN,4,7,0.5714285714285714,4,6,0.6666666666666666,6,6,12,0,0,1,4,6,12,2009_Dwayne Jones
2009,Eddie House,PG,30,249,560,0.4446428571428571,151,340,0.4441176470588235,98,220,0.44545454545454544,42,53,0.7924528301886793,11,146,157,92,61,7,55,113,691,2009_Eddie House
2009,Jason Kapono,SG,27,261,604,0.43211920529801323,98,229,0.4279475982532751,163,375,0.43466666666666665,34,42,0.8095238095238095,26,137,163,105,22,3,70,144,654,2009_Jason Kapono
2009,Joey Dorsey,PF,25,1,2,0.5,0,0,NaN,1,2,0.5,0,0,NaN,0,1,1,1,0,0,0,0,2,2009_Joey Dorsey
2009,Josh McRoberts,PF,21,35,83,0.42168674698795183,0,10,0.0,35,73,0.4794520547945205,10,13,0.7692307692307693,26,48,74,16,12,16,12,41,80,2009_Josh McRoberts
2009,Tyson Chandler,C,26,160,283,0.5653710247349824,0,0,NaN,160,283,0.5653710247349824,77,133,0.5789473684210527,163,230,393,22,15,56,70,144,397,2009_Tyson Chandler
2010,Channing Frye,C,26,317,703,0.45092460881934565,172,392,0.4387755102040816,145,311,0.4662379421221865,98,121,0.8099173553719008,66,361,427,113,64,74,73,263,904,2010_Channing Frye
2010,Derek Fisher,PG,35,212,558,0.37992831541218636,78,224,0.3482142857142857,134,334,0.40119760479041916,113,132,0.8560606060606061,25,145,170,201,90,9,78,202,615,2010_Derek Fisher
2010,Emeka Okafor,C,27,348,656,0.5304878048780488,0,0,NaN,348,656,0.5304878048780488,154,274,0.5620437956204379,251,491,742,55,54,127,111,218,850,2010_Emeka Okafor
2010,JaVale McGee,C,22,156,307,0.50814332247557,0,1,0.0,156,306,0.5098039215686274,74,116,0.6379310344827587,88,155,243,14,16,101,51,122,386,2010_JaVale McGee
2010,Josh Powell,PF,27,71,194,0.36597938144329895,7,16,0.4375,64,178,0.3595505617977528,20,31,0.6451612903225806,44,72,116,35,9,6,33,71,169,2010_Josh Powell
2010,Kendrick Perkins,C,25,314,522,0.6015325670498084,0,3,0.0,314,519,0.605009633911368,163,280,0.5821428571428572,155,440,595,80,26,132,165,219,791,2010_Kendrick Perkins
2010,Kris Humphries,PF,24,360,816,0.4411764705882353,0,2,0.0,360,814,0.44226044226044225,254,380,0.6684210526315789,240,516,756,64,72,96,132,290,974,2010_Kris Humphries
2010,Marcus Haislip,SF,29,10,21,0.47619047619047616,3,5,0.6,7,16,0.4375,2,5,0.4,4,6,10,0,0,2,3,5,25,2010_Marcus Haislip
2010,Matt Barnes,SF,29,271,557,0.4865350089766607,66,207,0.3188405797101449,205,350,0.5857142857142857,108,146,0.7397260273972602,106,339,445,134,59,30,112,185,716,2010_Matt Barnes
2010,Oleksiy Pecherov,C,24,77,188,0.4095744680851064,14,52,0.2692307692307692,63,136,0.4632352941176471,29,32,0.90625,32,92,124,11,9,14,32,55,197,2010_Oleksiy Pecherov
2010,Paul Millsap,PF,24,385,716,0.5377094972067039,1,9,0.1111111111111111,384,707,0.5431400282885431,183,264,0.6931818181818182,186,373,559,131,64,99,116,285,954,2010_Paul Millsap
2010,Roger Mason,SG,29,193,496,0.38911290322580644,88,264,0.3333333333333333,105,232,0.4525862068965517,27,34,0.7941176470588235,11,151,162,137,30,14,59,99,501,2010_Roger Mason
2010,Steve Novak,SF,26,42,108,0.3888888888888889,22,71,0.30985915492957744,20,37,0.5405405405405406,7,9,0.7777777777777778,1,32,33,6,7,2,2,21,113,2010_Steve Novak
2011,Bobby Simmons,SF,30,0,3,0.0,0,3,0.0,0,0,NaN,0,0,NaN,0,0,0,2,0,0,0,2,0,2011_Bobby Simmons
2011,Channing Frye,PF,27,358,829,0.43184559710494574,171,439,0.3895216400911162,187,390,0.4794871794871795,89,107,0.8317757009345794,65,448,513,96,46,79,73,272,976,2011_Channing Frye
2011,Josh Powell,PF,28,94,208,0.4519230769230769,0,1,0.0,94,207,0.45410628019323673,36,45,0.8,49,86,135,22,5,5,53,78,224,2011_Josh Powell
2011,Orien Greene,SG,28,1,2,0.5,0,0,NaN,1,2,0.5,1,2,0.5,0,0,0,1,1,0,0,0,3,2011_Orien Greene
2011,Steve Novak,SF,27,70,134,0.5223880597014925,52,92,0.5652173913043478,18,42,0.42857142857142855,16,16,1.0,8,48,56,6,2,10,8,28,208,2011_Steve Novak
2012,Al Horford,C,25,57,103,0.5533980582524272,0,1,0.0,57,102,0.5588235294117647,22,30,0.7333333333333333,26,51,77,24,10,14,16,21,136,2012_Al Horford
2012,Antawn Jamison,PF,35,421,1044,0.40325670498084293,91,267,0.3408239700374532,330,777,0.4247104247104247,185,271,0.6826568265682657,123,285,408,131,51,43,90,164,1118,2012_Antawn Jamison
2012,Bobby Simmons,SF,31,28,90,0.3111111111111111,20,60,0.3333333333333333,8,30,0.26666666666666666,4,7,0.5714285714285714,17,38,55,11,15,3,10,41,80,2012_Bobby Simmons
2012,Brandon Rush,SF,26,235,469,0.5010660980810234,99,219,0.4520547945205479,136,250,0.544,65,82,0.7926829268292683,33,218,251,88,35,58,68,64,634,2012_Brandon Rush
2012,Carlos Boozer,PF,30,448,842,0.5320665083135392,0,1,0.0,448,841,0.5326991676575505,95,137,0.6934306569343066,114,450,564,125,63,24,115,168,991,2012_Carlos Boozer
2012,Channing Frye,PF,28,255,613,0.4159869494290375,91,263,0.34600760456273766,164,350,0.4685714285714286,73,82,0.8902439024390244,71,308,379,88,42,70,63,176,674,2012_Channing Frye
2012,D.J. Kennedy,SF,22,5,12,0.4166666666666667,2,4,0.5,3,8,0.375,0,2,0.0,1,6,7,3,2,0,3,7,12,2012_D.J. Kennedy
2012,Delonte West,PG,28,166,360,0.46111111111111114,27,76,0.35526315789473684,139,284,0.4894366197183099,62,70,0.8857142857142857,13,88,101,139,58,11,76,67,421,2012_Delonte West
2012,Eric Dawson,C,27,7,12,0.5833333333333334,0,0,NaN,7,12,0.5833333333333334,1,2,0.5,5,5,10,0,1,2,3,6,15,2012_Eric Dawson
2012,Hamady N'Diaye,C,25,0,1,0.0,0,0,NaN,0,1,0.0,0,0,NaN,0,0,0,0,0,0,0,0,0,2012_Hamady N'Diaye
2012,Josh Harrellson,PF,22,63,149,0.4228187919463087,20,59,0.3389830508474576,43,90,0.4777777777777778,16,26,0.6153846153846154,47,97,144,11,23,20,20,48,162,2012_Josh Harrellson
2012,Steve Novak,PF,28,161,337,0.47774480712166173,133,282,0.4716312056737589,28,55,0.509090909090909,22,26,0.8461538461538461,9,95,104,12,16,9,21,59,477,2012_Steve Novak
2012,Tiago Splitter,C,27,212,343,0.6180758017492711,0,0,NaN,212,343,0.6180758017492711,125,181,0.6906077348066298,93,213,306,65,21,47,87,134,549,2012_Tiago Splitter
2012,Vince Carter,SG,35,223,542,0.4114391143911439,74,205,0.36097560975609755,149,337,0.4421364985163205,95,115,0.8260869565217391,32,173,205,139,56,25,84,134,615,2012_Vince Carter
2013,Al Jefferson,C,28,611,1236,0.494336569579288,2,17,0.11764705882352941,609,1219,0.4995898277276456,167,217,0.7695852534562212,156,564,720,164,80,89,105,170,1391,2013_Al Jefferson
2013,Arnett Moultrie,PF,22,78,134,0.582089552238806,0,0,NaN,78,134,0.582089552238806,18,28,0.6428571428571429,76,69,145,10,17,10,19,43,174,2013_Arnett Moultrie
2013,Boris Diaw,PF,30,179,332,0.5391566265060241,30,78,0.38461538461538464,149,254,0.5866141732283464,47,65,0.7230769230769231,66,188,254,180,52,27,84,143,435,2013_Boris Diaw
2013,Carlos Boozer,PF,31,544,1140,0.47719298245614034,0,2,0.0,544,1138,0.4780316344463972,193,264,0.7310606060606061,175,596,771,179,66,28,176,239,1281,2013_Carlos Boozer
2013,Chris Copeland,PF,28,182,380,0.4789473684210526,59,140,0.42142857142857143,123,240,0.5125,63,83,0.7590361445783133,34,85,119,27,16,12,50,104,486,2013_Chris Copeland
2013,Daniel Orton,C,22,12,26,0.46153846153846156,0,0,NaN,12,26,0.46153846153846156,9,17,0.5294117647058824,13,13,26,4,4,3,4,13,33,2013_Daniel Orton
2013,J.J. Hickson,C,24,418,744,0.5618279569892473,0,2,0.0,418,742,0.5633423180592992,182,268,0.6791044776119403,266,562,828,88,48,51,145,160,1018,2013_J.J. Hickson
2013,James Harden,SG,23,585,1337,0.43754674644727,179,486,0.3683127572016461,406,851,0.4770857814336075,674,792,0.851010101010101,62,317,379,455,142,38,295,178,2023,2013_James Harden
2013,Jeremy Tyler,C,21,18,48,0.375,0,0,NaN,18,48,0.375,8,12,0.6666666666666666,12,28,40,2,2,4,12,20,44,2013_Jeremy Tyler
2013,Josh Harrellson,C,23,4,9,0.4444444444444444,1,5,0.2,3,4,0.75,1,2,0.5,3,4,7,0,1,1,3,4,10,2013_Josh Harrellson
2013,Kevin Love,PF,24,105,298,0.3523489932885906,20,92,0.21739130434782608,85,206,0.41262135922330095,100,142,0.704225352112676,64,188,252,42,13,9,39,34,330,2013_Kevin Love
2013,Kyle Singler,SF,24,275,642,0.42834890965732086,70,200,0.35,205,442,0.4638009049773756,100,124,0.8064516129032258,109,221,330,77,57,37,98,217,720,2013_Kyle Singler
2013,Shavlik Randolph,PF,29,28,48,0.5833333333333334,0,0,NaN,28,48,0.5833333333333334,11,27,0.4074074074074074,28,42,70,4,8,7,10,38,67,2013_Shavlik Randolph
2013,Steve Novak,SF,29,178,430,0.413953488372093,149,351,0.42450142450142453,29,79,0.3670886075949367,30,33,0.9090909090909091,17,135,152,35,28,8,12,97,535,2013_Steve Novak
2013,Timofey Mozgov,C,26,44,87,0.5057471264367817,0,2,0.0,44,85,0.5176470588235295,20,26,0.7692307692307693,50,57,107,9,6,18,25,57,108,2013_Timofey Mozgov
2013,Will Conroy,PG,30,0,9,0.0,0,3,0.0,0,6,0.0,1,2,0.5,1,0,1,0,0,0,0,1,1,2013_Will Conroy
2014,Alec Burks,SG,22,380,831,0.457280385078219,50,143,0.34965034965034963,330,688,0.4796511627906977,279,373,0.7479892761394102,59,198,257,212,69,14,149,190,1089,2014_Alec Burks
2014,Arnett Moultrie,PF,23,16,38,0.42105263157894735,0,0,NaN,16,38,0.42105263157894735,4,5,0.8,11,24,35,2,8,4,7,22,36,2014_Arnett Moultrie
2014,Carlos Boozer,PF,32,447,980,0.4561224489795918,0,2,0.0,447,978,0.4570552147239264,148,193,0.7668393782383419,137,495,632,118,53,22,154,216,1042,2014_Carlos Boozer
2014,Corey Brewer,SF,27,388,807,0.48079306071871125,59,211,0.2796208530805687,329,596,0.552013422818792,163,227,0.7180616740088106,63,144,207,135,151,30,105,210,998,2014_Corey Brewer
2014,Glen Rice,SG,23,11,37,0.2972972972972973,5,17,0.29411764705882354,6,20,0.3,5,7,0.7142857142857143,4,16,20,7,6,1,9,7,32,2014_Glen Rice
2014,J.J. Barea,PG,29,254,656,0.3871951219512195,73,231,0.31601731601731603,181,425,0.4258823529411765,79,100,0.79,16,138,154,303,26,0,125,129,660,2014_J.J. Barea
2014,Jeffery Taylor,SF,24,82,218,0.3761467889908257,18,67,0.26865671641791045,64,151,0.423841059602649,26,47,0.5531914893617021,15,45,60,22,13,5,25,62,208,2014_Jeffery Taylor
2014,Josh Harrellson,C,24,38,82,0.4634146341463415,12,31,0.3870967741935484,26,51,0.5098039215686274,5,7,0.7142857142857143,30,46,76,15,6,15,10,44,93,2014_Josh Harrellson
2014,Justin Hamilton,C,23,18,40,0.45,6,18,0.3333333333333333,12,22,0.5454545454545454,10,10,1.0,8,6,14,0,10,0,8,16,52,2014_Justin Hamilton
2014,Kenneth Faried,PF,24,447,820,0.5451219512195122,0,3,0.0,447,817,0.5471236230110159,202,311,0.6495176848874598,238,446,684,96,70,69,135,193,1096,2014_Kenneth Faried
2014,Matthew Dellavedova,SG,23,122,296,0.41216216216216217,57,155,0.36774193548387096,65,141,0.46099290780141844,38,48,0.7916666666666666,29,94,123,187,33,5,60,121,339,2014_Matthew Dellavedova
2014,Tony Snell,SG,22,129,336,0.38392857142857145,57,178,0.3202247191011236,72,158,0.45569620253164556,31,41,0.7560975609756098,19,105,124,68,29,15,44,84,346,2014_Tony Snell
2014,Victor Oladipo,PG,21,392,936,0.4188034188034188,74,226,0.3274336283185841,318,710,0.447887323943662,248,318,0.779874213836478,43,286,329,327,129,37,256,210,1106,2014_Victor Oladipo
2015,Carlos Boozer,PF,33,371,743,0.4993270524899058,0,0,NaN,371,743,0.4993270524899058,94,150,0.6266666666666667,111,371,482,95,41,12,92,184,836,2015_Carlos Boozer
2015,Glen Rice,SG,24,3,15,0.2,1,7,0.14285714285714285,2,8,0.25,4,6,0.6666666666666666,2,2,4,2,0,0,2,11,11,2015_Glen Rice
2015,Goran Dragic,SG-PG_SG_PG,28,1004,2004,0.500998003992016,180,518,0.3474903474903475,824,1486,0.5545087483176312,362,468,0.7735042735042735,162,386,548,700,156,30,346,390,2550,2015_Goran Dragic
2015,Joey Dorsey,PF,31,80,145,0.5517241379310345,0,1,0.0,80,144,0.5555555555555556,24,83,0.2891566265060241,103,176,279,25,40,25,41,157,184,2015_Joey Dorsey
2015,Justin Hamilton,C,24,170,356,0.47752808988764045,20,62,0.3225806451612903,150,294,0.5102040816326531,78,94,0.8297872340425532,114,154,268,72,54,60,52,140,438,2015_Justin Hamilton
2015,Matthew Dellavedova,SG,24,111,307,0.36156351791530944,68,167,0.40718562874251496,43,140,0.30714285714285716,29,38,0.7631578947368421,37,89,126,204,24,2,61,152,319,2015_Matthew Dellavedova
2015,Mike Scott,PF,26,201,453,0.44370860927152317,66,192,0.34375,135,261,0.5172413793103449,61,77,0.7922077922077922,45,154,199,75,25,3,39,83,529,2015_Mike Scott
2015,Nene Hilario,PF,32,307,601,0.5108153078202995,1,5,0.2,306,596,0.5134228187919463,122,202,0.6039603960396039,84,261,345,123,66,22,124,180,737,2015_Nene Hilario
2015,Nerlens Noel,C,20,302,653,0.46248085758039814,0,0,NaN,302,653,0.46248085758039814,140,230,0.6086956521739131,185,426,611,128,133,142,146,208,744,2015_Nerlens Noel
2015,Phil Pressey,PG,23,64,174,0.367816091954023,16,65,0.24615384615384617,48,109,0.44036697247706424,33,49,0.673469387755102,13,67,80,117,30,6,41,54,177,2015_Phil Pressey
2015,Rudy Gay,SF,28,508,1116,0.4551971326164875,79,220,0.35909090909090907,429,896,0.47879464285714285,337,393,0.8575063613231552,98,301,399,250,71,41,183,157,1432,2015_Rudy Gay
2015,Willie Green,SG,33,118,306,0.38562091503267976,42,121,0.34710743801652894,76,185,0.41081081081081083,28,34,0.8235294117647058,14,65,79,68,26,5,48,81,306,2015_Willie Green
2016,Aaron Harrison,SG,21,5,19,0.2631578947368421,3,10,0.3,2,9,0.2222222222222222,5,12,0.4166666666666667,4,11,15,2,6,0,4,10,18,2016_Aaron Harrison
2016,Archie Goodwin,PG,21,176,422,0.41706161137440756,23,99,0.23232323232323232,153,323,0.47368421052631576,130,193,0.6735751295336787,27,115,142,118,27,13,100,84,505,2016_Archie Goodwin
2016,Cliff Alexander,PF,20,5,10,0.5,0,0,NaN,5,10,0.5,0,0,NaN,2,4,6,0,1,2,1,1,10,2016_Cliff Alexander
2016,Devyn Marble,SG,23,21,71,0.29577464788732394,8,32,0.25,13,39,0.3333333333333333,10,24,0.4166666666666667,6,32,38,12,13,1,7,25,60,2016_Devyn Marble
2016,Gordon Hayward,SF,25,521,1202,0.4334442595673877,143,410,0.348780487804878,378,792,0.4772727272727273,393,477,0.8238993710691824,61,336,397,296,95,27,202,183,1578,2016_Gordon Hayward
2016,Jahlil Okafor,C,20,397,781,0.5083226632522407,1,6,0.16666666666666666,396,775,0.5109677419354839,133,194,0.6855670103092784,122,251,373,65,22,61,124,140,928,2016_Jahlil Okafor
2016,Jarrett Jack,PG,32,140,358,0.39106145251396646,31,102,0.30392156862745096,109,256,0.42578125,100,112,0.8928571428571429,9,127,136,236,34,7,94,77,411,2016_Jarrett Jack
2016,Jason Thompson,C,29,104,216,0.48148148148148145,10,30,0.3333333333333333,94,186,0.5053763440860215,76,108,0.7037037037037037,64,204,268,58,24,40,30,160,294,2016_Jason Thompson
2016,Joe Ingles,SF,28,124,291,0.4261168384879725,81,210,0.38571428571428573,43,81,0.5308641975308642,13,18,0.7222222222222222,19,132,151,96,55,4,65,98,342,2016_Joe Ingles
2016,Matthew Dellavedova,PG,25,207,511,0.4050880626223092,98,239,0.4100418410041841,109,272,0.4007352941176471,57,66,0.8636363636363636,33,129,162,337,44,9,116,178,569,2016_Matthew Dellavedova
2016,Mike Muscala,C,24,76,152,0.5,12,39,0.3076923076923077,64,113,0.5663716814159292,31,39,0.7948717948717948,38,79,117,34,13,27,27,72,195,2016_Mike Muscala
2016,Solomon Hill,SF,24,93,208,0.44711538461538464,24,74,0.32432432432432434,69,134,0.5149253731343284,36,42,0.8571428571428571,39,127,166,57,37,11,33,68,246,2016_Solomon Hill
2016,Terry Rozier,PG,21,29,106,0.27358490566037735,6,27,0.2222222222222222,23,79,0.2911392405063291,8,10,0.8,24,39,63,37,6,1,19,23,72,2016_Terry Rozier
2016,Thanasis Antetokounmpo,SF,23,3,4,0.75,0,1,0.0,3,3,1.0,0,0,NaN,0,1,1,0,0,0,0,2,6,2016_Thanasis Antetokounmpo
2016,Tyus Jones,PG,19,56,156,0.358974358974359,16,53,0.3018867924528302,40,103,0.3883495145631068,28,39,0.717948717948718,7,40,47,108,31,3,33,33,156,2016_Tyus Jones
2017,Andre Drummond,C,23,483,911,0.5301866081229418,2,7,0.2857142857142857,481,904,0.5320796460176991,137,355,0.38591549295774646,345,771,1116,89,124,89,152,237,1105,2017_Andre Drummond
2017,Andre Roberson,SF,25,215,463,0.46436285097192226,45,184,0.24456521739130435,170,279,0.6093189964157706,47,111,0.42342342342342343,98,304,402,79,94,79,51,204,522,2017_Andre Roberson
2017,Anthony Morrow,SG,31,196,504,0.3888888888888889,82,266,0.3082706766917293,114,238,0.4789915966386555,68,74,0.918918918918919,24,38,62,50,48,4,12,88,542,2017_Anthony Morrow
2017,Chris Paul,PG,31,374,785,0.4764331210191083,124,302,0.4105960264900662,250,483,0.5175983436853002,232,260,0.8923076923076924,41,263,304,563,118,8,147,146,1104,2017_Chris Paul
2017,Jahlil Okafor,C,21,242,471,0.5138004246284501,0,0,NaN,242,471,0.5138004246284501,106,158,0.6708860759493671,81,159,240,58,20,49,91,122,590,2017_Jahlil Okafor
2017,Jerryd Bayless,PG,28,11,32,0.34375,2,5,0.4,9,27,0.3333333333333333,9,10,0.9,3,9,12,13,0,0,9,4,33,2017_Jerryd Bayless
2017,Justin Hamilton,C,26,174,379,0.45910290237467016,55,181,0.30386740331491713,119,198,0.601010101010101,39,52,0.75,71,191,262,55,29,43,43,91,442,2017_Justin Hamilton
2017,Kyrie Irving,PG,24,671,1420,0.4725352112676056,177,441,0.4013605442176871,494,979,0.5045965270684372,297,328,0.9054878048780488,52,178,230,418,83,25,180,157,1816,2017_Kyrie Irving
2017,Malik Beasley,SG,20,33,73,0.4520547945205479,9,28,0.32142857142857145,24,45,0.5333333333333333,8,10,0.8,5,12,17,11,7,0,8,10,83,2017_Malik Beasley
2017,Matthew Dellavedova,PG,26,208,534,0.3895131086142322,79,215,0.3674418604651163,129,319,0.4043887147335423,82,96,0.8541666666666666,24,123,147,357,53,0,133,153,577,2017_Matthew Dellavedova
2017,Taurean Waller-Prince,SF,22,114,285,0.4,33,102,0.3235294117647059,81,183,0.4426229508196721,74,94,0.7872340425531915,25,132,157,55,43,27,61,96,335,2017_Taurean Waller-Prince
2017,Trevor Ariza,SF,31,326,798,0.40852130325814534,191,555,0.3441441441441441,135,243,0.5555555555555556,93,126,0.7380952380952381,54,405,459,175,147,20,74,133,936,2017_Trevor Ariza
2003,Anthony Carter,PG,27,83,233,0.3562231759656652,0,8,0.0,83,225,0.3688888888888889,33,50,0.66,12,71,83,203,45,5,81,70,199,2003_Anthony Carter
2003,Bo Outlaw,C,31,153,278,0.5503597122302158,0,2,0.0,153,276,0.5543478260869565,72,116,0.6206896551724138,134,234,368,112,50,71,76,194,378,2003_Bo Outlaw
2003,Bryce Drew,PG,28,8,27,0.2962962962962963,3,7,0.42857142857142855,5,20,0.25,0,0,NaN,4,9,13,11,2,0,3,2,19,2003_Bryce Drew
2003,Chauncey Billups,PG,26,366,870,0.4206896551724138,149,380,0.39210526315789473,217,490,0.44285714285714284,318,362,0.8784530386740331,38,235,273,287,63,15,134,136,1199,2003_Chauncey Billups
2003,Gary Payton,PG,34,1330,2932,0.4536152796725784,108,364,0.2967032967032967,1222,2568,0.47585669781931467,500,704,0.7102272727272727,158,510,668,1326,266,40,374,362,3268,2003_Gary Payton
2003,Glen Rice,SF,35,196,457,0.4288840262582057,101,254,0.39763779527559057,95,203,0.46798029556650245,63,83,0.7590361445783133,28,126,154,65,23,5,55,99,556,2003_Glen Rice
2003,Greg Foster,C,34,47,122,0.38524590163934425,1,4,0.25,46,118,0.3898305084745763,26,32,0.8125,30,72,102,13,1,9,30,82,121,2003_Greg Foster
2003,Greg Ostertag,C,29,169,326,0.5184049079754601,0,0,NaN,169,326,0.5184049079754601,100,196,0.5102040816326531,180,323,503,55,20,147,104,235,438,2003_Greg Ostertag
2003,Jacque Vaughn,PG,27,184,411,0.44768856447688565,8,34,0.23529411764705882,176,377,0.46684350132625996,97,125,0.776,26,92,118,232,64,2,97,169,473,2003_Jacque Vaughn
2003,Jay Williams,PG,21,273,685,0.39854014598540144,65,202,0.3217821782178218,208,483,0.4306418219461698,103,161,0.639751552795031,27,168,195,350,86,17,171,179,714,2003_Jay Williams
2003,Jerome James,C,27,111,232,0.47844827586206895,0,0,NaN,111,232,0.47844827586206895,54,92,0.5869565217391305,78,138,216,27,12,82,75,166,276,2003_Jerome James
2003,John Salmons,PG,23,48,116,0.41379310344827586,10,31,0.3225806451612903,38,85,0.4470588235294118,26,35,0.7428571428571429,16,43,59,47,17,6,29,53,132,2003_John Salmons
2003,Malik Rose,PF,28,289,630,0.4587301587301587,2,5,0.4,287,625,0.4592,242,306,0.7908496732026143,148,358,506,124,57,40,170,206,822,2003_Malik Rose
2003,Manu Ginobili,SG,25,174,397,0.43828715365239296,51,148,0.34459459459459457,123,249,0.4939759036144578,126,171,0.7368421052631579,47,114,161,138,96,17,100,170,525,2003_Manu Ginobili
2003,Quentin Richardson,SG,22,203,546,0.3717948717948718,61,198,0.30808080808080807,142,348,0.40804597701149425,85,124,0.6854838709677419,98,183,281,52,35,10,64,92,552,2003_Quentin Richardson
2003,Randy Brown,PG,34,16,43,0.37209302325581395,0,0,NaN,16,43,0.37209302325581395,9,12,0.75,3,23,26,35,17,2,17,36,41,2003_Randy Brown
2003,Soumaila Samake,C,24,10,24,0.4166666666666667,0,0,NaN,10,24,0.4166666666666667,2,2,1.0,10,13,23,4,0,5,2,13,22,2003_Soumaila Samake
2003,Steve Nash,PG,28,518,1114,0.4649910233393178,111,269,0.41263940520446096,407,845,0.4816568047337278,308,339,0.9085545722713865,63,171,234,598,85,6,192,134,1455,2003_Steve Nash
2004,Adonal Foyle,C,28,59,130,0.45384615384615384,0,0,NaN,59,130,0.45384615384615384,19,35,0.5428571428571428,54,113,167,17,6,46,21,68,137,2004_Adonal Foyle
2004,Bo Outlaw,PF,32,159,312,0.5096153846153846,0,4,0.0,159,308,0.5162337662337663,61,116,0.5258620689655172,125,217,342,90,73,70,69,170,379,2004_Bo Outlaw
2004,Darius Miles,SF,22,730,1506,0.4847277556440903,14,80,0.175,716,1426,0.5021037868162693,248,386,0.6424870466321243,224,494,718,324,134,122,260,336,1722,2004_Darius Miles
2004,Derek Anderson,SG,29,230,612,0.3758169934640523,79,259,0.305019305019305,151,353,0.42776203966005666,155,188,0.824468085106383,26,156,182,228,66,3,90,79,694,2004_Derek Anderson
2004,Gary Payton,PG,35,482,1024,0.470703125,55,165,0.3333333333333333,427,859,0.4970896391152503,180,252,0.7142857142857143,72,270,342,449,96,19,151,169,1199,2004_Gary Payton
2004,Glen Rice,SF,36,22,76,0.2894736842105263,5,28,0.17857142857142858,17,48,0.3541666666666667,17,17,1.0,9,32,41,24,6,0,13,22,66,2004_Glen Rice
2004,Jacque Vaughn,PG,28,107,277,0.3862815884476534,3,20,0.15,104,257,0.4046692607003891,53,68,0.7794117647058824,12,104,116,195,44,2,84,126,270,2004_Jacque Vaughn
2004,Jerome Moiso,PF,25,40,84,0.47619047619047616,0,1,0.0,40,83,0.4819277108433735,22,38,0.5789473684210527,41,72,113,8,17,12,25,42,102,2004_Jerome Moiso
2004,Josh Howard,SF,23,229,532,0.43045112781954886,20,66,0.30303030303030304,209,466,0.44849785407725323,97,138,0.7028985507246377,149,219,368,97,69,54,67,168,575,2004_Josh Howard
2004,Manu Ginobili,SG,26,330,789,0.41825095057034223,88,245,0.35918367346938773,242,544,0.44485294117647056,239,298,0.802013422818792,86,258,344,291,136,16,161,181,987,2004_Manu Ginobili
2004,Ndudi Ebi,SF,19,6,14,0.42857142857142855,0,0,NaN,6,14,0.42857142857142855,1,4,0.25,2,1,3,3,0,4,3,6,13,2004_Ndudi Ebi
2004,Shandon Anderson,SG,30,238,564,0.4219858156028369,36,128,0.28125,202,436,0.463302752293578,123,161,0.7639751552795031,53,169,222,122,68,17,118,182,635,2004_Shandon Anderson
2004,Shaquille O'Neal,C,31,554,948,0.5843881856540084,0,0,NaN,554,948,0.5843881856540084,331,676,0.4896449704142012,246,523,769,196,34,166,195,225,1439,2004_Shaquille O'Neal
2005,Ben Wallace,C,30,295,651,0.45314900153609833,1,9,0.1111111111111111,294,642,0.45794392523364486,130,304,0.4276315789473684,292,610,902,123,106,176,82,159,721,2005_Ben Wallace
2005,Bo Outlaw,PF,33,12,34,0.35294117647058826,0,0,NaN,12,34,0.35294117647058826,5,9,0.5555555555555556,16,37,53,13,6,12,8,29,29,2005_Bo Outlaw
2005,Derek Fisher,PG,30,297,755,0.3933774834437086,108,291,0.3711340206185567,189,464,0.4073275862068966,175,203,0.8620689655172413,38,180,218,301,76,4,129,176,877,2005_Derek Fisher
2005,Emeka Okafor,PF,22,448,1003,0.44666001994017945,0,1,0.0,448,1002,0.4471057884231537,209,343,0.60932944606414,275,520,795,64,62,125,125,214,1105,2005_Emeka Okafor
2005,Gary Payton,PG,36,339,725,0.4675862068965517,42,129,0.32558139534883723,297,596,0.4983221476510067,153,201,0.7611940298507462,48,188,236,469,88,12,148,121,873,2005_Gary Payton
2005,Horace Jenkins,PG,30,15,45,0.3333333333333333,0,9,0.0,15,36,0.4166666666666667,12,13,0.9230769230769231,3,6,9,9,5,1,7,6,42,2005_Horace Jenkins
2005,Jacque Vaughn,SG,29,146,325,0.4492307692307692,5,15,0.3333333333333333,141,310,0.45483870967741935,76,91,0.8351648351648352,17,90,107,135,41,1,62,138,373,2005_Jacque Vaughn
2005,Josh Howard,SF,24,377,793,0.47540983606557374,34,115,0.2956521739130435,343,678,0.5058997050147492,170,232,0.7327586206896551,169,315,484,109,116,49,122,211,958,2005_Josh Howard
2005,Kaniel Dickens,SF,26,4,14,0.2857142857142857,3,9,0.3333333333333333,1,5,0.2,2,2,1.0,3,6,9,1,2,1,2,5,13,2005_Kaniel Dickens
2005,Kendrick Perkins,C,20,56,119,0.47058823529411764,0,0,NaN,56,119,0.47058823529411764,37,58,0.6379310344827587,53,123,176,21,9,37,43,98,149,2005_Kendrick Perkins
2005,Manu Ginobili,SG,27,367,780,0.4705128205128205,97,258,0.375968992248062,270,522,0.5172413793103449,355,442,0.8031674208144797,75,254,329,288,119,27,172,190,1186,2005_Manu Ginobili
2005,Marcus Haislip,PF,24,13,38,0.34210526315789475,0,1,0.0,13,37,0.35135135135135137,6,11,0.5454545454545454,5,10,15,3,2,2,6,15,32,2005_Marcus Haislip
2005,Sasha Vujacic,SG,20,33,117,0.28205128205128205,17,63,0.2698412698412698,16,54,0.2962962962962963,18,19,0.9473684210526315,13,49,62,51,12,2,15,41,101,2005_Sasha Vujacic
2005,Yuta Tabuse,PG,24,1,6,0.16666666666666666,1,1,1.0,0,5,0.0,4,4,1.0,2,2,4,3,0,0,1,1,7,2005_Yuta Tabuse
2006,Alex Scales,SG,27,0,0,NaN,0,0,NaN,0,0,NaN,0,0,NaN,0,0,0,0,0,0,0,0,0,2006_Alex Scales
2006,Awvee Storey,SF,28,16,41,0.3902439024390244,3,7,0.42857142857142855,13,34,0.38235294117647056,8,14,0.5714285714285714,8,14,22,4,3,1,5,22,43,2006_Awvee Storey
2006,Ben Wallace,C,31,237,465,0.5096774193548387,0,4,0.0,237,461,0.5140997830802603,123,296,0.4155405405405405,301,622,923,158,146,181,88,164,597,2006_Ben Wallace
2006,Bo Outlaw,PF,34,35,58,0.603448275862069,0,0,NaN,35,58,0.603448275862069,5,8,0.625,31,46,77,14,10,12,17,50,75,2006_Bo Outlaw
2006,Chuck Hayes,PF,22,59,105,0.5619047619047619,0,1,0.0,59,104,0.5673076923076923,29,45,0.6444444444444445,67,112,179,14,26,14,12,76,147,2006_Chuck Hayes
2006,Earl Barron,C,24,5,16,0.3125,0,0,NaN,5,16,0.3125,3,4,0.75,2,8,10,0,0,0,5,10,13,2006_Earl Barron
2006,Gary Payton,PG,37,230,547,0.42047531992687387,66,230,0.28695652173913044,164,317,0.5173501577287066,100,126,0.7936507936507936,34,199,233,257,71,10,102,169,626,2006_Gary Payton
2006,Jackson Vroman,PF,24,26,66,0.3939393939393939,0,0,NaN,26,66,0.3939393939393939,21,44,0.4772727272727273,33,53,86,11,12,11,21,78,73,2006_Jackson Vroman
2006,Joe Smith,PF,30,145,305,0.47540983606557374,0,2,0.0,145,303,0.47854785478547857,89,115,0.7739130434782608,83,147,230,31,24,13,40,120,379,2006_Joe Smith
2006,Josh Howard,SF,25,350,743,0.47106325706594887,27,63,0.42857142857142855,323,680,0.475,196,267,0.7340823970037453,123,248,371,111,68,26,79,167,923,2006_Josh Howard
2006,Manu Ginobili,SG,28,309,669,0.4618834080717489,83,217,0.3824884792626728,226,452,0.5,280,360,0.7777777777777778,42,188,230,235,101,26,121,156,981,2006_Manu Ginobili
2006,Martynas Andriuskevicius,C,19,0,1,0.0,0,0,NaN,0,1,0.0,0,0,NaN,1,3,4,0,2,0,0,1,0,2006_Martynas Andriuskevicius
2006,Orien Greene,PG,23,100,253,0.3952569169960474,9,40,0.225,91,213,0.4272300469483568,45,68,0.6617647058823529,37,108,145,129,77,10,109,181,254,2006_Orien Greene
2006,Robert Horry,PF,35,112,292,0.3835616438356164,53,144,0.3680555555555556,59,148,0.39864864864864863,44,68,0.6470588235294118,71,171,242,79,43,51,41,115,321,2006_Robert Horry
2006,Sasha Vujacic,PG,21,108,312,0.34615384615384615,59,172,0.3430232558139535,49,140,0.35,46,52,0.8846153846153846,33,126,159,139,48,3,50,150,321,2006_Sasha Vujacic
2007,Antawn Jamison,PF,30,512,1139,0.4495171202809482,138,379,0.3641160949868074,374,760,0.4921052631578947,226,307,0.7361563517915309,134,428,562,136,80,36,104,194,1388,2007_Antawn Jamison
2007,Ben Wallace,C,32,192,424,0.4528301886792453,1,5,0.2,191,419,0.45584725536992843,109,267,0.40823970037453183,303,518,821,186,111,156,101,153,494,2007_Ben Wallace
2007,Bo Outlaw,PF,35,34,51,0.6666666666666666,0,0,NaN,34,51,0.6666666666666666,13,22,0.5909090909090909,47,59,106,16,17,6,21,57,81,2007_Bo Outlaw
2007,Brian Cardinal,PF,29,42,85,0.49411764705882355,18,44,0.4090909090909091,24,41,0.5853658536585366,25,27,0.9259259259259259,13,46,59,31,22,1,23,42,127,2007_Brian Cardinal
2007,Chuck Hayes,PF,23,192,335,0.573134328358209,0,0,NaN,192,335,0.573134328358209,55,89,0.6179775280898876,204,317,521,47,70,18,64,281,439,2007_Chuck Hayes
2007,Delonte West,SG,23,306,717,0.42677824267782427,65,178,0.3651685393258427,241,539,0.44712430426716143,168,197,0.8527918781725888,32,176,208,304,74,34,140,152,845,2007_Delonte West
2007,Earl Barron,C,25,24,83,0.2891566265060241,0,1,0.0,24,82,0.2926829268292683,17,18,0.9444444444444444,19,22,41,5,6,4,11,21,65,2007_Earl Barron
2007,Gary Payton,PG,38,144,366,0.39344262295081966,32,123,0.2601626016260163,112,243,0.4609053497942387,38,57,0.6666666666666666,18,114,132,201,43,3,66,117,358,2007_Gary Payton
2007,Joe Smith,PF,31,428,954,0.44863731656184486,0,10,0.0,428,944,0.4533898305084746,250,296,0.8445945945945946,240,560,800,98,74,54,152,296,1106,2007_Joe Smith
2007,Jordan Farmar,PG,20,124,294,0.4217687074829932,45,137,0.3284671532846715,79,157,0.5031847133757962,27,38,0.7105263157894737,22,97,119,137,44,7,73,77,320,2007_Jordan Farmar
2007,Josh Boone,PF,22,99,171,0.5789473684210527,0,0,NaN,99,171,0.5789473684210527,56,103,0.5436893203883495,64,112,176,10,11,21,33,94,254,2007_Josh Boone
2007,Josh Howard,SF,26,493,1075,0.4586046511627907,92,239,0.38493723849372385,401,836,0.4796650717703349,243,294,0.826530612244898,130,345,475,127,82,56,123,180,1321,2007_Josh Howard
2007,Luke Jackson,SF,25,38,86,0.4418604651162791,10,34,0.29411764705882354,28,52,0.5384615384615384,10,18,0.5555555555555556,4,16,20,26,10,2,14,30,96,2007_Luke Jackson
2007,Manu Ginobili,SG,29,396,854,0.4637002341920375,128,323,0.39628482972136225,268,531,0.504708097928437,320,372,0.8602150537634409,59,268,327,263,109,27,157,155,1240,2007_Manu Ginobili
2007,Melvin Ely,C_PF_PF-C,28,58,160,0.3625,0,0,NaN,58,160,0.3625,62,94,0.6595744680851063,30,76,106,36,12,16,56,102,178,2007_Melvin Ely
2007,Mike Wilks,PG,27,66,141,0.46808510638297873,5,15,0.3333333333333333,61,126,0.48412698412698413,33,42,0.7857142857142857,15,39,54,79,15,4,31,53,170,2007_Mike Wilks
2007,Sasha Vujacic,SG,22,105,268,0.3917910447761194,60,161,0.37267080745341613,45,107,0.4205607476635514,43,49,0.8775510204081632,28,79,107,64,41,1,30,103,313,2007_Sasha Vujacic
2007,Vince Carter,SG,30,726,1598,0.45431789737171463,156,437,0.35697940503432496,570,1161,0.4909560723514212,462,576,0.8020833333333334,114,378,492,393,82,30,217,266,2070,2007_Vince Carter
2007,Will Blalock,PG,23,9,30,0.3,1,5,0.2,8,25,0.32,6,6,1.0,6,9,15,17,5,0,12,9,25,2007_Will Blalock
2008,Al Jefferson,C,23,721,1441,0.5003469812630118,0,5,0.0,721,1436,0.5020891364902507,284,394,0.7208121827411168,308,603,911,117,74,119,167,222,1726,2008_Al Jefferson
2008,Ben Wallace,C_PF_C-PF,33,276,704,0.39204545454545453,0,8,0.0,276,696,0.39655172413793105,144,338,0.4260355029585799,468,740,1208,210,176,234,134,242,696,2008_Ben Wallace
2008,Bo Outlaw,PF,36,2,3,0.6666666666666666,0,0,NaN,2,3,0.6666666666666666,0,0,NaN,0,0,0,0,0,0,1,1,4,2008_Bo Outlaw
2008,Chuck Hayes,PF,24,113,221,0.5113122171945701,0,3,0.0,113,218,0.518348623853211,11,24,0.4583333333333333,132,295,427,91,85,43,62,212,237,2008_Chuck Hayes
2008,Corey Maggette,SF,28,458,1000,0.458,78,203,0.3842364532019704,380,797,0.4767879548306148,553,681,0.8120411160058737,78,316,394,189,71,7,195,210,1547,2008_Corey Maggette
2008,Earl Barron,C,26,132,327,0.4036697247706422,1,13,0.07692307692307693,131,314,0.4171974522292994,61,87,0.7011494252873564,67,131,198,29,19,8,48,114,326,2008_Earl Barron
2008,Guillermo Diaz,SG,22,1,4,0.25,0,1,0.0,1,3,0.3333333333333333,3,5,0.6,2,0,2,1,0,0,0,0,5,2008_Guillermo Diaz
2008,Joe Smith,PF,32,624,1306,0.4777947932618683,0,6,0.0,624,1300,0.48,308,408,0.7549019607843137,326,476,802,132,68,94,142,372,1556,2008_Joe Smith
2008,Jordan Farmar,PG,21,291,631,0.4611727416798732,114,307,0.3713355048859935,177,324,0.5462962962962963,53,78,0.6794871794871795,39,144,183,225,77,5,108,105,749,2008_Jordan Farmar
2008,Josh Howard,SF,27,567,1247,0.454691259021652,67,210,0.319047619047619,500,1037,0.4821600771456123,312,384,0.8125,120,412,532,164,59,32,114,202,1513,2008_Josh Howard
2008,Sasha Vujacic,SG,23,219,482,0.45435684647302904,118,270,0.43703703703703706,101,212,0.47641509433962265,76,91,0.8351648351648352,19,135,154,72,36,5,52,107,632,2008_Sasha Vujacic
2008,Shavlik Randolph,PF,24,4,14,0.2857142857142857,0,0,NaN,4,14,0.2857142857142857,0,0,NaN,9,2,11,3,1,3,2,5,8,2008_Shavlik Randolph
2009,Ben Wallace,PF,34,69,155,0.44516129032258067,0,0,NaN,69,155,0.44516129032258067,27,64,0.421875,136,226,362,44,48,75,34,82,165,2009_Ben Wallace
2009,Chuck Hayes,C,25,42,113,0.37168141592920356,0,4,0.0,42,109,0.3853211009174312,7,19,0.3684210526315789,74,176,250,42,34,19,25,134,91,2009_Chuck Hayes
2009,Corey Brewer,SF,22,37,90,0.4111111111111111,5,12,0.4166666666666667,32,78,0.41025641025641024,14,19,0.7368421052631579,18,31,49,25,15,3,13,37,93,2009_Corey Brewer
2009,Darius Songaila,C,30,243,457,0.5317286652078774,0,1,0.0,243,456,0.5328947368421053,80,90,0.8888888888888888,75,152,227,94,64,20,74,200,566,2009_Darius Songaila
2009,David West,PF,28,610,1292,0.47213622291021673,6,25,0.24,604,1267,0.47671665351223363,367,415,0.8843373493975903,160,486,646,173,49,68,163,207,1593,2009_David West
2009,Demetris Nichols,SF,24,6,18,0.3333333333333333,0,4,0.0,6,14,0.42857142857142855,2,4,0.5,0,4,4,2,0,2,0,2,14,2009_Demetris Nichols
2009,J.J. Barea,SG,24,246,557,0.44165170556552963,55,154,0.35714285714285715,191,403,0.4739454094292804,70,93,0.7526881720430108,36,141,177,269,37,5,105,121,617,2009_J.J. Barea
2009,Joe Smith,C,33,312,666,0.46846846846846846,6,14,0.42857142857142855,306,652,0.46932515337423314,118,164,0.7195121951219512,178,348,526,82,34,80,50,244,748,2009_Joe Smith
2009,Jordan Farmar,PG,22,161,412,0.3907766990291262,49,146,0.3356164383561644,112,266,0.42105263157894735,45,77,0.5844155844155844,22,95,117,155,57,10,87,105,416,2009_Jordan Farmar
2009,Josh Howard,SF,28,353,783,0.4508301404853129,58,168,0.34523809523809523,295,615,0.4796747967479675,172,220,0.7818181818181819,59,204,263,83,55,30,89,135,936,2009_Josh Howard
2009,Kosta Koufos,C,19,94,185,0.5081081081081081,0,0,NaN,94,185,0.5081081081081081,36,51,0.7058823529411765,50,88,138,20,12,31,26,70,224,2009_Kosta Koufos
2009,Marcus Banks,PG,27,42,114,0.3684210526315789,6,38,0.15789473684210525,36,76,0.47368421052631576,22,36,0.6111111111111112,2,34,36,56,22,4,28,52,112,2009_Marcus Banks
2009,Royal Ivey,SG,27,69,208,0.3317307692307692,39,114,0.34210526315789475,30,94,0.3191489361702128,34,43,0.7906976744186046,19,57,76,43,36,7,23,76,211,2009_Royal Ivey
2009,Sasha Vujacic,SG,24,155,401,0.3865336658354115,81,223,0.3632286995515695,74,178,0.4157303370786517,70,76,0.9210526315789473,19,116,135,113,77,7,35,154,461,2009_Sasha Vujacic
2009,Stephen Graham,SG,26,106,256,0.4140625,20,66,0.30303030303030304,86,190,0.45263157894736844,50,62,0.8064516129032258,21,75,96,33,10,4,45,82,282,2009_Stephen Graham
2010,Al Thornton,SF,26,640,1352,0.47337278106508873,22,62,0.3548387096774194,618,1290,0.4790697674418605,306,422,0.7251184834123223,232,356,588,180,90,70,204,412,1608,2010_Al Thornton
2010,Eduardo Najera,PF,33,124,292,0.4246575342465753,38,128,0.296875,86,164,0.524390243902439,28,48,0.5833333333333334,68,162,230,58,52,28,50,188,314,2010_Eduardo Najera
2010,Jeff Teague,PG,21,90,227,0.3964757709251101,7,32,0.21875,83,195,0.4256410256410256,41,49,0.8367346938775511,5,62,67,122,34,11,50,82,228,2010_Jeff Teague
2010,Jermaine Taylor,SG,23,45,119,0.37815126050420167,5,22,0.22727272727272727,40,97,0.41237113402061853,33,46,0.717391304347826,21,25,46,16,10,3,19,15,128,2010_Jermaine Taylor
2010,Manu Ginobili,SG,32,398,903,0.4407530454042082,132,350,0.37714285714285717,266,553,0.4810126582278481,309,355,0.8704225352112676,68,216,284,370,103,24,154,154,1237,2010_Manu Ginobili
2010,Marcus Landry,SF,24,32,86,0.37209302325581395,18,56,0.32142857142857145,14,30,0.4666666666666667,6,10,0.6,10,28,38,0,2,4,12,28,88,2010_Marcus Landry
2010,Michael Finley,SF,36,162,368,0.44021739130434784,64,164,0.3902439024390244,98,204,0.4803921568627451,16,30,0.5333333333333333,12,130,142,86,20,12,42,66,404,2010_Michael Finley
2010,Nene Hilario,C,27,421,717,0.5871687587168759,0,2,0.0,421,715,0.5888111888111888,293,416,0.7043269230769231,166,461,627,203,115,82,125,281,1135,2010_Nene Hilario
2010,Robin Lopez,C,21,171,291,0.5876288659793815,0,0,NaN,171,291,0.5876288659793815,88,125,0.704,104,144,248,7,10,53,41,117,430,2010_Robin Lopez
2010,Stephen Curry,PG,21,528,1143,0.46194225721784776,166,380,0.4368421052631579,362,763,0.4744429882044561,177,200,0.885,48,308,356,472,152,19,243,252,1399,2010_Stephen Curry
2010,Willie Green,SG,28,248,543,0.4567219152854512,47,136,0.34558823529411764,201,407,0.49385749385749383,95,114,0.8333333333333334,20,109,129,152,32,11,67,135,638,2010_Willie Green
2011,Al Thornton,SF-PF_SF_PF,27,410,862,0.4756380510440835,8,52,0.15384615384615385,402,810,0.4962962962962963,220,284,0.7746478873239436,112,314,426,124,70,24,128,286,1048,2011_Al Thornton
2011,C.J. Miles,SF,23,366,899,0.407119021134594,109,339,0.3215339233038348,257,560,0.4589285714285714,159,196,0.8112244897959183,54,201,255,135,74,38,93,221,1000,2011_C.J. Miles
2011,Ekpe Udoh,C,23,97,222,0.4369369369369369,0,0,NaN,97,222,0.4369369369369369,42,64,0.65625,80,101,181,40,22,86,48,144,236,2011_Ekpe Udoh
2011,Evan Turner,SG,22,225,529,0.42533081285444235,14,44,0.3181818181818182,211,485,0.4350515463917526,101,125,0.808,42,264,306,159,49,14,80,138,565,2011_Evan Turner
2011,Jarrett Jack,SG-PG_SG_PG,27,520,1274,0.40816326530612246,66,216,0.3055555555555556,454,1058,0.42911153119092627,364,428,0.8504672897196262,40,306,346,484,108,12,220,204,1470,2011_Jarrett Jack
2011,Jeff Teague,PG,22,133,304,0.4375,18,48,0.375,115,256,0.44921875,77,97,0.7938144329896907,11,91,102,138,45,25,64,82,361,2011_Jeff Teague
2011,Jermaine Taylor,SG,24,188,392,0.47959183673469385,28,90,0.3111111111111111,160,302,0.5298013245033113,42,56,0.75,52,72,124,64,28,10,92,78,446,2011_Jermaine Taylor
2011,Josh Howard,SF,30,58,162,0.35802469135802467,7,29,0.2413793103448276,51,133,0.38345864661654133,29,47,0.6170212765957447,18,56,74,24,13,5,20,34,152,2011_Josh Howard
2011,Keith Bogans,SG,30,124,307,0.40390879478827363,90,237,0.379746835443038,34,70,0.4857142857142857,21,32,0.65625,19,129,148,101,38,9,41,113,359,2011_Keith Bogans
2011,Lamar Odom,PF,31,473,893,0.5296752519596865,68,178,0.38202247191011235,405,715,0.5664335664335665,166,246,0.6747967479674797,175,535,710,249,47,61,139,200,1180,2011_Lamar Odom
2011,Manu Ginobili,SG,33,441,1018,0.43320235756385067,154,441,0.3492063492063492,287,577,0.49740034662045063,357,410,0.8707317073170732,42,253,295,393,123,28,174,163,1393,2011_Manu Ginobili
2011,Quinton Ross,SF,29,26,59,0.4406779661016949,0,3,0.0,26,56,0.4642857142857143,5,14,0.35714285714285715,10,20,30,10,3,6,7,40,57,2011_Quinton Ross
2011,Robin Lopez,C,22,179,357,0.5014005602240896,0,0,NaN,179,357,0.5014005602240896,74,100,0.74,82,134,216,8,18,45,48,143,432,2011_Robin Lopez
2011,Shawne Williams,PF,24,164,385,0.42597402597402595,85,212,0.4009433962264151,79,173,0.45664739884393063,41,49,0.8367346938775511,60,179,239,47,39,51,46,164,454,2011_Shawne Williams
2011,Stephen Curry,PG,22,505,1053,0.4795821462488129,151,342,0.4415204678362573,354,711,0.4978902953586498,212,227,0.933920704845815,52,234,286,432,109,20,226,233,1373,2011_Stephen Curry
2012,Aaron Gray,C,27,83,161,0.515527950310559,0,0,NaN,83,161,0.515527950310559,25,47,0.5319148936170213,83,198,281,27,22,17,51,127,191,2012_Aaron Gray
2012,Andres Nocioni,SF,32,5,20,0.25,1,6,0.16666666666666666,4,14,0.2857142857142857,6,11,0.5454545454545454,1,13,14,1,1,1,5,4,17,2012_Andres Nocioni
2012,Anthony Morrow,SG,26,272,658,0.4133738601823708,106,286,0.3706293706293706,166,372,0.44623655913978494,97,104,0.9326923076923077,31,96,127,61,46,9,70,86,747,2012_Anthony Morrow
2012,Chris Paul,PG,26,425,890,0.47752808988764045,79,213,0.37089201877934275,346,677,0.5110782865583456,260,302,0.8609271523178808,42,171,213,543,152,4,124,138,1189,2012_Chris Paul
2012,Chris Wright,SF,23,23,45,0.5111111111111111,0,0,NaN,23,45,0.5111111111111111,24,31,0.7741935483870968,19,26,45,4,7,13,8,22,70,2012_Chris Wright
2012,Daequan Cook,SG,24,109,296,0.36824324324324326,79,228,0.34649122807017546,30,68,0.4411764705882353,14,22,0.6363636363636364,12,110,122,15,22,11,16,69,311,2012_Daequan Cook
2012,Donte Greene,PF,23,108,266,0.40601503759398494,25,105,0.23809523809523808,83,161,0.515527950310559,44,55,0.8,19,114,133,34,18,29,32,67,285,2012_Donte Greene
2012,Earl Barron,C,30,2,4,0.5,0,0,NaN,2,4,0.5,0,0,NaN,1,0,1,0,0,0,0,5,4,2012_Earl Barron
2012,Ekpe Udoh,C,24,254,590,0.43050847457627117,0,4,0.0,254,586,0.4334470989761092,172,228,0.7543859649122807,200,308,508,114,80,204,106,348,680,2012_Ekpe Udoh
2012,Evan Turner,SF,23,263,590,0.4457627118644068,11,49,0.22448979591836735,252,541,0.4658040665434381,73,108,0.6759259259259259,27,349,376,180,40,20,105,117,610,2012_Evan Turner
2012,Glen Davis,PF,26,225,534,0.42134831460674155,2,14,0.14285714285714285,223,520,0.4288461538461538,114,167,0.6826347305389222,107,224,331,47,43,19,75,106,566,2012_Glen Davis
2012,Isaiah Thomas,PG,22,256,571,0.44833625218914186,83,219,0.3789954337899543,173,352,0.4914772727272727,154,185,0.8324324324324325,48,120,168,266,53,8,105,121,749,2012_Isaiah Thomas
2012,Jeff Teague,PG,23,320,672,0.47619047619047616,51,149,0.3422818791946309,269,523,0.51434034416826,140,185,0.7567567567567568,21,138,159,321,106,37,134,145,831,2012_Jeff Teague
2012,Jeremy Evans,SF,24,27,42,0.6428571428571429,0,1,0.0,27,41,0.6585365853658537,8,16,0.5,19,31,50,13,6,24,5,23,62,2012_Jeremy Evans
2012,Josh Howard,SF,31,144,361,0.3988919667590028,9,37,0.24324324324324326,135,324,0.4166666666666667,75,97,0.7731958762886598,39,119,158,50,32,10,53,91,372,2012_Josh Howard
2012,Josh Selby,PG,20,25,72,0.3472222222222222,2,15,0.13333333333333333,23,57,0.40350877192982454,11,14,0.7857142857142857,2,13,15,30,7,0,29,17,63,2012_Josh Selby
2012,Kyrie Irving,PG,19,350,747,0.4685408299866131,73,183,0.3989071038251366,277,564,0.49113475177304966,171,196,0.8724489795918368,44,147,191,275,54,20,160,110,944,2012_Kyrie Irving
2012,Luke Babbitt,SF,22,71,173,0.41040462427745666,43,100,0.43,28,73,0.3835616438356164,17,20,0.85,16,79,95,16,10,4,27,46,202,2012_Luke Babbitt
2012,Manu Ginobili,SG,34,150,285,0.5263157894736842,52,126,0.4126984126984127,98,159,0.6163522012578616,88,101,0.8712871287128713,18,98,116,151,24,12,64,56,440,2012_Manu Ginobili
2012,Michael Redd,SG,32,144,360,0.4,42,132,0.3181818181818182,102,228,0.4473684210526316,88,111,0.7927927927927928,14,63,77,33,13,0,37,29,418,2012_Michael Redd
2012,Robin Lopez,C,23,124,269,0.46096654275092935,0,0,NaN,124,269,0.46096654275092935,100,140,0.7142857142857143,90,119,209,20,18,60,43,128,348,2012_Robin Lopez
2012,Shawne Williams,SF,25,42,147,0.2857142857142857,21,87,0.2413793103448276,21,60,0.35,8,11,0.7272727272727273,20,48,68,16,10,11,13,44,113,2012_Shawne Williams
2012,Stephen Curry,PG,23,145,296,0.48986486486486486,55,121,0.45454545454545453,90,175,0.5142857142857142,38,47,0.8085106382978723,15,73,88,138,39,8,65,62,383,2012_Stephen Curry
2012,Thaddeus Young,PF,23,348,687,0.5065502183406113,1,4,0.25,347,683,0.5080527086383602,111,144,0.7708333333333334,137,188,325,74,64,41,55,127,808,2012_Thaddeus Young
2012,Trevor Ariza,SF,26,168,403,0.41687344913151364,29,87,0.3333333333333333,139,316,0.439873417721519,79,102,0.7745098039215687,41,174,215,135,69,25,76,73,444,2012_Trevor Ariza
2013,Brandan Wright,C,25,241,404,0.5965346534653465,0,3,0.0,241,401,0.600997506234414,59,96,0.6145833333333334,85,175,260,38,26,76,34,78,541,2013_Brandan Wright
2013,Carlos Delfino,SF,30,251,620,0.40483870967741936,158,421,0.3752969121140142,93,199,0.46733668341708545,48,56,0.8571428571428571,18,202,220,135,68,9,72,114,708,2013_Carlos Delfino
2013,Chase Budinger,SF,24,79,191,0.41361256544502617,26,81,0.32098765432098764,53,110,0.4818181818181818,32,42,0.7619047619047619,15,56,71,25,14,7,23,29,216,2013_Chase Budinger
2013,Earl Barron,C,31,36,102,0.35294117647058826,0,0,NaN,36,102,0.35294117647058826,6,14,0.42857142857142855,44,78,122,10,10,12,22,48,78,2013_Earl Barron
2013,Ekpe Udoh,C,25,117,269,0.4349442379182156,0,1,0.0,117,268,0.43656716417910446,89,119,0.7478991596638656,113,138,251,43,39,85,43,139,323,2013_Ekpe Udoh
2013,Evan Turner,SF,24,441,1053,0.4188034188034188,58,159,0.36477987421383645,383,894,0.42841163310961966,154,208,0.7403846153846154,56,461,517,354,71,17,187,197,1094,2013_Evan Turner
2013,Isaiah Thomas,PG,23,366,832,0.43990384615384615,115,321,0.3582554517133956,251,511,0.4911937377690802,253,287,0.8815331010452961,29,132,161,316,67,3,140,167,1100,2013_Isaiah Thomas
2013,Jared Dudley,SF,27,313,669,0.4678624813153961,106,271,0.39114391143911437,207,398,0.5201005025125628,129,162,0.7962962962962963,79,166,245,203,75,8,101,128,861,2013_Jared Dudley
2013,Jeff Teague,PG,24,439,974,0.45071868583162217,89,248,0.3588709677419355,350,726,0.4820936639118457,199,226,0.8805309734513275,25,155,180,579,117,28,230,181,1166,2013_Jeff Teague
2013,Josh Howard,SF,32,31,77,0.4025974025974026,5,16,0.3125,26,61,0.4262295081967213,7,12,0.5833333333333334,9,27,36,4,10,3,10,18,74,2013_Josh Howard
2013,Manu Ginobili,SG,35,229,539,0.424860853432282,83,235,0.35319148936170214,146,304,0.48026315789473684,164,206,0.7961165048543689,30,171,201,274,80,13,132,114,705,2013_Manu Ginobili
2013,Robin Lopez,C,24,384,719,0.5340751043115438,0,0,NaN,384,719,0.5340751043115438,161,207,0.7777777777777778,226,236,462,64,32,128,110,167,929,2013_Robin Lopez
2013,Stephen Curry,PG,24,626,1388,0.4510086455331412,272,600,0.4533333333333333,354,788,0.44923857868020306,262,291,0.9003436426116839,59,255,314,539,126,12,240,198,1786,2013_Stephen Curry
2014,Alexey Shved,SG,25,76,237,0.3206751054852321,30,102,0.29411764705882354,46,135,0.34074074074074073,68,90,0.7555555555555555,21,60,81,68,26,16,48,36,250,2014_Alexey Shved
2014,Chauncey Billups,SG,37,24,79,0.3037974683544304,14,48,0.2916666666666667,10,31,0.3225806451612903,10,12,0.8333333333333334,4,24,28,42,8,1,25,25,72,2014_Chauncey Billups
2014,Chuck Hayes,C,30,112,260,0.4307692307692308,0,2,0.0,112,258,0.43410852713178294,40,50,0.8,138,282,420,70,68,24,66,190,264,2014_Chuck Hayes
2014,Ekpe Udoh,PF,26,57,143,0.3986013986013986,0,0,NaN,57,143,0.3986013986013986,30,47,0.6382978723404256,61,87,148,31,15,44,38,96,144,2014_Ekpe Udoh
2014,Evan Turner,SF,25,868,2042,0.4250734573947111,100,312,0.32051282051282054,768,1730,0.4439306358381503,426,524,0.8129770992366412,124,692,816,524,134,14,378,390,2262,2014_Evan Turner
2014,Gal Mekel,PG,25,30,86,0.3488372093023256,5,20,0.25,25,66,0.3787878787878788,8,12,0.6666666666666666,5,22,27,63,4,1,31,31,73,2014_Gal Mekel
2014,Greg Smith,C,23,18,28,0.6428571428571429,0,0,NaN,18,28,0.6428571428571429,2,5,0.4,11,16,27,0,1,2,5,17,38,2014_Greg Smith
2014,Isaiah Thomas,PG,24,496,1096,0.45255474452554745,127,364,0.3489010989010989,369,732,0.5040983606557377,346,407,0.8501228501228502,47,163,210,454,93,8,213,185,1465,2014_Isaiah Thomas
2014,Jamaal Franklin,SG,22,16,39,0.41025641025641024,5,11,0.45454545454545453,11,28,0.39285714285714285,2,2,1.0,4,19,23,6,4,2,11,23,39,2014_Jamaal Franklin
2014,Jeff Teague,PG,25,456,1040,0.43846153846153846,74,225,0.3288888888888889,382,815,0.4687116564417178,318,376,0.8457446808510638,34,174,208,528,89,17,232,158,1304,2014_Jeff Teague
2014,John Salmons,SF_SG_SG-SF,34,300,826,0.36319612590799033,126,326,0.38650306748466257,174,500,0.348,80,104,0.7692307692307693,40,286,326,294,94,38,108,248,806,2014_John Salmons
2014,Jrue Holiday,PG,23,203,454,0.44713656387665196,30,77,0.38961038961038963,173,377,0.4588859416445623,51,63,0.8095238095238095,28,114,142,268,56,12,105,92,487,2014_Jrue Holiday
2014,Luke Ridnour,PG,32,252,654,0.3853211009174312,74,216,0.3425925925925926,178,438,0.4063926940639269,34,52,0.6538461538461539,46,148,194,352,64,16,132,184,612,2014_Luke Ridnour
2014,Manu Ginobili,SG,36,294,627,0.4688995215311005,90,258,0.3488372093023256,204,369,0.5528455284552846,160,188,0.851063829787234,30,172,202,293,70,17,139,128,838,2014_Manu Ginobili
2014,Robin Lopez,C,25,355,644,0.5512422360248447,0,1,0.0,355,643,0.552099533437014,198,242,0.8181818181818182,326,374,700,73,25,139,84,196,908,2014_Robin Lopez
2014,Shawne Williams,PF,27,73,192,0.3802083333333333,42,129,0.32558139534883723,31,63,0.49206349206349204,14,20,0.7,25,142,167,30,19,30,21,93,202,2014_Shawne Williams
2014,Stephen Curry,PG,25,652,1383,0.47143890093998553,261,615,0.424390243902439,391,768,0.5091145833333334,308,348,0.8850574712643678,46,288,334,666,128,14,294,194,1873,2014_Stephen Curry
2014,Steve Nash,PG,39,36,94,0.3829787234042553,8,24,0.3333333333333333,28,70,0.4,22,24,0.9166666666666666,4,25,29,86,7,2,31,18,102,2014_Steve Nash
2014,Taj Gibson,PF,28,429,896,0.47879464285714285,0,7,0.0,429,889,0.48256467941507314,211,281,0.7508896797153025,200,358,558,91,41,112,150,207,1069,2014_Taj Gibson
2015,Ben Gordon,SG,31,129,295,0.43728813559322033,35,97,0.36082474226804123,94,198,0.47474747474747475,56,67,0.835820895522388,6,57,63,50,14,1,55,60,349,2015_Ben Gordon
2015,Chuck Hayes,C,31,22,46,0.4782608695652174,0,0,NaN,22,46,0.4782608695652174,6,11,0.5454545454545454,18,33,51,20,10,4,8,37,50,2015_Chuck Hayes
2015,Danilo Gallinari,SF,26,228,568,0.4014084507042254,107,301,0.3554817275747508,121,267,0.45318352059925093,171,191,0.8952879581151832,31,187,218,83,47,20,57,94,734,2015_Danilo Gallinari
2015,Earl Barron,C,33,12,39,0.3076923076923077,2,4,0.5,10,35,0.2857142857142857,6,12,0.5,14,14,28,5,4,2,5,26,32,2015_Earl Barron
2015,Ekpe Udoh,PF,27,11,24,0.4583333333333333,0,0,NaN,11,24,0.4583333333333333,7,9,0.7777777777777778,7,19,26,8,8,7,7,20,29,2015_Ekpe Udoh
2015,Elijah Millsap,SG,27,81,238,0.3403361344537815,28,90,0.3111111111111111,53,148,0.3581081081081081,58,86,0.6744186046511628,28,122,150,58,56,16,67,124,248,2015_Elijah Millsap
2015,Evan Turner,SG,26,320,746,0.4289544235924933,33,119,0.2773109243697479,287,627,0.45773524720893144,106,141,0.75177304964539,40,377,417,449,83,19,198,180,779,2015_Evan Turner
2015,Gal Mekel,PG,26,3,20,0.15,0,3,0.0,3,17,0.17647058823529413,0,0,NaN,0,1,1,13,2,0,2,1,6,2015_Gal Mekel
2015,Isaiah Thomas,PG,25,670,1594,0.4203262233375157,258,692,0.37283236994219654,412,902,0.4567627494456763,604,696,0.867816091954023,66,240,306,568,114,10,286,300,2202,2015_Isaiah Thomas
2015,Jamaal Franklin,SG,23,1,2,0.5,1,2,0.5,0,0,NaN,0,0,NaN,1,1,2,3,0,1,3,4,3,2015_Jamaal Franklin
2015,Jeff Teague,PG,26,408,887,0.4599774520856821,71,207,0.34299516908212563,337,680,0.49558823529411766,275,319,0.8620689655172413,30,154,184,513,125,31,205,139,1162,2015_Jeff Teague
2015,Josh McRoberts,PF,27,28,53,0.5283018867924528,8,19,0.42105263157894735,20,34,0.5882352941176471,8,13,0.6153846153846154,7,38,45,33,12,3,22,41,72,2015_Josh McRoberts
2015,Kyle Anderson,SF,21,31,89,0.34831460674157305,3,11,0.2727272727272727,28,78,0.358974358974359,9,14,0.6428571428571429,5,67,72,28,15,7,10,28,74,2015_Kyle Anderson
2015,Lance Stephenson,SG,24,207,550,0.37636363636363634,18,105,0.17142857142857143,189,445,0.4247191011235955,69,110,0.6272727272727273,39,238,277,240,38,8,128,134,501,2015_Lance Stephenson
2015,Manu Ginobili,SG,37,251,589,0.42614601018675724,89,258,0.3449612403100775,162,331,0.48942598187311176,147,204,0.7205882352941176,28,183,211,293,67,20,154,138,738,2015_Manu Ginobili
2015,Nik Stauskas,SG,21,108,296,0.36486486486486486,48,149,0.3221476510067114,60,147,0.40816326530612246,55,64,0.859375,11,77,88,67,20,17,40,92,319,2015_Nik Stauskas
2015,Robin Lopez,C,26,234,437,0.5354691075514875,0,1,0.0,234,436,0.536697247706422,98,127,0.7716535433070866,190,204,394,55,16,84,73,122,566,2015_Robin Lopez
2015,Shane Larkin,PG,22,187,432,0.43287037037037035,35,116,0.3017241379310345,152,316,0.4810126582278481,61,78,0.782051282051282,29,147,176,226,93,9,83,150,470,2015_Shane Larkin
2015,Shawne Williams,SF,28,242,600,0.4033333333333333,128,356,0.3595505617977528,114,244,0.4672131147540984,70,80,0.875,72,260,332,88,50,42,60,270,682,2015_Shawne Williams
2015,Stephen Curry,PG,26,653,1341,0.48695003728560776,286,646,0.44272445820433437,367,695,0.5280575539568345,308,337,0.913946587537092,56,285,341,619,163,16,249,158,1900,2015_Stephen Curry
2015,Tony Allen,SG,33,225,455,0.4945054945054945,10,29,0.3448275862068966,215,426,0.5046948356807511,79,126,0.626984126984127,103,177,280,86,129,30,86,166,539,2015_Tony Allen
2016,Chuck Hayes,C,32,1,2,0.5,0,0,NaN,1,2,0.5,2,2,1.0,0,8,8,2,0,0,3,6,4,2016_Chuck Hayes
2016,Duje Dukan,SF,24,2,10,0.2,2,5,0.4,0,5,0.0,0,0,NaN,2,2,4,1,1,0,0,2,6,2016_Duje Dukan
2016,Evan Turner,SG,27,343,753,0.4555112881806109,20,83,0.24096385542168675,323,670,0.48208955223880595,148,179,0.8268156424581006,50,347,397,359,80,28,169,139,854,2016_Evan Turner
2016,Gerald Henderson,SG,28,232,529,0.43856332703213613,48,136,0.35294117647058826,184,393,0.4681933842239186,112,146,0.7671232876712328,30,181,211,75,39,19,68,87,624,2016_Gerald Henderson
2016,Isaiah Thomas,PG,26,591,1382,0.4276410998552822,167,465,0.35913978494623655,424,917,0.4623773173391494,474,544,0.8713235294117647,46,197,243,509,91,9,220,167,1823,2016_Isaiah Thomas
2016,J.J. O'Brien,SF,23,0,1,0.0,0,0,NaN,0,1,0.0,0,0,NaN,0,1,1,0,1,0,0,1,0,2016_J.J. O'Brien
2016,Jeff Teague,PG,27,434,988,0.4392712550607287,110,275,0.4,324,713,0.4544179523141655,261,312,0.8365384615384616,33,181,214,470,97,24,218,167,1239,2016_Jeff Teague
2016,Kendrick Perkins,C,31,40,75,0.5333333333333333,0,0,NaN,40,75,0.5333333333333333,11,25,0.44,25,103,128,31,11,11,41,64,91,2016_Kendrick Perkins
2016,Kris Humphries,PF,30,242,590,0.4101694915254237,68,216,0.3148148148148148,174,374,0.46524064171123,134,168,0.7976190476190477,114,322,436,72,32,46,76,188,686,2016_Kris Humphries
2016,Kyle Anderson,SF,22,138,295,0.46779661016949153,12,37,0.32432432432432434,126,258,0.4883720930232558,62,83,0.7469879518072289,25,219,244,123,60,29,59,97,350,2016_Kyle Anderson
2016,Kyle O'Quinn,PF,25,129,271,0.47601476014760147,5,22,0.22727272727272727,124,249,0.4979919678714859,46,60,0.7666666666666667,76,174,250,72,20,49,61,107,309,2016_Kyle O'Quinn
2016,Manu Ginobili,SG,38,197,435,0.4528735632183908,70,179,0.39106145251396646,127,256,0.49609375,91,112,0.8125,26,120,146,177,66,11,99,99,555,2016_Manu Ginobili
2016,Maurice Harkless,SF,22,195,411,0.4744525547445255,39,140,0.2785714285714286,156,271,0.5756457564575646,69,111,0.6216216216216216,101,179,280,67,49,35,62,124,498,2016_Maurice Harkless
2016,Michael Kidd-Gilchrist,SF,22,33,61,0.5409836065573771,3,7,0.42857142857142855,30,54,0.5555555555555556,20,29,0.6896551724137931,12,33,45,9,3,3,8,9,89,2016_Michael Kidd-Gilchrist
2016,Paul Millsap,PF,30,501,1066,0.4699812382739212,74,232,0.31896551724137934,427,834,0.511990407673861,309,408,0.7573529411764706,198,534,732,265,147,139,191,237,1385,2016_Paul Millsap
2016,Rakeem Christmas,PF,24,2,2,1.0,0,0,NaN,2,2,1.0,0,0,NaN,1,0,1,0,0,0,0,1,4,2016_Rakeem Christmas
2016,Reggie Bullock,SF,24,43,98,0.4387755102040816,22,53,0.41509433962264153,21,45,0.4666666666666667,14,15,0.9333333333333333,14,54,68,27,10,2,8,29,122,2016_Reggie Bullock
2016,Robin Lopez,C,27,357,662,0.5392749244712991,0,1,0.0,357,661,0.540090771558245,128,161,0.7950310559006211,268,334,602,114,16,129,133,182,842,2016_Robin Lopez
2016,Ryan Kelly,PF,24,55,149,0.3691275167785235,5,37,0.13513513513513514,50,112,0.44642857142857145,37,54,0.6851851851851852,21,100,121,20,13,10,18,39,152,2016_Ryan Kelly
2016,Salah Mejri,C,29,49,78,0.6282051282051282,0,1,0.0,49,77,0.6363636363636364,27,46,0.5869565217391305,41,82,123,10,8,36,23,54,125,2016_Salah Mejri
2016,Sasha Vujacic,SG,31,106,277,0.38267148014440433,52,143,0.36363636363636365,54,134,0.40298507462686567,32,39,0.8205128205128205,26,123,149,84,34,5,44,83,296,2016_Sasha Vujacic
2016,Stephen Curry,PG,27,805,1598,0.5037546933667084,402,886,0.45372460496614,403,712,0.5660112359550562,363,400,0.9075,68,362,430,527,169,15,262,161,2375,2016_Stephen Curry
2016,Terrence Jones,PF,24,166,367,0.45231607629427795,25,79,0.31645569620253167,141,288,0.4895833333333333,77,116,0.6637931034482759,62,149,211,41,23,39,49,86,434,2016_Terrence Jones
2017,Alex Len,C,23,230,463,0.49676025917926564,3,12,0.25,227,451,0.5033259423503326,150,208,0.7211538461538461,156,354,510,44,37,98,102,242,613,2017_Alex Len
2017,Boban Marjanovic,C,28,72,132,0.5454545454545454,0,0,NaN,72,132,0.5454545454545454,47,58,0.8103448275862069,46,84,130,9,6,12,10,25,191,2017_Boban Marjanovic
2017,Dion Waiters,SG,25,281,663,0.4238310708898944,85,215,0.3953488372093023,196,448,0.4375,82,127,0.6456692913385826,18,136,154,200,41,20,103,95,729,2017_Dion Waiters
2017,Evan Turner,SF,28,235,552,0.4257246376811594,31,118,0.2627118644067797,204,434,0.4700460829493088,85,103,0.8252427184466019,36,211,247,205,53,24,100,121,586,2017_Evan Turner
2017,Frank Kaminsky,C,23,320,802,0.39900249376558605,116,354,0.327683615819209,204,448,0.45535714285714285,118,156,0.7564102564102564,57,279,336,162,47,34,76,139,874,2017_Frank Kaminsky
2017,Isaiah Thomas,PG,27,682,1473,0.46300067888662594,245,646,0.37925696594427244,437,827,0.528415961305925,590,649,0.9090909090909091,43,162,205,449,70,13,210,167,2199,2017_Isaiah Thomas
2017,JaMychal Green,PF,26,250,500,0.5,55,145,0.3793103448275862,195,355,0.5492957746478874,134,167,0.8023952095808383,167,377,544,84,46,34,94,248,689,2017_JaMychal Green
2017,Jeff Teague,PG,28,402,909,0.44224422442244227,90,252,0.35714285714285715,312,657,0.4748858447488584,360,415,0.8674698795180723,33,298,331,639,100,32,216,165,1254,2017_Jeff Teague
2017,Jordan Farmar,PG,30,4,12,0.3333333333333333,4,9,0.4444444444444444,0,3,0.0,0,0,NaN,1,2,3,9,2,0,3,1,12,2017_Jordan Farmar
2017,Kyle Anderson,SG,23,93,209,0.4449760765550239,15,40,0.375,78,169,0.46153846153846156,45,57,0.7894736842105263,33,175,208,91,51,26,39,63,246,2017_Kyle Anderson
2017,Manu Ginobili,SG,39,171,439,0.3895216400911162,89,227,0.3920704845814978,82,212,0.3867924528301887,86,107,0.8037383177570093,28,129,157,183,82,16,96,119,517,2017_Manu Ginobili
2017,Patrick McCaw,SG,21,106,245,0.4326530612244898,41,123,0.3333333333333333,65,122,0.5327868852459017,29,37,0.7837837837837838,22,79,101,77,32,15,36,62,282,2017_Patrick McCaw
2017,Quincy Acy,PF,26,140,340,0.4117647058823529,74,180,0.4111111111111111,66,160,0.4125,90,120,0.75,40,190,230,36,28,30,42,134,444,2017_Quincy Acy
2017,Robin Lopez,C,28,382,775,0.49290322580645163,0,2,0.0,382,773,0.49417852522639066,75,104,0.7211538461538461,243,276,519,80,18,117,90,151,839,2017_Robin Lopez
2017,Sasha Vujacic,SG,32,42,136,0.3088235294117647,23,74,0.3108108108108108,19,62,0.3064516129032258,17,24,0.7083333333333334,12,47,59,52,13,2,16,38,124,2017_Sasha Vujacic
2017,Stephen Curry,PG,28,675,1443,0.4677754677754678,324,789,0.41064638783269963,351,654,0.536697247706422,325,362,0.8977900552486188,61,292,353,523,143,17,239,183,1999,2017_Stephen Curry
2017,Wade Baldwin,PG,20,36,115,0.3130434782608696,3,22,0.13636363636363635,33,93,0.3548387096774194,31,37,0.8378378378378378,11,35,46,61,18,7,40,40,106,2017_Wade Baldwin
2003,Anthony Goldwire,PG,31,18,50,0.36,6,18,0.3333333333333333,12,32,0.375,8,14,0.5714285714285714,0,12,12,8,6,0,12,12,50,2003_Anthony Goldwire
2003,Dan Dickau,PG,24,70,170,0.4117647058823529,22,61,0.36065573770491804,48,109,0.44036697247706424,21,26,0.8076923076923077,9,34,43,85,14,2,53,66,183,2003_Dan Dickau
2003,James Posey,SF,26,618,1504,0.4109042553191489,140,458,0.3056768558951965,478,1046,0.4569789674952199,410,492,0.8333333333333334,180,672,852,368,212,30,288,394,1786,2003_James Posey
2003,Joe Johnson,SG,21,316,796,0.3969849246231156,75,205,0.36585365853658536,241,591,0.4077834179357022,96,124,0.7741935483870968,57,207,264,210,62,19,108,143,803,2003_Joe Johnson
2003,Mikki Moore,C,27,10,26,0.38461538461538464,0,0,NaN,10,26,0.38461538461538464,16,20,0.8,12,4,16,6,0,8,4,14,36,2003_Mikki Moore
2003,Rick Fox,SF,33,262,621,0.4219001610305958,105,280,0.375,157,341,0.4604105571847507,52,69,0.7536231884057971,64,259,323,253,69,14,121,215,681,2003_Rick Fox
2003,Yao Ming,C,22,401,805,0.49813664596273294,1,2,0.5,400,803,0.49813200498132004,301,371,0.8113207547169812,196,479,675,137,31,147,173,230,1104,2003_Yao Ming
2004,Anthony Peeler,SG,34,156,348,0.4482758620689655,68,141,0.48226950354609927,88,207,0.4251207729468599,51,61,0.8360655737704918,31,122,153,120,56,10,77,103,431,2004_Anthony Peeler
2004,Britton Johnsen,C,24,17,59,0.288135593220339,1,12,0.08333333333333333,16,47,0.3404255319148936,7,16,0.4375,15,30,45,12,7,1,14,28,42,2004_Britton Johnsen
2004,Corliss Williamson,PF,30,304,602,0.5049833887043189,0,0,NaN,304,602,0.5049833887043189,144,197,0.7309644670050761,88,168,256,57,30,20,113,204,752,2004_Corliss Williamson
2004,Horace Grant,PF,38,92,224,0.4107142857142857,0,1,0.0,92,223,0.4125560538116592,39,54,0.7222222222222222,79,154,233,71,24,21,29,70,223,2004_Horace Grant
2004,James Posey,SG,27,368,770,0.4779220779220779,112,290,0.38620689655172413,256,480,0.5333333333333333,278,335,0.8298507462686567,92,311,403,122,137,40,112,248,1126,2004_James Posey
2004,Jamison Brewer,PG,23,13,35,0.37142857142857144,5,14,0.35714285714285715,8,21,0.38095238095238093,1,6,0.16666666666666666,2,9,11,17,7,0,10,9,32,2004_Jamison Brewer
2004,Jason Williams,PG,28,290,713,0.4067321178120617,120,364,0.32967032967032966,170,349,0.4871060171919771,82,98,0.8367346938775511,25,122,147,492,92,5,136,97,782,2004_Jason Williams
2004,Joe Johnson,SG,22,555,1291,0.42989930286599537,83,272,0.30514705882352944,472,1019,0.4631992149165849,174,232,0.75,80,305,385,362,93,26,199,177,1367,2004_Joe Johnson
2004,Kendall Gill,SG,35,215,548,0.39233576642335766,9,38,0.23684210526315788,206,510,0.403921568627451,100,136,0.7352941176470589,61,129,190,89,65,16,83,107,539,2004_Kendall Gill
2004,Kenny Anderson,PG,33,113,256,0.44140625,1,4,0.25,112,252,0.4444444444444444,35,48,0.7291666666666666,19,62,81,125,26,5,50,73,262,2004_Kenny Anderson
2004,Lonny Baxter,C_PF_C-PF,25,206,418,0.49282296650717705,2,6,0.3333333333333333,204,412,0.49514563106796117,88,152,0.5789473684210527,128,246,374,40,34,58,76,246,502,2004_Lonny Baxter
2004,Mikki Moore,C_PF_PF-C,28,100,198,0.5050505050505051,0,0,NaN,100,198,0.5050505050505051,60,70,0.8571428571428571,58,110,168,38,14,26,44,130,260,2004_Mikki Moore
2004,Randy Livingston,PG,28,2,10,0.2,0,3,0.0,2,7,0.2857142857142857,4,6,0.6666666666666666,2,5,7,4,2,0,4,7,8,2004_Randy Livingston
2004,Scott Williams,C,35,180,372,0.4838709677419355,4,6,0.6666666666666666,176,366,0.4808743169398907,32,54,0.5925925925925926,76,188,264,34,40,32,32,190,396,2004_Scott Williams
2004,Travis Hansen,SF,25,46,130,0.35384615384615387,9,30,0.3,37,100,0.37,22,27,0.8148148148148148,30,40,70,19,10,9,15,67,123,2004_Travis Hansen
2005,Anthony Miller,PF,33,2,3,0.6666666666666666,0,0,NaN,2,3,0.6666666666666666,0,0,NaN,0,1,1,1,1,0,1,2,4,2005_Anthony Miller
2005,Britton Johnsen,SF,25,6,22,0.2727272727272727,0,4,0.0,6,18,0.3333333333333333,0,0,NaN,5,5,10,4,1,0,3,10,12,2005_Britton Johnsen
2005,Christian Laettner,PF,35,107,184,0.5815217391304348,1,7,0.14285714285714285,106,177,0.5988700564971752,45,59,0.7627118644067796,36,95,131,41,32,15,29,78,260,2005_Christian Laettner
2005,James Posey,SF,28,127,356,0.35674157303370785,55,178,0.3089887640449438,72,178,0.4044943820224719,96,111,0.8648648648648649,45,174,219,88,48,23,69,134,405,2005_James Posey
2005,Joe Johnson,SF,23,544,1179,0.46140797285835455,177,370,0.4783783783783784,367,809,0.453646477132262,135,180,0.75,120,302,422,291,79,24,148,167,1400,2005_Joe Johnson
2005,Michael Finley,SG,31,387,907,0.42668136714443217,116,285,0.4070175438596491,271,622,0.43569131832797425,113,136,0.8308823529411765,45,217,262,169,48,18,60,123,1003,2005_Michael Finley
2005,Mikki Moore,PF,29,144,287,0.5017421602787456,1,5,0.2,143,282,0.5070921985815603,107,136,0.7867647058823529,97,149,246,47,19,32,63,173,396,2005_Mikki Moore
2005,Nene Hilario,C,22,194,386,0.5025906735751295,0,2,0.0,194,384,0.5052083333333334,140,212,0.660377358490566,104,221,325,84,50,48,94,167,528,2005_Nene Hilario
2005,Willie Green,SG,23,155,423,0.3664302600472813,30,105,0.2857142857142857,125,318,0.39308176100628933,97,125,0.776,22,111,133,100,34,6,75,121,437,2005_Willie Green
2006,Allen Iverson,PG,30,815,1822,0.4473106476399561,72,223,0.32286995515695066,743,1599,0.4646654158849281,675,829,0.8142340168878166,44,188,232,532,140,10,248,121,2377,2006_Allen Iverson
2006,Bernard Robinson,SF,25,157,365,0.4301369863013699,2,21,0.09523809523809523,155,344,0.45058139534883723,106,134,0.7910447761194029,62,157,219,77,81,10,74,141,422,2006_Bernard Robinson
2006,Dan Gadzuric,C,27,171,309,0.5533980582524272,0,1,0.0,171,308,0.5551948051948052,41,89,0.4606741573033708,91,141,232,24,25,43,35,171,383,2006_Dan Gadzuric
2006,Gordan Giricek,SG,28,166,383,0.43342036553524804,18,59,0.3050847457627119,148,324,0.4567901234567901,43,57,0.7543859649122807,15,55,70,63,16,4,63,87,393,2006_Gordan Giricek
2006,Jalen Rose,SF_SG_SF-SG,33,580,1370,0.4233576642335766,118,344,0.3430232558139535,462,1026,0.4502923976608187,496,636,0.779874213836478,56,366,422,362,60,26,230,312,1774,2006_Jalen Rose
2006,James Posey,SF,29,159,395,0.40253164556962023,117,290,0.40344827586206894,42,105,0.4,48,61,0.7868852459016393,33,286,319,89,54,20,58,196,483,2006_James Posey
2006,Jarrett Jack,SG,22,189,428,0.441588785046729,20,76,0.2631578947368421,169,352,0.48011363636363635,128,160,0.8,18,142,160,219,41,2,102,138,526,2006_Jarrett Jack
2006,Jarvis Hayes,SG,24,77,183,0.4207650273224044,17,47,0.3617021276595745,60,136,0.4411764705882353,25,30,0.8333333333333334,19,57,76,27,16,1,22,38,196,2006_Jarvis Hayes
2006,Joe Johnson,SG,24,632,1395,0.45304659498207883,128,360,0.35555555555555557,504,1035,0.48695652173913045,261,330,0.7909090909090909,98,237,335,536,103,31,267,187,1653,2006_Joe Johnson
2006,Nate Robinson,PG,21,230,565,0.40707964601769914,58,146,0.3972602739726027,172,419,0.4105011933174224,152,202,0.7524752475247525,56,111,167,147,59,1,114,201,670,2006_Nate Robinson
2006,Quinton Ross,SG,24,130,308,0.42207792207792205,0,7,0.0,130,301,0.4318936877076412,57,75,0.76,38,132,170,79,51,16,47,155,317,2006_Quinton Ross
2006,Sebastian Telfair,PG,20,228,578,0.3944636678200692,57,162,0.35185185185185186,171,416,0.4110576923076923,130,175,0.7428571428571429,19,101,120,247,66,6,115,167,643,2006_Sebastian Telfair
2007,Allen Iverson,SG-PG_SG_PG,31,1162,2626,0.4424980959634425,124,394,0.3147208121827411,1038,2232,0.4650537634408602,970,1220,0.7950819672131147,46,340,386,936,246,26,536,190,3418,2007_Allen Iverson
2007,Chris Paul,PG,21,381,871,0.43742824339839265,50,143,0.34965034965034963,331,728,0.45467032967032966,292,357,0.8179271708683473,54,226,280,569,118,3,161,154,1104,2007_Chris Paul
2007,Jake Voskuhl,C,29,121,255,0.4745098039215686,0,0,NaN,121,255,0.4745098039215686,77,113,0.6814159292035398,84,172,256,44,30,24,56,199,319,2007_Jake Voskuhl
2007,Jarron Collins,C,28,75,170,0.4411764705882353,0,0,NaN,75,170,0.4411764705882353,54,83,0.6506024096385542,71,100,171,60,13,8,37,147,204,2007_Jarron Collins
2007,Joe Johnson,SG,25,536,1139,0.47058823529411764,119,312,0.3814102564102564,417,827,0.5042321644498187,235,314,0.7484076433121019,53,186,239,249,60,11,176,115,1426,2007_Joe Johnson
2007,Larry Hughes,SG,28,381,953,0.39979013641133265,74,222,0.3333333333333333,307,731,0.41997264021887826,209,309,0.6763754045307443,41,226,267,256,89,26,154,164,1045,2007_Larry Hughes
2007,Nate Robinson,PG,22,227,523,0.4340344168260038,83,213,0.38967136150234744,144,310,0.4645161290322581,108,139,0.7769784172661871,55,97,152,90,50,6,72,160,645,2007_Nate Robinson
2007,Sarunas Jasikevicius,SG-PG_SG_PG,30,256,644,0.39751552795031053,88,260,0.3384615384615385,168,384,0.4375,172,190,0.9052631578947369,30,108,138,344,52,2,180,150,772,2007_Sarunas Jasikevicius
2007,Sebastian Telfair,PG,21,176,474,0.37130801687763715,37,128,0.2890625,139,346,0.40173410404624277,90,110,0.8181818181818182,17,91,108,218,43,11,98,166,479,2007_Sebastian Telfair
2007,Solomon Jones,PF,22,65,128,0.5078125,0,1,0.0,65,127,0.5118110236220472,59,75,0.7866666666666666,49,87,136,11,11,42,25,124,189,2007_Solomon Jones
2007,Trevor Ariza,SG,21,200,371,0.5390835579514824,0,7,0.0,200,364,0.5494505494505495,106,171,0.6198830409356725,98,151,249,65,59,19,84,134,506,2007_Trevor Ariza
2007,Uros Slokar,C,23,14,26,0.5384615384615384,1,2,0.5,13,24,0.5416666666666666,9,13,0.6923076923076923,7,7,14,1,1,2,9,11,38,2007_Uros Slokar
2008,Allen Iverson,SG,32,712,1556,0.45758354755784064,95,275,0.34545454545454546,617,1281,0.4816549570647931,645,797,0.8092848180677541,47,196,243,586,160,12,245,109,2164,2008_Allen Iverson
2008,Billy Thomas,SF,32,8,34,0.23529411764705882,8,32,0.25,0,2,0.0,4,4,1.0,0,4,4,0,2,0,8,8,28,2008_Billy Thomas
2008,Brandan Wright,PF,20,62,112,0.5535714285714286,0,0,NaN,62,112,0.5535714285714286,27,40,0.675,38,61,99,9,6,22,13,36,151,2008_Brandan Wright
2008,Courtney Sims,C,24,0,1,0.0,0,0,NaN,0,1,0.0,0,0,NaN,1,1,2,1,0,0,0,2,0,2008_Courtney Sims
2008,Jared Dudley,PF,22,163,348,0.46839080459770116,9,41,0.21951219512195122,154,307,0.501628664495114,87,118,0.7372881355932204,121,165,286,81,55,10,50,128,422,2008_Jared Dudley
2008,Joe Johnson,SG,26,647,1497,0.43219772879091517,169,444,0.38063063063063063,478,1053,0.4539411206077873,316,379,0.8337730870712401,83,284,367,474,84,18,223,168,1779,2008_Joe Johnson
2008,Kasib Powell,SF,26,35,95,0.3684210526315789,8,33,0.24242424242424243,27,62,0.43548387096774194,6,9,0.6666666666666666,8,36,44,18,9,2,5,18,84,2008_Kasib Powell
2008,Nate Robinson,PG,23,331,782,0.42327365728900257,97,292,0.3321917808219178,234,490,0.4775510204081633,154,196,0.7857142857142857,51,171,222,212,60,1,103,186,913,2008_Nate Robinson
2008,P.J. Brown,PF,38,14,41,0.34146341463414637,0,1,0.0,14,40,0.35,11,16,0.6875,29,39,68,10,5,8,10,29,39,2008_P.J. Brown
2008,Paul Pierce,SF,30,509,1098,0.46357012750455373,143,365,0.3917808219178082,366,733,0.49931787175989084,409,485,0.843298969072165,53,358,411,363,101,36,221,200,1570,2008_Paul Pierce
2008,Sebastian Telfair,PG,22,223,556,0.4010791366906475,32,114,0.2807017543859649,191,442,0.4321266968325792,78,105,0.7428571428571429,16,119,135,355,59,11,111,171,556,2008_Sebastian Telfair
2008,Solomon Jones,PF,23,12,30,0.4,0,2,0.0,12,28,0.42857142857142855,11,20,0.55,19,23,42,0,3,5,11,28,35,2008_Solomon Jones
2008,Thomas Gardner,SG,22,9,23,0.391304347826087,3,12,0.25,6,11,0.5454545454545454,0,2,0.0,3,1,4,1,0,0,4,4,21,2008_Thomas Gardner
2009,Allen Iverson,PG-SG_SG_PG,33,696,1668,0.4172661870503597,56,198,0.2828282828282828,640,1470,0.43537414965986393,542,694,0.7809798270893372,60,286,346,566,176,12,292,172,1990,2009_Allen Iverson
2009,Anthony Carter,PG,33,167,386,0.4326424870466321,21,88,0.23863636363636365,146,298,0.4899328859060403,57,78,0.7307692307692307,40,165,205,364,96,13,155,142,412,2009_Anthony Carter
2009,Chauncey Billups,PG,32,820,1960,0.41836734693877553,324,794,0.4080604534005038,496,1166,0.42538593481989706,836,916,0.9126637554585153,64,414,478,1012,186,36,354,322,2800,2009_Chauncey Billups
2009,Courtney Sims,C,25,6,12,0.5,0,0,NaN,6,12,0.5,0,0,NaN,4,4,8,0,0,0,2,2,12,2009_Courtney Sims
2009,George Hill,PG,22,150,372,0.4032258064516129,24,73,0.3287671232876712,126,299,0.4214046822742475,114,146,0.7808219178082192,30,128,158,136,45,21,74,150,438,2009_George Hill
2009,Jerome James,C,33,3,8,0.375,0,0,NaN,3,8,0.375,0,0,NaN,1,2,3,0,1,1,1,2,6,2009_Jerome James
2009,Joe Johnson,SG,27,620,1420,0.43661971830985913,149,414,0.35990338164251207,471,1006,0.46819085487077533,299,362,0.8259668508287292,65,281,346,455,84,19,195,176,1688,2009_Joe Johnson
2009,Malik Rose,SF-PF_SF_PF,34,90,262,0.3435114503816794,0,14,0.0,90,248,0.3629032258064516,80,102,0.7843137254901961,34,158,192,72,20,6,72,144,260,2009_Malik Rose
2009,Nate Robinson,PG,24,449,1028,0.4367704280155642,125,385,0.3246753246753247,324,643,0.5038880248833593,249,296,0.8412162162162162,98,192,290,301,95,6,139,206,1272,2009_Nate Robinson
2009,Patrick O'Bryant,C,22,90,168,0.5357142857142857,0,4,0.0,90,164,0.5487804878048781,22,40,0.55,26,106,132,22,12,38,44,122,202,2009_Patrick O'Bryant
2009,Paul Pierce,SF,31,540,1181,0.4572396274343776,119,304,0.39144736842105265,421,877,0.48004561003420754,459,553,0.8300180831826401,56,401,457,294,80,27,228,215,1658,2009_Paul Pierce
2009,Robert Swift,C,23,37,71,0.5211267605633803,0,0,NaN,37,71,0.5211267605633803,12,16,0.75,21,68,89,9,5,17,8,50,86,2009_Robert Swift
2009,Roy Hibbert,C,22,198,420,0.4714285714285714,0,0,NaN,198,420,0.4714285714285714,98,147,0.6666666666666666,115,128,243,49,20,76,55,215,494,2009_Roy Hibbert
2009,Samuel Dalembert,C,27,216,434,0.4976958525345622,0,2,0.0,216,432,0.5,91,124,0.7338709677419355,214,487,701,18,33,146,117,248,523,2009_Samuel Dalembert
2009,Sebastian Telfair,PG,23,267,697,0.3830703012912482,73,211,0.3459715639810427,194,486,0.3991769547325103,131,160,0.81875,32,95,127,343,73,12,146,184,738,2009_Sebastian Telfair
2009,Solomon Jones,C,24,67,111,0.6036036036036037,1,2,0.5,66,109,0.6055045871559633,53,74,0.7162162162162162,52,90,142,15,7,34,27,125,188,2009_Solomon Jones
2009,Steve Nash,PG,34,428,851,0.5029377203290247,108,246,0.43902439024390244,320,605,0.5289256198347108,196,210,0.9333333333333333,19,204,223,717,55,10,248,108,1160,2009_Steve Nash
2010,Antoine Wright,SF,25,162,399,0.40601503759398494,58,173,0.3352601156069364,104,226,0.46017699115044247,53,77,0.6883116883116883,38,152,190,71,30,11,58,134,435,2010_Antoine Wright
2010,Ben Gordon,SG,26,291,699,0.41630901287553645,75,234,0.32051282051282054,216,465,0.4645161290322581,198,230,0.8608695652173913,26,93,119,166,49,6,118,147,855,2010_Ben Gordon
2010,James Posey,SF,33,126,345,0.3652173913043478,81,242,0.3347107438016529,45,103,0.4368932038834951,66,80,0.825,32,297,329,117,42,19,51,204,399,2010_James Posey
2010,Jon Brockman,PF,22,55,103,0.5339805825242718,0,0,NaN,55,103,0.5339805825242718,37,62,0.5967741935483871,105,108,213,22,15,5,23,115,147,2010_Jon Brockman
2010,Mike Bibby,PG,31,268,644,0.4161490683229814,126,324,0.3888888888888889,142,320,0.44375,68,79,0.8607594936708861,20,164,184,310,67,3,90,157,730,2010_Mike Bibby
2010,Mike Miller,SG,29,217,433,0.5011547344110855,82,171,0.47953216374269003,135,262,0.5152671755725191,70,85,0.8235294117647058,55,281,336,212,39,12,115,131,586,2010_Mike Miller
2010,Mikki Moore,C,34,54,90,0.6,0,0,NaN,54,90,0.6,7,11,0.6363636363636364,26,43,69,36,5,13,21,60,115,2010_Mikki Moore
2010,Rodney Stuckey,PG,23,449,1109,0.4048692515779982,18,79,0.22784810126582278,431,1030,0.4184466019417476,299,359,0.8328690807799443,67,214,281,348,101,12,163,205,1215,2010_Rodney Stuckey
2010,Roko Ukic,PG,25,14,30,0.4666666666666667,3,12,0.25,11,18,0.6111111111111112,9,11,0.8181818181818182,0,3,3,12,1,0,6,6,40,2010_Roko Ukic
2010,Shaquille O'Neal,C,37,262,463,0.5658747300215983,0,1,0.0,262,462,0.5670995670995671,112,226,0.49557522123893805,93,262,355,80,15,62,105,169,636,2010_Shaquille O'Neal
2010,Tony Allen,SG,28,129,253,0.5098814229249012,0,5,0.0,129,248,0.5201612903225806,72,119,0.6050420168067226,52,93,145,72,59,19,66,109,330,2010_Tony Allen
2010,Tony Parker,PG,27,349,716,0.48743016759776536,10,34,0.29411764705882354,339,682,0.4970674486803519,186,246,0.7560975609756098,7,128,135,317,29,8,149,96,894,2010_Tony Parker
2011,Derek Fisher,PG,36,206,529,0.389413988657845,63,159,0.39622641509433965,143,370,0.3864864864864865,83,103,0.8058252427184466,14,138,152,224,99,8,70,192,558,2011_Derek Fisher
2011,Dexter Pittman,C,22,1,3,0.3333333333333333,0,0,NaN,1,3,0.3333333333333333,0,0,NaN,1,2,3,0,0,0,2,2,2,2011_Dexter Pittman
2011,Emeka Okafor,C,28,300,524,0.5725190839694656,0,1,0.0,300,523,0.5736137667304015,145,258,0.562015503875969,230,454,684,42,40,127,119,230,745,2011_Emeka Okafor
2011,JaVale McGee,C,23,332,604,0.5496688741721855,0,3,0.0,332,601,0.5524126455906821,134,230,0.5826086956521739,223,411,634,38,41,193,102,232,798,2011_JaVale McGee
2011,James Anderson,SF,21,31,81,0.38271604938271603,18,46,0.391304347826087,13,35,0.37142857142857144,14,18,0.7777777777777778,2,21,23,18,3,6,13,24,94,2011_James Anderson
2011,James Posey,SF,34,81,241,0.3360995850622407,67,212,0.3160377358490566,14,29,0.4827586206896552,11,15,0.7333333333333333,10,137,147,34,24,6,24,103,240,2011_James Posey
2011,Jeremy Lin,PG,22,28,72,0.3888888888888889,1,5,0.2,27,67,0.40298507462686567,19,25,0.76,12,22,34,42,33,9,18,31,76,2011_Jeremy Lin
2011,Kendrick Perkins,C,26,134,260,0.5153846153846153,0,0,NaN,134,260,0.5153846153846153,80,144,0.5555555555555556,124,340,464,52,18,52,112,182,348,2011_Kendrick Perkins
2011,Kris Humphries,PF,25,307,583,0.5265866209262435,0,1,0.0,307,582,0.5274914089347079,127,191,0.6649214659685864,225,546,771,84,33,80,103,168,741,2011_Kris Humphries
2011,Paul Millsap,PF,25,525,988,0.5313765182186235,9,23,0.391304347826087,516,965,0.5347150259067357,256,338,0.757396449704142,164,415,579,187,103,69,145,272,1315,2011_Paul Millsap
2011,Tony Parker,PG,28,555,1069,0.5191768007483629,25,70,0.35714285714285715,530,999,0.5305305305305306,233,303,0.768976897689769,30,208,238,513,90,3,200,135,1368,2011_Tony Parker
2012,Enes Kanter,C,19,117,236,0.4957627118644068,0,1,0.0,117,235,0.4978723404255319,70,105,0.6666666666666666,107,171,278,8,18,23,54,87,304,2012_Enes Kanter
2012,Joe Johnson,SG,30,423,931,0.45435016111707843,125,322,0.38819875776397517,298,609,0.48932676518883417,158,186,0.8494623655913979,53,168,221,232,48,13,116,75,1129,2012_Joe Johnson
2012,Mikki Moore,C,36,9,20,0.45,0,0,NaN,9,20,0.45,6,7,0.8571428571428571,7,15,22,5,3,3,7,24,24,2012_Mikki Moore
2012,Tony Parker,PG,29,427,890,0.4797752808988764,14,61,0.22950819672131148,413,829,0.49819059107358266,227,284,0.7992957746478874,22,149,171,463,57,5,153,75,1095,2012_Tony Parker
2013,Al Horford,C,26,576,1060,0.5433962264150943,3,6,0.5,573,1054,0.5436432637571158,134,208,0.6442307692307693,195,562,757,240,78,78,147,163,1289,2013_Al Horford
2013,Antawn Jamison,PF,36,267,575,0.4643478260869565,84,233,0.3605150214592275,183,342,0.5350877192982456,94,136,0.6911764705882353,109,253,362,50,30,22,53,124,712,2013_Antawn Jamison
2013,Brandon Rush,SF,27,6,9,0.6666666666666666,0,2,0.0,6,7,0.8571428571428571,2,3,0.6666666666666666,0,1,1,2,0,0,3,5,14,2013_Brandon Rush
2013,Chris Wright,SG,23,1,2,0.5,0,0,NaN,1,2,0.5,0,0,NaN,0,0,0,0,0,0,1,0,2,2013_Chris Wright
2013,Harrison Barnes,SF,20,276,628,0.4394904458598726,52,145,0.3586206896551724,224,483,0.463768115942029,144,190,0.7578947368421053,53,280,333,98,52,14,101,140,748,2013_Harrison Barnes
2013,Jared Sullinger,PF,20,111,225,0.49333333333333335,1,5,0.2,110,220,0.5,47,63,0.746031746031746,92,172,264,35,22,22,29,154,270,2013_Jared Sullinger
2013,Joe Johnson,SG,31,445,1052,0.4230038022813688,148,395,0.37468354430379747,297,657,0.4520547945205479,132,161,0.8198757763975155,53,165,218,253,49,14,123,99,1170,2013_Joe Johnson
2013,Tiago Splitter,PF,28,315,563,0.5595026642984015,0,2,0.0,315,561,0.5614973262032086,208,285,0.7298245614035088,144,371,515,130,63,64,100,161,838,2013_Tiago Splitter
2013,Vince Carter,SF,36,372,855,0.43508771929824563,162,399,0.40601503759398494,210,456,0.4605263157894737,182,223,0.8161434977578476,58,276,334,194,74,44,106,226,1088,2013_Vince Carter
2014,Al Jefferson,C,29,700,1376,0.5087209302325582,3,15,0.2,697,1361,0.5121234386480529,191,277,0.6895306859205776,156,636,792,155,67,79,124,176,1594,2014_Al Jefferson
2014,Boris Diaw,PF,31,302,580,0.5206896551724138,45,112,0.4017857142857143,257,468,0.5491452991452992,68,92,0.7391304347826086,74,252,326,222,44,32,121,140,717,2014_Boris Diaw
2014,Chris Copeland,SF,29,55,117,0.4700854700854701,33,79,0.4177215189873418,22,38,0.5789473684210527,10,14,0.7142857142857143,7,25,32,18,3,7,14,38,153,2014_Chris Copeland
2014,Daniel Orton,C,23,21,47,0.44680851063829785,0,0,NaN,21,47,0.44680851063829785,23,30,0.7666666666666667,16,45,61,15,6,16,18,38,65,2014_Daniel Orton
2014,Harrison Barnes,SF,21,271,679,0.39911634756995584,66,190,0.3473684210526316,205,489,0.41922290388548056,130,181,0.7182320441988951,66,245,311,116,65,20,84,158,738,2014_Harrison Barnes
2014,J.J. Hickson,PF,25,332,654,0.5076452599388379,0,8,0.0,332,646,0.5139318885448917,150,290,0.5172413793103449,206,426,632,96,47,51,128,177,814,2014_J.J. Hickson
2014,James Harden,SG,24,549,1205,0.45560165975103734,177,483,0.36645962732919257,372,722,0.5152354570637119,576,665,0.8661654135338346,61,283,344,446,115,29,265,177,1851,2014_James Harden
2014,James Southerland,SF,23,10,30,0.3333333333333333,6,12,0.5,4,18,0.2222222222222222,2,4,0.5,0,16,16,0,2,4,2,6,28,2014_James Southerland
2014,Jared Sullinger,PF,21,384,899,0.4271412680756396,56,208,0.2692307692307692,328,691,0.47467438494934877,158,203,0.7783251231527094,241,360,601,118,35,49,119,251,982,2014_Jared Sullinger
2014,Jeremy Tyler,C,22,60,116,0.5172413793103449,0,0,NaN,60,116,0.5172413793103449,26,48,0.5416666666666666,38,71,109,8,6,20,26,70,146,2014_Jeremy Tyler
2014,Joe Johnson,SG,32,462,1018,0.4538310412573674,162,404,0.400990099009901,300,614,0.48859934853420195,159,195,0.8153846153846154,48,222,270,216,47,10,120,129,1245,2014_Joe Johnson
2014,Kevin Love,PF,25,650,1421,0.4574243490499648,190,505,0.37623762376237624,460,916,0.5021834061135371,520,633,0.8214849921011058,224,739,963,341,59,35,196,136,2010,2014_Kevin Love
2014,Kyle Singler,SF,25,269,602,0.446843853820598,94,246,0.3821138211382114,175,356,0.49157303370786515,152,184,0.8260869565217391,116,187,303,75,61,38,79,211,784,2014_Kyle Singler
2014,Nemanja Nedovic,SG,22,8,39,0.20512820512820512,3,18,0.16666666666666666,5,21,0.23809523809523808,7,8,0.875,3,12,15,13,0,1,13,13,26,2014_Nemanja Nedovic
2014,Timofey Mozgov,C,27,285,545,0.5229357798165137,4,24,0.16666666666666666,281,521,0.5393474088291746,196,260,0.7538461538461538,171,357,528,62,27,100,122,213,770,2014_Timofey Mozgov
2015,Alec Burks,SG,23,121,300,0.4033333333333333,26,68,0.38235294117647056,95,232,0.40948275862068967,106,129,0.8217054263565892,19,95,114,82,17,5,52,64,374,2015_Alec Burks
2015,Corey Brewer,SF,28,686,1610,0.4260869565217391,126,470,0.2680851063829787,560,1140,0.49122807017543857,336,452,0.7433628318584071,160,434,594,346,228,38,262,346,1834,2015_Corey Brewer
2015,Grant Jerrett,PF,21,14,52,0.2692307692307692,2,30,0.06666666666666667,12,22,0.5454545454545454,2,2,1.0,4,14,18,6,4,4,6,22,32,2015_Grant Jerrett
2015,Harrison Barnes,SF,22,316,656,0.4817073170731707,87,215,0.4046511627906977,229,441,0.5192743764172335,108,150,0.72,117,336,453,116,61,19,71,146,827,2015_Harrison Barnes
2015,JaKarr Sampson,SF,21,146,346,0.42196531791907516,31,127,0.2440944881889764,115,219,0.5251141552511416,63,94,0.6702127659574468,35,128,163,77,38,26,76,135,386,2015_JaKarr Sampson
2015,Jared Sullinger,PF,22,311,708,0.4392655367231638,52,184,0.2826086956521739,259,524,0.49427480916030536,96,129,0.7441860465116279,147,294,441,134,44,42,78,153,770,2015_Jared Sullinger
2015,Jeffery Taylor,SF,25,45,114,0.39473684210526316,11,36,0.3055555555555556,34,78,0.4358974358974359,26,41,0.6341463414634146,14,39,53,22,12,1,19,36,127,2015_Jeffery Taylor
2015,Joe Johnson,SG,33,446,1025,0.4351219512195122,121,337,0.3590504451038576,325,688,0.47238372093023256,141,176,0.8011363636363636,53,331,384,292,59,14,137,120,1154,2015_Joe Johnson
2015,Kenneth Faried,PF,25,373,736,0.5067934782608695,1,8,0.125,372,728,0.510989010989011,199,288,0.6909722222222222,242,426,668,89,62,57,118,211,946,2015_Kenneth Faried
2015,LeBron James,SF,30,624,1279,0.4878811571540266,120,339,0.35398230088495575,504,940,0.5361702127659574,375,528,0.7102272727272727,51,365,416,511,109,49,272,135,1743,2015_LeBron James
2015,Nate Robinson,PG,30,176,510,0.34509803921568627,62,224,0.2767857142857143,114,286,0.3986013986013986,62,92,0.6739130434782609,34,66,100,194,40,6,60,152,476,2015_Nate Robinson
2015,Tim Frazier,PG,24,42,122,0.3442622950819672,10,34,0.29411764705882354,32,88,0.36363636363636365,20,42,0.47619047619047616,12,44,56,120,16,0,50,52,114,2015_Tim Frazier
2015,Tony Snell,SF,23,159,371,0.42857142857142855,73,197,0.37055837563451777,86,174,0.4942528735632184,44,55,0.8,31,145,176,62,32,11,48,86,435,2015_Tony Snell
2015,Victor Oladipo,SG,22,473,1086,0.43554327808471455,84,248,0.3387096774193548,389,838,0.46420047732696895,262,320,0.81875,51,251,302,295,120,19,204,187,1292,2015_Victor Oladipo
2016,Goran Dragic,PG,29,417,875,0.4765714285714286,64,205,0.3121951219512195,353,670,0.5268656716417911,120,165,0.7272727272727273,54,223,277,419,71,17,185,188,1018,2016_Goran Dragic
2016,Harrison Barnes,SF,23,295,633,0.4660347551342812,82,214,0.38317757009345793,213,419,0.5083532219570406,102,134,0.7611940298507462,77,248,325,117,41,10,57,136,774,2016_Harrison Barnes
2016,Jared Sullinger,PF,23,351,806,0.43548387096774194,29,103,0.2815533980582524,322,703,0.45803698435277385,103,161,0.639751552795031,194,479,673,187,75,47,102,209,834,2016_Jared Sullinger
2016,Joe Johnson,SF,34,754,1718,0.43888242142025613,240,626,0.38338658146964855,514,1092,0.4706959706959707,236,284,0.8309859154929577,98,486,584,636,122,8,318,292,1984,2016_Joe Johnson
2016,Mike Scott,PF,27,176,376,0.46808510638297873,62,158,0.3924050632911392,114,218,0.5229357798165137,50,63,0.7936507936507936,53,153,206,78,25,17,42,102,464,2016_Mike Scott
2016,Nate Robinson,PG,31,0,1,0.0,0,1,0.0,0,0,NaN,0,0,NaN,0,0,0,4,1,0,0,5,0,2016_Nate Robinson
2016,Nene Hilario,PF,33,209,384,0.5442708333333334,0,3,0.0,209,381,0.5485564304461942,107,185,0.5783783783783784,52,207,259,97,54,26,76,156,525,2016_Nene Hilario
2016,Nerlens Noel,C,21,306,587,0.5212947189097104,1,2,0.5,305,585,0.5213675213675214,134,227,0.5903083700440529,154,388,542,122,118,100,158,192,747,2016_Nerlens Noel
2016,Phil Pressey,PG,24,60,156,0.38461538461538464,8,36,0.2222222222222222,52,120,0.43333333333333335,26,50,0.52,6,56,62,150,36,8,66,56,154,2016_Phil Pressey
2016,Rudy Gay,SF,29,466,1007,0.4627606752730884,74,215,0.34418604651162793,392,792,0.494949494949495,198,254,0.7795275590551181,103,353,456,120,100,51,139,184,1204,2016_Rudy Gay
2016,Sam Dekker,SF,21,0,0,NaN,0,0,NaN,0,0,NaN,0,0,NaN,0,1,1,0,1,0,0,0,0,2016_Sam Dekker
2016,Tim Frazier,PG,25,192,458,0.4192139737991266,32,96,0.3333333333333333,160,362,0.4419889502762431,106,148,0.7162162162162162,52,168,220,324,66,4,130,146,522,2016_Tim Frazier
2017,Aaron Harrison,SG,22,0,4,0.0,0,2,0.0,0,2,0.0,1,2,0.5,0,3,3,3,0,0,0,2,1,2017_Aaron Harrison
2017,Archie Goodwin,SG,22,72,132,0.5454545454545454,10,30,0.3333333333333333,62,102,0.6078431372549019,66,84,0.7857142857142857,14,42,56,48,8,10,28,16,220,2017_Archie Goodwin
2017,George Hill,PG,30,289,606,0.4768976897689769,94,233,0.4034334763948498,195,373,0.5227882037533512,157,196,0.8010204081632653,23,144,167,203,50,11,85,114,829,2017_George Hill
2017,Gordon Hayward,SF,26,545,1156,0.47145328719723184,149,374,0.3983957219251337,396,782,0.5063938618925832,362,429,0.8438228438228438,49,344,393,252,73,20,140,117,1601,2017_Gordon Hayward
2017,Harrison Barnes,PF,24,599,1280,0.46796875,78,222,0.35135135135135137,521,1058,0.4924385633270321,242,281,0.8612099644128114,94,303,397,117,66,15,102,128,1518,2017_Harrison Barnes
2017,Jake Layman,SF,22,26,89,0.29213483146067415,13,51,0.2549019607843137,13,38,0.34210526315789475,13,17,0.7647058823529411,6,18,24,11,9,3,11,22,78,2017_Jake Layman
2017,Jared Sullinger,PF,24,15,48,0.3125,3,18,0.16666666666666666,12,30,0.4,4,8,0.5,10,17,27,3,4,1,4,17,37,2017_Jared Sullinger
2017,Jarrett Jack,PG,33,2,3,0.6666666666666666,0,1,0.0,2,2,1.0,2,2,1.0,0,0,0,5,2,0,3,4,6,2017_Jarrett Jack
2017,Joe Ingles,SF,29,204,451,0.4523281596452328,123,279,0.44086021505376344,81,172,0.47093023255813954,50,68,0.7352941176470589,23,237,260,224,96,8,107,163,581,2017_Joe Ingles
2017,Joe Johnson,SF,35,273,626,0.43610223642172524,106,258,0.4108527131782946,167,368,0.453804347826087,63,77,0.8181818181818182,33,209,242,144,36,18,69,93,715,2017_Joe Johnson
2017,Mike Muscala,C,25,170,337,0.5044510385756676,46,110,0.41818181818181815,124,227,0.5462555066079295,49,64,0.765625,76,164,240,95,30,41,55,97,435,2017_Mike Muscala
2017,Mike Tobey,C,22,1,4,0.25,0,0,NaN,1,4,0.25,0,0,NaN,2,1,3,1,0,0,1,2,2,2017_Mike Tobey
2017,Roy Hibbert,C,30,160,294,0.54421768707483,0,0,NaN,160,294,0.54421768707483,122,150,0.8133333333333334,108,200,308,42,16,92,64,200,442,2017_Roy Hibbert
2017,Sergio Rodriguez,PG,30,210,536,0.3917910447761194,92,252,0.36507936507936506,118,284,0.4154929577464789,18,27,0.6666666666666666,21,136,157,344,48,4,128,95,530,2017_Sergio Rodriguez
2017,Solomon Hill,SF,25,183,477,0.3836477987421384,94,270,0.34814814814814815,89,207,0.42995169082125606,103,128,0.8046875,51,256,307,141,71,32,82,182,563,2017_Solomon Hill
2017,Stephen Zimmerman,C,20,10,31,0.3225806451612903,0,0,NaN,10,31,0.3225806451612903,3,5,0.6,11,24,35,4,2,5,3,17,23,2017_Stephen Zimmerman
2017,Terry Rozier,PG,22,151,411,0.36739659367396593,57,179,0.31843575418994413,94,232,0.4051724137931034,51,66,0.7727272727272727,40,187,227,131,45,11,47,69,410,2017_Terry Rozier
2017,Tim Frazier,PG,26,163,404,0.4034653465346535,40,128,0.3125,123,276,0.44565217391304346,98,129,0.7596899224806202,34,139,173,335,56,6,101,133,464,2017_Tim Frazier
2003,Alan Henderson,C,30,153,327,0.46788990825688076,0,2,0.0,153,325,0.4707692307692308,88,138,0.6376811594202898,156,242,398,41,33,32,61,168,394,2003_Alan Henderson
2003,Amal McCaskill,C,29,4,17,0.23529411764705882,0,0,NaN,4,17,0.23529411764705882,3,4,0.75,7,15,22,5,3,1,2,13,11,2003_Amal McCaskill
2003,Carlos Arroyo,PG,23,50,109,0.45871559633027525,3,7,0.42857142857142855,47,102,0.46078431372549017,18,22,0.8181818181818182,11,15,26,53,12,1,30,28,121,2003_Carlos Arroyo
2003,Danny Manning,PF,36,13,32,0.40625,3,8,0.375,10,24,0.4166666666666667,5,6,0.8333333333333334,7,11,18,7,9,3,7,11,34,2003_Danny Manning
2003,Dean Oliver,PG,24,7,29,0.2413793103448276,1,6,0.16666666666666666,6,23,0.2608695652173913,7,8,0.875,8,8,16,23,7,0,10,9,22,2003_Dean Oliver
2003,Drew Gooden,SF-PF_SF_PF,21,710,1554,0.4568854568854569,28,96,0.2916666666666667,682,1458,0.46776406035665297,302,424,0.7122641509433962,326,584,910,166,106,70,300,344,1750,2003_Drew Gooden
2003,Jake Tsakalidis,C,23,61,135,0.45185185185185184,0,0,NaN,61,135,0.45185185185185184,39,58,0.6724137931034483,45,77,122,13,6,17,26,80,161,2003_Jake Tsakalidis
2003,Kareem Rush,PG,22,96,244,0.39344262295081966,19,68,0.27941176470588236,77,176,0.4375,16,23,0.6956521739130435,26,68,94,68,10,11,63,71,227,2003_Kareem Rush
2003,Latrell Sprewell,SF,32,454,1127,0.4028393966282165,134,360,0.37222222222222223,320,767,0.4172099087353325,173,218,0.7935779816513762,45,240,285,332,102,22,172,134,1215,2003_Latrell Sprewell
2003,Lavor Postell,SG,24,14,38,0.3684210526315789,2,7,0.2857142857142857,12,31,0.3870967741935484,13,15,0.8666666666666667,1,3,4,3,2,0,7,9,43,2003_Lavor Postell
2003,Lindsey Hunter,PG,32,106,302,0.3509933774834437,34,107,0.3177570093457944,72,195,0.36923076923076925,34,47,0.723404255319149,15,44,59,71,35,5,57,50,280,2003_Lindsey Hunter
2003,Tyrone Hill,PF,34,258,612,0.4215686274509804,0,0,NaN,258,612,0.4215686274509804,108,160,0.675,252,530,782,82,92,52,136,344,624,2003_Tyrone Hill
2003,Vladimir Stepania,C,26,185,427,0.4332552693208431,0,0,NaN,185,427,0.4332552693208431,71,134,0.5298507462686567,211,343,554,24,45,40,69,169,441,2003_Vladimir Stepania
2004,Anthony Carter,PG,28,11,37,0.2972972972972973,0,3,0.0,11,34,0.3235294117647059,0,0,NaN,2,9,11,12,4,0,12,9,22,2004_Anthony Carter
2004,Bryce Drew,PG,29,4,18,0.2222222222222222,1,7,0.14285714285714285,3,11,0.2727272727272727,3,3,1.0,0,6,6,13,4,0,8,1,12,2004_Bryce Drew
2004,Carlos Arroyo,PG,24,339,768,0.44140625,38,117,0.3247863247863248,301,651,0.46236559139784944,181,225,0.8044444444444444,41,144,185,355,63,5,156,165,897,2004_Carlos Arroyo
2004,Chauncey Billups,PG,27,392,996,0.39357429718875503,130,335,0.3880597014925373,262,661,0.39636913767019666,404,460,0.8782608695652174,35,241,276,446,84,8,189,177,1318,2004_Chauncey Billups
2004,Drew Gooden,PF,22,369,829,0.4451145958986731,9,42,0.21428571428571427,360,787,0.45743329097839897,167,262,0.6374045801526718,160,356,516,89,62,72,126,196,914,2004_Drew Gooden
2004,Francisco Elson,C,27,94,199,0.4723618090452261,0,1,0.0,94,198,0.47474747474747475,30,45,0.6666666666666666,65,138,203,32,35,39,35,145,218,2004_Francisco Elson
2004,Jake Tsakalidis,C,24,67,133,0.5037593984962406,0,0,NaN,67,133,0.5037593984962406,36,61,0.5901639344262295,37,91,128,18,9,22,23,79,170,2004_Jake Tsakalidis
2004,Jerome James,C,28,129,259,0.4980694980694981,0,0,NaN,129,259,0.4980694980694981,66,100,0.66,78,152,230,32,20,60,82,180,324,2004_Jerome James
2004,John Salmons,SG,24,161,416,0.3870192307692308,50,147,0.3401360544217687,111,269,0.41263940520446096,71,92,0.7717391304347826,38,158,196,134,62,16,77,122,443,2004_John Salmons
2004,Kareem Rush,SG,23,190,432,0.4398148148148148,48,138,0.34782608695652173,142,294,0.48299319727891155,31,52,0.5961538461538461,20,77,97,59,33,20,48,109,459,2004_Kareem Rush
2004,Luke Ridnour,PG,22,145,350,0.4142857142857143,27,80,0.3375,118,270,0.43703703703703706,65,79,0.8227848101265823,35,73,108,163,52,7,80,105,382,2004_Luke Ridnour
2004,Malik Rose,PF,29,173,404,0.4282178217821782,0,3,0.0,173,401,0.4314214463840399,183,225,0.8133333333333334,110,210,320,69,36,24,112,164,529,2004_Malik Rose
2004,Maurice Carter,SG,27,22,70,0.3142857142857143,8,22,0.36363636363636365,14,48,0.2916666666666667,32,40,0.8,4,18,22,8,0,0,18,20,84,2004_Maurice Carter
2004,Othella Harrington,PF,30,100,202,0.49504950495049505,0,0,NaN,100,202,0.49504950495049505,58,78,0.7435897435897436,58,119,177,29,12,14,65,134,258,2004_Othella Harrington
2004,Quentin Richardson,SG,23,425,1068,0.397940074906367,120,341,0.3519061583577713,305,727,0.4195323246217332,151,204,0.7401960784313726,146,268,414,139,67,19,141,130,1121,2004_Quentin Richardson
2004,Richie Frahm,SF,26,63,139,0.45323741007194246,34,92,0.3695652173913043,29,47,0.6170212765957447,23,26,0.8846153846153846,12,44,56,24,16,4,7,50,183,2004_Richie Frahm
2004,Slavko Vranes,C,21,0,1,0.0,0,0,NaN,0,1,0.0,0,0,NaN,0,0,0,0,0,0,0,1,0,2004_Slavko Vranes
2004,Steve Nash,PG,29,397,845,0.46982248520710057,104,257,0.4046692607003891,293,588,0.49829931972789115,230,251,0.9163346613545816,59,173,232,687,67,8,209,139,1128,2004_Steve Nash
2004,Tyrone Hill,PF,35,3,5,0.6,0,0,NaN,3,5,0.6,3,4,0.75,5,3,8,0,0,1,2,10,9,2004_Tyrone Hill
2004,Vladimir Stepania,C,27,43,103,0.4174757281553398,0,0,NaN,43,103,0.4174757281553398,22,36,0.6111111111111112,50,75,125,23,11,15,19,61,108,2004_Vladimir Stepania
2005,Adonal Foyle,C,29,156,311,0.5016077170418006,0,0,NaN,156,311,0.5016077170418006,40,72,0.5555555555555556,165,264,429,56,26,159,58,201,352,2005_Adonal Foyle
2005,Ben Gordon,SG,21,434,1056,0.4109848484848485,134,331,0.40483383685800606,300,725,0.41379310344827586,233,270,0.8629629629629629,55,160,215,164,53,10,186,224,1235,2005_Ben Gordon
2005,Carlos Arroyo,PG,25,334,858,0.38927738927738925,16,60,0.26666666666666666,318,798,0.39849624060150374,238,298,0.7986577181208053,52,156,208,560,88,8,214,286,922,2005_Carlos Arroyo
2005,Darius Miles,SF,23,336,697,0.48206599713055953,8,23,0.34782608695652173,328,674,0.486646884272997,129,215,0.6,71,228,299,129,75,78,157,189,809,2005_Darius Miles
2005,Drew Gooden,PF,23,464,943,0.49204665959703076,5,28,0.17857142857142858,459,915,0.5016393442622951,251,310,0.8096774193548387,207,546,753,130,77,76,133,233,1184,2005_Drew Gooden
2005,Francisco Elson,C,28,101,216,0.4675925925925926,1,3,0.3333333333333333,100,213,0.4694835680751174,45,79,0.569620253164557,61,140,201,34,34,41,40,129,248,2005_Francisco Elson
2005,Ha Seung-Jin,C,19,10,23,0.43478260869565216,0,0,NaN,10,23,0.43478260869565216,6,11,0.5454545454545454,6,12,18,2,1,5,12,21,26,2005_Ha Seung-Jin
2005,Jake Tsakalidis,C,25,32,64,0.5,0,0,NaN,32,64,0.5,14,18,0.7777777777777778,21,35,56,10,3,16,12,42,78,2005_Jake Tsakalidis
2005,Jerome Moiso,C_PF_C-PF,26,18,36,0.5,0,2,0.0,18,34,0.5294117647058824,20,26,0.7692307692307693,20,54,74,2,6,12,14,26,56,2005_Jerome Moiso
2005,Kareem Rush,SG,24,314,812,0.3866995073891626,102,274,0.3722627737226277,212,538,0.3940520446096654,74,96,0.7708333333333334,40,138,178,136,40,14,94,148,804,2005_Kareem Rush
2005,Obinna Ekezie,C,29,79,182,0.4340659340659341,0,1,0.0,79,181,0.43646408839779005,72,93,0.7741935483870968,69,110,179,11,22,12,45,129,230,2005_Obinna Ekezie
2005,Shandon Anderson,SF_SG_SF-SG,31,196,434,0.45161290322580644,10,58,0.1724137931034483,186,376,0.4946808510638298,108,132,0.8181818181818182,82,300,382,140,80,28,100,276,510,2005_Shandon Anderson
2005,Shaquille O'Neal,C,32,658,1095,0.6009132420091324,0,0,NaN,658,1095,0.6009132420091324,353,765,0.46143790849673205,253,507,760,200,36,171,203,262,1669,2005_Shaquille O'Neal
2005,Tony Allen,SG,23,184,387,0.4754521963824289,12,31,0.3870967741935484,172,356,0.48314606741573035,112,152,0.7368421052631579,85,136,221,64,76,24,77,156,492,2005_Tony Allen
2006,Carlos Arroyo,PG-SG_SG_PG,26,336,756,0.4444444444444444,14,40,0.35,322,716,0.44972067039106145,212,274,0.7737226277372263,66,194,260,464,76,8,166,238,898,2006_Carlos Arroyo
2006,Derek Fisher,PG,31,364,887,0.41037204058624577,117,295,0.39661016949152544,247,592,0.4172297297297297,244,293,0.8327645051194539,36,175,211,352,125,8,156,237,1089,2006_Derek Fisher
2006,Dijon Thompson,SG,22,11,25,0.44,4,11,0.36363636363636365,7,14,0.5,2,2,1.0,4,7,11,1,3,1,2,6,28,2006_Dijon Thompson
2006,Drew Gooden,PF,24,334,652,0.5122699386503068,1,3,0.3333333333333333,333,649,0.5130970724191063,176,258,0.6821705426356589,237,428,665,56,52,49,106,190,845,2006_Drew Gooden
2006,Emeka Okafor,PF,23,131,316,0.41455696202531644,0,0,NaN,131,316,0.41455696202531644,82,125,0.656,94,167,261,31,22,50,53,88,344,2006_Emeka Okafor
2006,Francisco Elson,C,29,151,284,0.5316901408450704,1,5,0.2,150,279,0.5376344086021505,49,74,0.6621621621621622,99,240,339,47,54,45,65,211,352,2006_Francisco Elson
2006,Jake Tsakalidis,C,26,100,165,0.6060606060606061,0,0,NaN,100,165,0.6060606060606061,57,87,0.6551724137931034,78,134,212,13,14,32,39,107,257,2006_Jake Tsakalidis
2006,Joey Graham,SF,23,198,414,0.4782608695652174,29,87,0.3333333333333333,169,327,0.5168195718654435,108,133,0.8120300751879699,57,187,244,60,37,13,92,228,533,2006_Joey Graham
2006,Kareem Rush,SG,25,181,469,0.3859275053304904,57,164,0.3475609756097561,124,305,0.4065573770491803,55,77,0.7142857142857143,18,85,103,50,38,13,65,79,474,2006_Kareem Rush
2006,Kendrick Perkins,C,21,137,266,0.5150375939849624,0,2,0.0,137,264,0.5189393939393939,80,130,0.6153846153846154,140,264,404,69,21,105,107,199,354,2006_Kendrick Perkins
2006,Kris Humphries,PF,20,77,203,0.3793103448275862,0,5,0.0,77,198,0.3888888888888889,34,65,0.5230769230769231,56,101,157,30,23,16,31,82,188,2006_Kris Humphries
2006,Salim Stoudamire,SG,23,204,492,0.4146341463414634,82,216,0.37962962962962965,122,276,0.4420289855072464,99,110,0.9,12,104,116,75,27,3,82,118,589,2006_Salim Stoudamire
2007,Carlos Arroyo,PG,27,203,478,0.4246861924686193,14,51,0.27450980392156865,189,427,0.4426229508196721,132,166,0.7951807228915663,31,103,134,202,39,2,90,131,552,2007_Carlos Arroyo
2007,Drew Gooden,PF,25,371,784,0.4732142857142857,1,6,0.16666666666666666,370,778,0.4755784061696658,142,199,0.7135678391959799,263,418,681,88,70,28,115,210,885,2007_Drew Gooden
2007,Jake Tsakalidis,C,27,58,144,0.4027777777777778,0,0,NaN,58,144,0.4027777777777778,52,78,0.6666666666666666,84,124,208,10,16,24,48,102,168,2007_Jake Tsakalidis
2007,Joey Graham,SF,24,192,388,0.4948453608247423,9,31,0.2903225806451613,183,357,0.5126050420168067,110,131,0.8396946564885496,55,193,248,44,30,4,49,161,503,2007_Joey Graham
2007,Mike Hall,SF,22,1,4,0.25,0,0,NaN,1,4,0.25,0,0,NaN,1,1,2,1,0,0,0,1,2,2007_Mike Hall
2007,Orien Greene,SG,24,23,62,0.3709677419354839,2,11,0.18181818181818182,21,51,0.4117647058823529,15,25,0.6,12,32,44,22,17,4,28,38,63,2007_Orien Greene
2007,Raef LaFrentz,PF,30,39,102,0.38235294117647056,2,23,0.08695652173913043,37,79,0.46835443037974683,20,26,0.7692307692307693,25,45,70,8,7,11,13,57,100,2007_Raef LaFrentz
2007,Robert Horry,PF,36,90,251,0.35856573705179284,50,149,0.33557046979865773,40,102,0.39215686274509803,38,64,0.59375,73,156,229,77,45,41,44,105,268,2007_Robert Horry
2008,Al Horford,C,21,333,668,0.49850299401197606,0,5,0.0,333,663,0.502262443438914,155,212,0.7311320754716981,248,537,785,124,60,76,137,267,821,2008_Al Horford
2008,Antawn Jamison,PF,31,618,1417,0.4361326746647848,120,354,0.3389830508474576,498,1063,0.4684854186265287,333,438,0.7602739726027398,215,591,806,120,106,34,113,195,1689,2008_Antawn Jamison
2008,Carlos Arroyo,PG,28,157,348,0.4511494252873563,29,84,0.34523809523809523,128,264,0.48484848484848486,87,102,0.8529411764705882,10,103,113,219,26,2,77,85,430,2008_Carlos Arroyo
2008,Delonte West,PG,24,392,950,0.4126315789473684,96,270,0.35555555555555557,296,680,0.43529411764705883,134,182,0.7362637362637363,62,324,386,458,118,58,234,206,1014,2008_Delonte West
2008,Drew Gooden,PF,26,664,1480,0.4486486486486487,0,12,0.0,664,1468,0.45231607629427795,324,430,0.7534883720930232,350,830,1180,162,96,106,244,406,1652,2008_Drew Gooden
2008,Joey Graham,SF,25,49,113,0.4336283185840708,2,3,0.6666666666666666,47,110,0.42727272727272725,38,45,0.8444444444444444,18,49,67,15,3,0,23,47,138,2008_Joey Graham
2008,Josh Boone,PF,23,238,434,0.5483870967741935,0,0,NaN,238,434,0.5483870967741935,99,217,0.45622119815668205,192,317,509,55,36,61,68,155,575,2008_Josh Boone
2008,Kareem Rush,SG,27,228,569,0.4007029876977153,102,262,0.3893129770992366,126,307,0.41042345276872966,30,42,0.7142857142857143,19,149,168,89,42,19,62,108,588,2008_Kareem Rush
2008,Luke Jackson,SF,26,26,80,0.325,11,30,0.36666666666666664,15,50,0.3,16,23,0.6956521739130435,7,26,33,17,8,0,9,22,79,2008_Luke Jackson
2008,Melvin Ely,C,29,85,180,0.4722222222222222,0,0,NaN,85,180,0.4722222222222222,32,58,0.5517241379310345,28,117,145,22,7,18,42,79,202,2008_Melvin Ely
2008,Mike Wilks,PG,28,34,72,0.4722222222222222,6,16,0.375,28,56,0.5,8,8,1.0,10,28,38,28,18,0,18,26,82,2008_Mike Wilks
2008,Raef LaFrentz,C,31,27,61,0.4426229508196721,0,4,0.0,27,57,0.47368421052631576,11,19,0.5789473684210527,28,39,67,6,12,17,10,59,65,2008_Raef LaFrentz
2008,Vince Carter,SG,31,587,1287,0.4560994560994561,98,273,0.358974358974359,489,1014,0.4822485207100592,350,429,0.8158508158508159,112,341,453,389,93,33,181,241,1622,2008_Vince Carter
2009,Al Jefferson,C,24,485,975,0.49743589743589745,0,4,0.0,485,971,0.49948506694129763,186,252,0.7380952380952381,172,376,548,79,39,83,92,141,1156,2009_Al Jefferson
2009,Corey Maggette,PF,29,292,634,0.4605678233438486,24,95,0.25263157894736843,268,539,0.4972170686456401,342,415,0.8240963855421687,49,233,282,92,44,8,120,192,950,2009_Corey Maggette
2009,Drew Gooden,PF,27,474,1012,0.4683794466403162,0,8,0.0,474,1004,0.4721115537848606,262,312,0.8397435897435898,226,498,724,96,60,36,152,288,1210,2009_Drew Gooden
2009,J.J. Hickson,C,20,100,194,0.5154639175257731,0,0,NaN,100,194,0.5154639175257731,45,67,0.6716417910447762,52,113,165,9,14,30,45,81,245,2009_J.J. Hickson
2009,Joey Graham,SF,26,231,480,0.48125,3,16,0.1875,228,464,0.49137931034482757,132,160,0.825,95,197,292,48,35,12,74,191,597,2009_Joey Graham
2009,Kareem Rush,SG,28,20,58,0.3448275862068966,10,33,0.30303030303030304,10,25,0.4,4,4,1.0,0,15,15,15,5,1,10,10,54,2009_Kareem Rush
2009,Kevin Love,C,20,316,688,0.45930232558139533,2,19,0.10526315789473684,314,669,0.4693572496263079,265,336,0.7886904761904762,274,460,734,84,35,50,118,205,899,2009_Kevin Love
2009,Othello Hunter,PF,22,11,20,0.55,0,0,NaN,11,20,0.55,0,5,0.0,9,15,24,1,2,5,2,11,22,2009_Othello Hunter
2009,Shavlik Randolph,PF,25,8,13,0.6153846153846154,1,1,1.0,7,12,0.5833333333333334,1,4,0.25,10,8,18,0,0,1,6,4,18,2009_Shavlik Randolph
2010,Carlos Arroyo,PG,30,178,375,0.4746666666666667,7,25,0.28,171,350,0.48857142857142855,76,90,0.8444444444444444,26,104,130,225,36,6,54,102,439,2010_Carlos Arroyo
2010,Chris Richard,PF,25,15,29,0.5172413793103449,0,0,NaN,15,29,0.5172413793103449,7,11,0.6363636363636364,19,40,59,7,8,4,14,50,37,2010_Chris Richard
2010,Francisco Elson,C,33,10,30,0.3333333333333333,0,0,NaN,10,30,0.3333333333333333,4,10,0.4,12,16,28,4,2,0,2,14,24,2010_Francisco Elson
2010,James Johnson,PF,22,95,210,0.4523809523809524,15,46,0.32608695652173914,80,164,0.4878048780487805,51,70,0.7285714285714285,34,94,128,48,21,43,62,126,256,2010_James Johnson
2010,Jawad Williams,PG,26,81,206,0.3932038834951456,30,93,0.3225806451612903,51,113,0.45132743362831856,32,45,0.7111111111111111,16,67,83,34,12,5,18,73,224,2010_Jawad Williams
2010,LeBron James,SF,25,768,1528,0.5026178010471204,129,387,0.3333333333333333,639,1141,0.5600350569675723,593,773,0.7671410090556274,71,483,554,651,125,77,261,119,2258,2010_LeBron James
2010,Marcus Williams,PG,24,104,271,0.3837638376383764,24,81,0.2962962962962963,80,190,0.42105263157894735,37,55,0.6727272727272727,13,80,93,161,32,1,74,43,269,2010_Marcus Williams
2010,Nick Collison,C,29,182,309,0.5889967637540453,1,4,0.25,181,305,0.5934426229508196,74,107,0.6915887850467289,152,232,384,38,37,48,63,230,439,2010_Nick Collison
2010,Shawn Marion,SF,31,395,778,0.5077120822622108,3,19,0.15789473684210525,392,759,0.5164690382081687,105,139,0.7553956834532374,158,319,477,107,69,61,99,141,898,2010_Shawn Marion
2010,Ty Lawson,PG,22,201,390,0.5153846153846153,34,83,0.40963855421686746,167,307,0.5439739413680782,106,140,0.7571428571428571,42,82,124,203,48,2,82,89,542,2010_Ty Lawson
2010,Tyreke Evans,SG,20,533,1165,0.4575107296137339,36,141,0.2553191489361702,497,1024,0.4853515625,348,465,0.7483870967741936,66,314,380,414,109,26,216,204,1450,2010_Tyreke Evans
2011,Carlos Arroyo,PG,31,240,546,0.43956043956043955,62,138,0.4492753623188406,178,408,0.4362745098039216,78,94,0.8297872340425532,40,166,206,250,42,2,120,142,620,2011_Carlos Arroyo
2011,DeMarcus Cousins,C,20,432,1004,0.4302788844621514,3,18,0.16666666666666666,429,986,0.43509127789046653,276,402,0.6865671641791045,217,482,699,204,85,68,268,332,1143,2011_DeMarcus Cousins
2011,Eduardo Najera,PF,34,26,72,0.3611111111111111,11,34,0.3235294117647059,15,38,0.39473684210526316,6,11,0.5454545454545454,14,30,44,20,11,6,13,52,69,2011_Eduardo Najera
2011,Francisco Elson,C,34,54,113,0.4778761061946903,0,0,NaN,54,113,0.4778761061946903,26,31,0.8387096774193549,35,80,115,33,21,14,32,84,134,2011_Francisco Elson
2011,Garret Siler,C,24,17,31,0.5483870967741935,0,0,NaN,17,31,0.5483870967741935,11,22,0.5,16,12,28,3,1,4,10,20,45,2011_Garret Siler
2011,James Johnson,SF,23,216,474,0.45569620253164556,16,68,0.23529411764705882,200,406,0.49261083743842365,94,142,0.6619718309859155,74,210,284,178,66,74,128,190,542,2011_James Johnson
2011,Luis Scola,PF,30,569,1129,0.503985828166519,0,3,0.0,569,1126,0.5053285968028419,214,290,0.7379310344827587,147,459,606,185,48,44,147,227,1352,2011_Luis Scola
2011,Marcus Cousin,C,24,2,3,0.6666666666666666,0,0,NaN,2,3,0.6666666666666666,0,0,NaN,0,3,3,0,0,1,1,1,4,2011_Marcus Cousin
2011,Nene Hilario,C,28,402,654,0.6146788990825688,1,5,0.2,401,649,0.6178736517719569,286,402,0.7114427860696517,145,426,571,149,84,73,134,238,1091,2011_Nene Hilario
2011,Solomon Alabi,C,22,3,15,0.2,0,0,NaN,3,15,0.2,0,2,0.0,7,7,14,2,2,2,3,5,6,2011_Solomon Alabi
2011,Ty Lawson,PG,23,346,688,0.502906976744186,69,171,0.40350877192982454,277,517,0.5357833655705996,172,225,0.7644444444444445,67,142,209,377,80,4,137,133,933,2011_Ty Lawson
2011,Willie Green,SG,29,270,609,0.4433497536945813,54,155,0.34838709677419355,216,454,0.47577092511013214,78,100,0.78,22,139,161,74,36,13,67,143,672,2011_Willie Green
2012,C.J. Miles,SG,24,177,465,0.38064516129032255,46,150,0.30666666666666664,131,315,0.4158730158730159,108,136,0.7941176470588235,27,89,116,69,46,18,53,122,508,2012_C.J. Miles
2012,Drew Gooden,C,30,287,657,0.4368340943683409,16,55,0.2909090909090909,271,602,0.45016611295681064,176,208,0.8461538461538461,130,233,363,144,46,34,109,112,766,2012_Drew Gooden
2012,Francisco Elson,C,35,1,3,0.3333333333333333,0,0,NaN,1,3,0.3333333333333333,0,0,NaN,0,1,1,1,1,1,1,0,2,2012_Francisco Elson
2012,James Johnson,SF,24,233,518,0.4498069498069498,19,60,0.31666666666666665,214,458,0.4672489082969432,81,115,0.7043478260869566,74,218,292,122,71,84,101,177,566,2012_James Johnson
2012,Jarrett Jack,PG,28,266,583,0.4562607204116638,39,112,0.3482142857142857,227,471,0.4819532908704883,129,148,0.8716216216216216,23,153,176,285,31,9,106,93,700,2012_Jarrett Jack
2012,Jerome Dyson,PG,24,19,48,0.3958333333333333,1,8,0.125,18,40,0.45,28,36,0.7777777777777778,2,17,19,18,11,2,20,19,67,2012_Jerome Dyson
2012,Keith Bogans,SF,31,8,21,0.38095238095238093,3,12,0.25,5,9,0.5555555555555556,2,5,0.4,5,6,11,3,2,0,3,15,21,2012_Keith Bogans
2012,Lamar Odom,SF,32,123,349,0.3524355300859599,28,111,0.25225225225225223,95,238,0.39915966386554624,58,98,0.5918367346938775,36,172,208,83,20,18,52,97,332,2012_Lamar Odom
2012,Marcus Morris,PF,22,16,54,0.2962962962962963,2,17,0.11764705882352941,14,37,0.3783783783783784,6,8,0.75,5,11,16,3,2,2,4,12,40,2012_Marcus Morris
2012,Solomon Alabi,C,23,13,36,0.3611111111111111,0,0,NaN,13,36,0.3611111111111111,7,8,0.875,15,32,47,3,2,9,5,11,33,2012_Solomon Alabi
2012,Terrel Harris,SG,24,29,83,0.3493975903614458,8,39,0.20512820512820512,21,44,0.4772727272727273,14,21,0.6666666666666666,18,33,51,26,9,2,25,34,80,2012_Terrel Harris
2012,Ty Lawson,PG,24,374,767,0.4876140808344198,73,200,0.365,301,567,0.5308641975308642,178,216,0.8240740740740741,54,173,227,401,82,6,149,94,999,2012_Ty Lawson
2013,Aaron Gray,C,28,48,90,0.5333333333333333,0,0,NaN,48,90,0.5333333333333333,23,44,0.5227272727272727,48,85,133,33,7,5,36,85,119,2013_Aaron Gray
2013,Andre Drummond,C,19,208,342,0.6081871345029239,1,2,0.5,207,340,0.6088235294117647,59,159,0.3710691823899371,169,288,457,30,59,95,57,144,476,2013_Andre Drummond
2013,Anthony Morrow,SG,27,128,290,0.4413793103448276,32,86,0.37209302325581395,96,204,0.47058823529411764,40,44,0.9090909090909091,22,38,60,26,26,2,16,86,328,2013_Anthony Morrow
2013,Chris Paul,PG,27,412,856,0.48130841121495327,76,232,0.3275862068965517,336,624,0.5384615384615384,286,323,0.8854489164086687,53,209,262,678,169,10,159,143,1186,2013_Chris Paul
2013,Daequan Cook,SG,25,102,334,0.30538922155688625,52,182,0.2857142857142857,50,152,0.32894736842105265,18,24,0.75,14,108,122,38,16,14,30,52,274,2013_Daequan Cook
2013,Diante Garrett,PG,24,16,49,0.32653061224489793,3,15,0.2,13,34,0.38235294117647056,5,10,0.5,5,10,15,31,10,0,16,5,40,2013_Diante Garrett
2013,Drew Gooden,C,31,20,61,0.32786885245901637,1,5,0.2,19,56,0.3392857142857143,11,16,0.6875,13,18,31,6,5,6,9,21,52,2013_Drew Gooden
2013,Glen Davis,PF,27,214,478,0.4476987447698745,0,2,0.0,214,476,0.4495798319327731,84,117,0.717948717948718,55,191,246,70,32,21,64,88,512,2013_Glen Davis
2013,Jae Crowder,SF,22,141,367,0.38419618528610355,63,192,0.328125,78,175,0.44571428571428573,47,73,0.6438356164383562,35,152,187,94,63,17,49,128,392,2013_Jae Crowder
2013,James Johnson,SF,25,117,283,0.4134275618374558,2,21,0.09523809523809523,115,262,0.4389312977099237,40,67,0.5970149253731343,49,96,145,58,41,50,68,99,276,2013_James Johnson
2013,Jeremy Evans,PF,25,27,44,0.6136363636363636,0,1,0.0,27,43,0.627906976744186,21,33,0.6363636363636364,26,32,58,11,8,13,8,30,75,2013_Jeremy Evans
2013,Joel Freeland,PF,25,58,142,0.4084507042253521,0,0,NaN,58,142,0.4084507042253521,18,27,0.6666666666666666,40,79,119,13,13,11,19,67,134,2013_Joel Freeland
2013,Josh Selby,PG,21,6,22,0.2727272727272727,1,6,0.16666666666666666,5,16,0.3125,7,11,0.6363636363636364,0,5,5,4,2,0,7,7,20,2013_Josh Selby
2013,Luke Babbitt,PF,23,86,234,0.36752136752136755,62,178,0.34831460674157305,24,56,0.42857142857142855,10,13,0.7692307692307693,15,122,137,29,14,5,22,82,244,2013_Luke Babbitt
2013,Marcus Morris,SF_PF_PF-SF,23,444,1052,0.4220532319391635,172,466,0.36909871244635195,272,586,0.4641638225255973,132,234,0.5641025641025641,160,394,554,124,90,40,154,320,1192,2013_Marcus Morris
2013,Terrel Harris,SG,25,8,54,0.14814814814814814,0,16,0.0,8,38,0.21052631578947367,14,20,0.7,8,44,52,18,4,6,34,34,30,2013_Terrel Harris
2013,Thaddeus Young,PF,24,509,958,0.5313152400835073,1,8,0.125,508,950,0.5347368421052632,108,188,0.574468085106383,182,389,571,125,133,55,90,191,1127,2013_Thaddeus Young
2013,Trevor Ariza,SF,27,188,451,0.41685144124168516,76,209,0.36363636363636365,112,242,0.4628099173553719,78,95,0.8210526315789474,44,222,266,113,72,20,84,72,530,2013_Trevor Ariza
2013,Ty Lawson,PG,25,448,971,0.46138002059732236,85,232,0.36637931034482757,363,739,0.4912043301759134,235,311,0.7556270096463023,36,162,198,501,107,8,182,135,1216,2013_Ty Lawson
2014,Brandan Wright,C,26,224,331,0.676737160120846,0,0,NaN,224,331,0.676737160120846,77,106,0.7264150943396226,102,142,244,31,32,55,35,94,525,2014_Brandan Wright
2014,Chase Budinger,SF,25,100,254,0.3937007874015748,42,120,0.35,58,134,0.43283582089552236,32,39,0.8205128205128205,19,84,103,31,19,2,24,58,274,2014_Chase Budinger
2014,Drew Gooden,C,32,76,143,0.5314685314685315,7,17,0.4117647058823529,69,126,0.5476190476190477,24,27,0.8888888888888888,37,77,114,15,10,7,17,53,183,2014_Drew Gooden
2014,Elias Harris,SF,24,0,1,0.0,0,0,NaN,0,1,0.0,0,0,NaN,1,0,1,1,1,0,0,0,0,2014_Elias Harris
2014,Erik Murphy,C,23,3,13,0.23076923076923078,0,3,0.0,3,10,0.3,0,0,NaN,2,6,8,2,0,4,2,7,6,2014_Erik Murphy
2014,Ian Clark,SG,22,26,67,0.3880597014925373,11,31,0.3548387096774194,15,36,0.4166666666666667,5,7,0.7142857142857143,3,16,19,15,8,2,14,24,68,2014_Ian Clark
2014,Jae Crowder,SF,23,130,296,0.4391891891891892,50,151,0.33112582781456956,80,145,0.5517241379310345,46,61,0.7540983606557377,46,148,194,60,59,21,41,100,356,2014_Jae Crowder
2014,James Johnson,SF,26,143,308,0.4642857142857143,22,87,0.25287356321839083,121,221,0.5475113122171946,76,90,0.8444444444444444,60,106,166,111,42,57,66,102,384,2014_James Johnson
2014,Jared Dudley,SF,28,196,447,0.43847874720357943,81,225,0.36,115,222,0.5180180180180181,38,58,0.6551724137931034,36,124,160,104,41,10,56,146,511,2014_Jared Dudley
2014,Joel Freeland,C,26,77,162,0.47530864197530864,0,2,0.0,77,160,0.48125,20,29,0.6896551724137931,88,120,208,36,10,22,32,95,174,2014_Joel Freeland
2014,Marcus Morris,SF,24,288,651,0.4423963133640553,99,260,0.38076923076923075,189,391,0.4833759590792839,121,159,0.7610062893081762,84,235,319,88,72,18,95,157,796,2014_Marcus Morris
2014,Royce White,PF,22,0,1,0.0,0,0,NaN,0,1,0.0,0,0,NaN,0,0,0,0,0,0,0,2,0,2014_Royce White
2014,Ty Lawson,PG,26,347,806,0.4305210918114144,72,202,0.3564356435643564,275,604,0.4552980132450331,324,406,0.7980295566502463,40,175,215,543,100,10,200,113,1090,2014_Ty Lawson
2014,Vitor Faverani,C,25,64,147,0.43537414965986393,12,40,0.3,52,107,0.48598130841121495,24,37,0.6486486486486487,42,86,128,16,14,27,41,74,164,2014_Vitor Faverani
2015,Alexey Shved,SG,26,266,670,0.3970149253731343,94,278,0.3381294964028777,172,392,0.4387755102040816,242,300,0.8066666666666666,46,152,198,212,60,12,96,96,868,2015_Alexey Shved
2015,Andre Dawkins,SG,23,1,6,0.16666666666666666,1,6,0.16666666666666666,0,0,NaN,0,0,NaN,0,2,2,1,0,0,1,3,3,2015_Andre Dawkins
2015,Chris Bosh,C,30,343,745,0.4604026845637584,63,168,0.375,280,577,0.4852686308492201,179,232,0.771551724137931,46,264,310,95,41,25,95,69,928,2015_Chris Bosh
2015,Drew Gooden,PF,33,110,276,0.39855072463768115,23,59,0.3898305084745763,87,217,0.4009216589861751,34,44,0.7727272727272727,72,151,223,49,21,9,28,91,277,2015_Drew Gooden
2015,Erick Green,PG,23,61,162,0.3765432098765432,14,47,0.2978723404255319,47,115,0.40869565217391307,10,12,0.8333333333333334,7,24,31,39,12,0,14,26,146,2015_Erick Green
2015,Greg Smith,PF,24,30,49,0.6122448979591837,0,0,NaN,30,49,0.6122448979591837,20,39,0.5128205128205128,26,53,79,9,7,11,11,53,80,2015_Greg Smith
2015,Ian Clark,SG,23,38,110,0.34545454545454546,20,60,0.3333333333333333,18,50,0.36,18,18,1.0,8,24,32,24,18,6,18,40,114,2015_Ian Clark
2015,Jae Crowder,SF,24,458,1090,0.42018348623853213,122,416,0.2932692307692308,336,674,0.49851632047477745,218,282,0.7730496453900709,144,442,586,188,144,50,98,274,1256,2015_Jae Crowder
2015,James Johnson,PF,27,238,404,0.5891089108910891,11,51,0.21568627450980393,227,353,0.6430594900849859,67,102,0.6568627450980392,61,196,257,95,54,70,79,155,554,2015_James Johnson
2015,Joel Freeland,C,27,74,151,0.4900662251655629,0,0,NaN,74,151,0.4900662251655629,21,25,0.84,62,129,191,16,9,23,23,93,169,2015_Joel Freeland
2015,John Salmons,SF,35,16,48,0.3333333333333333,8,26,0.3076923076923077,8,22,0.36363636363636365,2,4,0.5,4,17,21,13,9,4,5,25,42,2015_John Salmons
2015,Jrue Holiday,PG,24,238,534,0.44569288389513106,51,135,0.37777777777777777,187,399,0.46867167919799496,65,76,0.8552631578947368,32,103,135,274,63,23,91,110,592,2015_Jrue Holiday
2015,Luke Ridnour,PG,33,75,176,0.42613636363636365,20,63,0.31746031746031744,55,113,0.48672566371681414,18,21,0.8571428571428571,8,60,68,96,20,4,38,67,188,2015_Luke Ridnour
2015,Marcus Morris,PF,25,331,763,0.4338138925294889,112,313,0.35782747603833864,219,450,0.4866666666666667,71,113,0.6283185840707964,73,312,385,133,63,16,73,188,845,2015_Marcus Morris
2015,Marcus Smart,PG,20,175,477,0.3668763102725367,91,272,0.33455882352941174,84,205,0.4097560975609756,82,127,0.6456692913385826,61,161,222,208,99,18,90,176,523,2015_Marcus Smart
2015,Taj Gibson,PF,29,254,506,0.5019762845849802,0,0,NaN,254,506,0.5019762845849802,132,184,0.717391304347826,162,234,396,71,36,75,77,162,640,2015_Taj Gibson
2015,Ty Lawson,PG,27,404,926,0.43628509719222464,70,205,0.34146341463414637,334,721,0.463245492371706,265,363,0.7300275482093664,42,192,234,720,92,9,185,128,1143,2015_Ty Lawson
2015,Will Cherry,PG,23,5,19,0.2631578947368421,2,9,0.2222222222222222,3,10,0.3,3,6,0.5,1,4,5,8,6,1,4,10,15,2015_Will Cherry
2016,Danilo Gallinari,SF,27,287,700,0.41,87,239,0.36401673640167365,200,461,0.43383947939262474,375,432,0.8680555555555556,52,229,281,135,42,19,77,87,1036,2016_Danilo Gallinari
2016,Drew Gooden,PF,34,33,103,0.32038834951456313,7,41,0.17073170731707318,26,62,0.41935483870967744,9,14,0.6428571428571429,28,57,85,13,8,11,13,40,82,2016_Drew Gooden
2016,Elijah Millsap,SG,28,11,39,0.28205128205128205,1,12,0.08333333333333333,10,27,0.37037037037037035,13,18,0.7222222222222222,6,29,35,19,7,3,9,33,36,2016_Elijah Millsap
2016,Erick Green,PG,24,10,26,0.38461538461538464,2,10,0.2,8,16,0.5,4,4,1.0,6,6,12,6,2,0,0,8,26,2016_Erick Green
2016,Ian Clark,SG,24,89,202,0.4405940594059406,30,84,0.35714285714285715,59,118,0.5,28,34,0.8235294117647058,13,55,68,64,17,13,43,58,236,2016_Ian Clark
2016,Jae Crowder,SF,25,360,813,0.44280442804428044,122,363,0.33608815426997246,238,450,0.5288888888888889,196,239,0.8200836820083682,70,303,373,135,126,35,83,198,1038,2016_Jae Crowder
2016,James Johnson,PF,28,114,240,0.475,20,66,0.30303030303030304,94,174,0.5402298850574713,39,68,0.5735294117647058,28,98,126,67,29,33,54,84,287,2016_James Johnson
2016,Josh McRoberts,PF,28,55,148,0.3716216216216216,12,49,0.24489795918367346,43,99,0.43434343434343436,28,40,0.7,22,83,105,81,18,7,30,68,150,2016_Josh McRoberts
2016,Lance Stephenson,SF,25,456,948,0.4810126582278481,60,156,0.38461538461538464,396,792,0.5,174,222,0.7837837837837838,80,366,446,266,86,18,188,270,1146,2016_Lance Stephenson
2016,Marcus Morris,SF,26,410,945,0.43386243386243384,108,298,0.3624161073825503,302,647,0.4667697063369397,203,271,0.7490774907749077,91,313,404,201,67,23,140,170,1131,2016_Marcus Morris
2016,Nik Stauskas,SG,22,210,545,0.3853211009174312,106,325,0.3261538461538461,104,220,0.4727272727272727,91,118,0.7711864406779662,23,160,183,138,44,20,94,115,617,2016_Nik Stauskas
2016,Shane Larkin,PG,23,222,502,0.44223107569721115,39,108,0.3611111111111111,183,394,0.46446700507614214,83,107,0.7757009345794392,28,152,180,342,95,12,146,121,566,2016_Shane Larkin
2016,Tony Allen,SG,34,215,469,0.4584221748400853,15,42,0.35714285714285715,200,427,0.468384074941452,90,138,0.6521739130434783,104,192,296,70,110,18,78,175,535,2016_Tony Allen
2016,Ty Lawson,PG,28,278,708,0.3926553672316384,72,216,0.3333333333333333,206,492,0.4186991869918699,118,172,0.686046511627907,52,188,240,474,106,14,190,174,746,2016_Ty Lawson
2017,Cheick Diallo,PF,20,36,76,0.47368421052631576,0,0,NaN,36,76,0.47368421052631576,15,21,0.7142857142857143,23,50,73,4,4,7,7,17,87,2017_Cheick Diallo
2017,DeMarre Carroll,SF,30,220,549,0.4007285974499089,109,320,0.340625,111,229,0.4847161572052402,89,117,0.7606837606837606,63,212,275,74,81,27,54,143,638,2017_DeMarre Carroll
2017,Gerald Henderson,SG,29,234,553,0.4231464737793852,61,173,0.35260115606936415,173,380,0.45526315789473687,133,165,0.806060606060606,34,151,185,112,41,15,62,129,662,2017_Gerald Henderson
2017,Ian Clark,SG,25,211,433,0.48729792147806006,61,163,0.37423312883435583,150,270,0.5555555555555556,44,58,0.7586206896551724,22,100,122,90,39,8,55,77,527,2017_Ian Clark
2017,Jae Crowder,SF,26,333,720,0.4625,157,394,0.39847715736040606,176,326,0.5398773006134969,176,217,0.8110599078341014,48,367,415,155,72,23,79,161,999,2017_Jae Crowder
2017,James Johnson,PF,29,368,769,0.47854356306892065,87,256,0.33984375,281,513,0.5477582846003899,152,215,0.7069767441860465,66,309,375,276,76,86,171,197,975,2017_James Johnson
2017,Kris Humphries,PF,31,87,214,0.40654205607476634,19,54,0.35185185185185186,68,160,0.425,64,82,0.7804878048780488,60,146,206,29,15,21,28,69,257,2017_Kris Humphries
2017,Kyle O'Quinn,C,26,215,413,0.5205811138014528,2,17,0.11764705882352941,213,396,0.5378787878787878,64,83,0.7710843373493976,157,282,439,117,36,104,76,174,496,2017_Kyle O'Quinn
2017,Marcus Morris,SF,27,421,1007,0.41807348560079444,118,357,0.33053221288515405,303,650,0.46615384615384614,145,185,0.7837837837837838,77,289,366,160,52,25,87,168,1105,2017_Marcus Morris
2017,Maurice Harkless,SF,23,314,624,0.5032051282051282,68,194,0.35051546391752575,246,430,0.5720930232558139,77,124,0.6209677419354839,125,216,341,89,85,70,85,214,773,2017_Maurice Harkless
2017,Michael Kidd-Gilchrist,SF,23,295,618,0.4773462783171521,1,9,0.1111111111111111,294,609,0.4827586206896552,152,194,0.7835051546391752,156,409,565,114,81,77,56,187,743,2017_Michael Kidd-Gilchrist
2017,Paul Millsap,PF,31,430,972,0.44238683127572015,75,241,0.3112033195020747,355,731,0.4856361149110807,311,405,0.7679012345679013,111,422,533,252,90,62,158,186,1246,2017_Paul Millsap
2017,Rakeem Christmas,PF,25,19,43,0.4418604651162791,0,0,NaN,19,43,0.4418604651162791,21,29,0.7241379310344828,26,30,56,4,3,6,8,37,59,2017_Rakeem Christmas
2017,Reggie Bullock,SF,25,54,128,0.421875,28,73,0.3835616438356164,26,55,0.4727272727272727,5,7,0.7142857142857143,13,51,64,29,18,3,10,22,141,2017_Reggie Bullock
2017,Reggie Williams,SF,30,8,23,0.34782608695652173,5,11,0.45454545454545453,3,12,0.25,6,7,0.8571428571428571,2,4,6,4,3,0,0,2,27,2017_Reggie Williams
2017,Ryan Kelly,PF,25,8,28,0.2857142857142857,4,10,0.4,4,18,0.2222222222222222,5,6,0.8333333333333334,1,17,18,8,4,5,4,5,25,2017_Ryan Kelly
2017,Terrence Jones,PF,25,462,982,0.47046843177189407,38,150,0.25333333333333335,424,832,0.5096153846153846,206,340,0.6058823529411764,130,482,612,116,80,108,96,134,1168,2017_Terrence Jones
2017,Ty Lawson,PG,29,237,522,0.4540229885057471,34,118,0.288135593220339,203,404,0.5024752475247525,173,217,0.7972350230414746,44,135,179,335,74,6,129,119,681,2017_Ty Lawson
2003,Antawn Jamison,SF,26,691,1471,0.4697484704282801,65,209,0.31100478468899523,626,1262,0.4960380348652932,375,475,0.7894736842105263,195,383,578,156,76,45,177,197,1822,2003_Antawn Jamison
2003,Cezary Trybanski,C,23,5,20,0.25,0,0,NaN,5,20,0.25,4,10,0.4,6,8,14,1,0,6,8,13,14,2003_Cezary Trybanski
2003,Chris Jefferies,SF,22,75,194,0.3865979381443299,18,54,0.3333333333333333,57,140,0.40714285714285714,29,43,0.6744186046511628,16,43,59,22,19,16,45,56,197,2003_Chris Jefferies
2003,Eddie Griffin,PF,20,271,678,0.3997050147492625,64,192,0.3333333333333333,207,486,0.42592592592592593,58,94,0.6170212765957447,138,323,461,86,52,111,76,136,664,2003_Eddie Griffin
2003,Etan Thomas,PF,24,61,124,0.49193548387096775,0,0,NaN,61,124,0.49193548387096775,60,94,0.6382978723404256,70,95,165,3,8,23,33,66,182,2003_Etan Thomas
2003,Nate Huffman,C,27,9,25,0.36,0,0,NaN,9,25,0.36,5,8,0.625,9,14,23,5,1,3,3,13,23,2003_Nate Huffman
2003,Robert Archibald,PF,22,6,20,0.3,0,0,NaN,6,20,0.3,7,18,0.3888888888888889,6,11,17,3,0,3,7,9,19,2003_Robert Archibald
2003,Sam Cassell,PG,33,546,1162,0.46987951807228917,59,163,0.3619631901840491,487,999,0.4874874874874875,385,447,0.8612975391498882,57,285,342,450,88,14,177,216,1536,2003_Sam Cassell
2003,Stanislav Medvedenko,PF,23,112,258,0.43410852713178294,0,2,0.0,112,256,0.4375,31,43,0.7209302325581395,66,75,141,18,11,8,37,118,255,2003_Stanislav Medvedenko
2003,Steven Hunter,C,21,56,103,0.5436893203883495,0,0,NaN,56,103,0.5436893203883495,18,44,0.4090909090909091,38,55,93,6,9,36,15,56,130,2003_Steven Hunter
2003,Vince Carter,SG,26,355,760,0.46710526315789475,45,131,0.3435114503816794,310,629,0.492845786963434,129,160,0.80625,59,129,188,143,48,41,74,121,884,2003_Vince Carter
2003,Zeljko Rebraca,C,30,80,145,0.5517241379310345,0,0,NaN,80,145,0.5517241379310345,38,48,0.7916666666666666,27,65,92,9,6,17,29,79,198,2003_Zeljko Rebraca
2004,Anthony Goldwire,PG,32,14,44,0.3181818181818182,4,16,0.25,10,28,0.35714285714285715,2,2,1.0,2,12,14,22,10,0,6,10,34,2004_Anthony Goldwire
2004,Boris Diaw,SG,21,140,313,0.4472843450479233,6,26,0.23076923076923078,134,287,0.46689895470383275,56,93,0.6021505376344086,111,231,342,182,59,37,126,191,342,2004_Boris Diaw
2004,Chris Jefferies,SF_SG_SF-SG,23,54,144,0.375,34,84,0.40476190476190477,20,60,0.3333333333333333,26,40,0.65,10,48,58,14,8,14,38,72,168,2004_Chris Jefferies
2004,Dan Dickau,PG,25,74,196,0.37755102040816324,20,60,0.3333333333333333,54,136,0.39705882352941174,22,28,0.7857142857142857,14,38,52,76,34,0,52,88,190,2004_Dan Dickau
2004,Etan Thomas,C,25,257,526,0.48859315589353614,0,0,NaN,257,526,0.48859315589353614,191,295,0.6474576271186441,183,345,528,68,36,123,113,219,705,2004_Etan Thomas
2004,Juwan Howard,PF,30,529,1169,0.4525235243798118,0,1,0.0,529,1168,0.4529109589041096,318,393,0.8091603053435115,171,399,570,158,54,22,178,284,1376,2004_Juwan Howard
2004,Rick Fox,SF,34,73,186,0.3924731182795699,15,61,0.2459016393442623,58,125,0.464,22,30,0.7333333333333333,29,73,102,98,29,4,48,99,183,2004_Rick Fox
2004,Rusty LaRue,PG,30,1,3,0.3333333333333333,1,1,1.0,0,2,0.0,1,2,0.5,0,3,3,2,2,0,4,2,4,2004_Rusty LaRue
2004,Sam Cassell,PG,34,620,1270,0.4881889763779528,74,186,0.3978494623655914,546,1084,0.503690036900369,289,331,0.8731117824773413,44,227,271,592,102,18,220,247,1603,2004_Sam Cassell
2004,Steven Hunter,C,22,82,155,0.5290322580645161,0,0,NaN,82,155,0.5290322580645161,23,69,0.3333333333333333,54,116,170,12,5,73,29,101,187,2004_Steven Hunter
2004,Yao Ming,C,23,535,1025,0.5219512195121951,0,2,0.0,535,1023,0.52297165200391,361,446,0.8094170403587444,197,538,735,122,22,156,204,273,1431,2004_Yao Ming
2005,Anthony Peeler,SG,35,56,150,0.37333333333333335,25,65,0.38461538461538464,31,85,0.36470588235294116,16,18,0.8888888888888888,14,51,65,57,18,2,28,39,153,2005_Anthony Peeler
2005,Corliss Williamson,PF,31,546,1168,0.4674657534246575,0,4,0.0,546,1164,0.4690721649484536,390,488,0.7991803278688525,208,310,518,156,76,30,172,436,1482,2005_Corliss Williamson
2005,David Harrison,C,22,106,184,0.5760869565217391,0,0,NaN,106,184,0.5760869565217391,52,91,0.5714285714285714,48,87,135,13,16,55,53,134,264,2005_David Harrison
2005,Eddie Griffin,PF,22,202,522,0.38697318007662834,67,204,0.3284313725490196,135,318,0.42452830188679247,56,78,0.717948717948718,128,325,453,53,23,118,55,120,527,2005_Eddie Griffin
2005,Etan Thomas,C,26,128,255,0.5019607843137255,0,0,NaN,128,255,0.5019607843137255,76,144,0.5277777777777778,85,159,244,20,17,51,50,133,332,2005_Etan Thomas
2005,Ibo Kutluay,SG,30,0,1,0.0,0,0,NaN,0,1,0.0,0,0,NaN,0,1,1,0,0,0,2,1,0,2005_Ibo Kutluay
2005,Jamison Brewer,PG,24,11,37,0.2972972972972973,3,15,0.2,8,22,0.36363636363636365,6,13,0.46153846153846156,6,16,22,12,8,1,13,11,31,2005_Jamison Brewer
2005,Jason Williams,PG,29,266,644,0.41304347826086957,107,330,0.3242424242424242,159,314,0.5063694267515924,80,101,0.7920792079207921,19,103,122,399,75,5,130,91,719,2005_Jason Williams
2005,Kendall Gill,SG,36,32,80,0.4,3,9,0.3333333333333333,29,71,0.4084507042253521,18,20,0.9,11,26,37,27,14,4,9,37,85,2005_Kendall Gill
2005,Kenny Anderson,PG,34,170,402,0.4228855721393035,12,26,0.46153846153846156,158,376,0.42021276595744683,54,74,0.7297297297297297,48,128,176,206,66,0,98,174,406,2005_Kenny Anderson
2005,LeBron James,SF,20,795,1684,0.47209026128266035,108,308,0.35064935064935066,687,1376,0.4992732558139535,477,636,0.75,111,477,588,577,177,52,262,146,2175,2005_LeBron James
2005,Lionel Chalmers,PG,24,42,125,0.336,12,49,0.24489795918367346,30,76,0.39473684210526316,15,24,0.625,4,27,31,51,13,0,24,30,111,2005_Lionel Chalmers
2005,Lonny Baxter,PF,26,3,11,0.2727272727272727,0,0,NaN,3,11,0.2727272727272727,0,2,0.0,4,4,8,0,0,0,4,10,6,2005_Lonny Baxter
2005,Matt Bonner,C,24,247,463,0.5334773218142549,39,92,0.42391304347826086,208,371,0.5606469002695418,56,71,0.7887323943661971,108,177,285,48,39,19,40,220,589,2005_Matt Bonner
2005,Randy Livingston,PG,29,22,52,0.4230769230769231,5,8,0.625,17,44,0.38636363636363635,15,17,0.8823529411764706,3,9,12,45,12,2,14,28,64,2005_Randy Livingston
2005,Sam Cassell,PG,35,319,687,0.4643377001455604,27,103,0.2621359223300971,292,584,0.5,134,155,0.864516129032258,25,132,157,301,36,14,109,160,799,2005_Sam Cassell
2005,Scott Williams,C,36,12,41,0.2926829268292683,0,1,0.0,12,40,0.3,9,11,0.8181818181818182,15,15,30,8,4,6,5,30,33,2005_Scott Williams
2005,Steven Hunter,C,23,135,220,0.6136363636363636,0,1,0.0,135,219,0.6164383561643836,78,163,0.4785276073619632,98,129,227,13,4,102,44,131,348,2005_Steven Hunter
2006,Antonio Daniels,SG,30,230,550,0.41818181818181815,23,101,0.22772277227722773,207,449,0.4610244988864143,284,336,0.8452380952380952,19,153,172,284,52,8,89,96,767,2006_Antonio Daniels
2006,Daniel Ewing,SG,22,97,255,0.3803921568627451,22,78,0.28205128205128205,75,177,0.423728813559322,36,46,0.782608695652174,23,62,85,84,37,6,57,86,252,2006_Daniel Ewing
2006,Eddie Griffin,C,23,130,370,0.35135135135135137,16,82,0.1951219512195122,114,288,0.3958333333333333,44,74,0.5945945945945946,107,282,389,40,13,148,43,125,320,2006_Eddie Griffin
2006,Etan Thomas,C,27,131,246,0.532520325203252,0,0,NaN,131,246,0.532520325203252,75,125,0.6,99,180,279,14,20,68,51,148,337,2006_Etan Thomas
2006,Matt Bonner,PF,25,209,467,0.4475374732334047,102,243,0.41975308641975306,107,224,0.47767857142857145,63,76,0.8289473684210527,86,198,284,56,49,31,32,216,583,2006_Matt Bonner
2006,Michael Finley,SG,32,286,695,0.4115107913669065,110,279,0.3942652329749104,176,416,0.4230769230769231,98,115,0.8521739130434782,31,216,247,116,37,7,62,97,780,2006_Michael Finley
2006,Michael Olowokandi,C,30,214,480,0.44583333333333336,0,0,NaN,214,480,0.44583333333333336,48,94,0.5106382978723404,100,340,440,46,44,66,110,244,476,2006_Michael Olowokandi
2006,Nene Hilario,PF,23,0,1,0.0,0,0,NaN,0,1,0.0,0,0,NaN,0,0,0,0,0,0,2,1,0,2006_Nene Hilario
2006,Sam Cassell,PG,36,493,1112,0.4433453237410072,70,190,0.3684210526315789,423,922,0.45878524945770066,289,335,0.8626865671641791,40,247,287,491,74,11,175,225,1345,2006_Sam Cassell
2006,Sergei Monia,SF,22,58,174,0.3333333333333333,18,68,0.2647058823529412,40,106,0.37735849056603776,20,28,0.7142857142857143,22,82,104,38,14,10,24,82,154,2006_Sergei Monia
2006,Steven Hunter,C,24,175,291,0.6013745704467354,0,0,NaN,175,291,0.6013745704467354,71,138,0.5144927536231884,110,161,271,17,12,76,64,120,421,2006_Steven Hunter
2006,Willie Green,SG,24,28,66,0.42424242424242425,10,19,0.5263157894736842,18,47,0.3829787234042553,4,5,0.8,1,14,15,5,2,0,12,13,70,2006_Willie Green
2007,Antonio Daniels,SG,31,172,389,0.442159383033419,19,63,0.30158730158730157,153,326,0.46932515337423314,208,250,0.832,18,133,151,290,39,9,69,79,571,2007_Antonio Daniels
2007,Bernard Robinson,SF_SG_SG-SF,26,38,124,0.3064516129032258,0,4,0.0,38,120,0.31666666666666665,46,54,0.8518518518518519,20,76,96,38,34,4,32,64,122,2007_Bernard Robinson
2007,Bobby Jones,SF,23,43,93,0.46236559139784944,1,9,0.1111111111111111,42,84,0.5,23,41,0.5609756097560976,22,35,57,16,11,1,18,59,110,2007_Bobby Jones
2007,Brandon Roy,SG,22,349,765,0.4562091503267974,55,146,0.3767123287671233,294,619,0.47495961227786754,202,241,0.8381742738589212,58,192,250,230,67,10,116,139,955,2007_Brandon Roy
2007,Dan Gadzuric,C,28,108,228,0.47368421052631576,0,1,0.0,108,227,0.47577092511013214,42,90,0.4666666666666667,94,152,246,29,22,32,49,141,258,2007_Dan Gadzuric
2007,Eddie Griffin,PF,24,7,27,0.25925925925925924,0,1,0.0,7,26,0.2692307692307692,4,5,0.8,7,18,25,4,0,7,6,8,18,2007_Eddie Griffin
2007,Etan Thomas,C,28,159,277,0.5740072202166066,0,0,NaN,159,277,0.5740072202166066,77,138,0.5579710144927537,136,241,377,29,22,89,71,162,395,2007_Etan Thomas
2007,Gordan Giricek,SG,29,176,381,0.46194225721784776,52,122,0.4262295081967213,124,259,0.47876447876447875,71,87,0.8160919540229885,24,105,129,63,28,5,64,122,475,2007_Gordan Giricek
2007,Greg Buckner,SG,30,123,299,0.411371237458194,32,103,0.3106796116504854,91,196,0.4642857142857143,27,34,0.7941176470588235,35,123,158,70,47,7,40,152,305,2007_Greg Buckner
2007,Jalen Rose,SF,34,38,86,0.4418604651162791,21,47,0.44680851063829785,17,39,0.4358974358974359,11,12,0.9166666666666666,3,20,23,16,5,2,9,22,108,2007_Jalen Rose
2007,Jarrett Jack,PG,23,320,705,0.45390070921985815,63,180,0.35,257,525,0.4895238095238095,243,279,0.8709677419354839,18,190,208,417,86,9,187,202,946,2007_Jarrett Jack
2007,Jarvis Hayes,SF,25,224,546,0.41025641025641024,66,183,0.36065573770491804,158,363,0.43526170798898073,71,84,0.8452380952380952,42,168,210,80,48,13,56,160,585,2007_Jarvis Hayes
2007,Matt Bonner,PF,26,106,237,0.4472573839662447,36,94,0.3829787234042553,70,143,0.48951048951048953,27,38,0.7105263157894737,64,92,156,22,17,11,25,67,275,2007_Matt Bonner
2007,Quinton Ross,SG,25,177,379,0.46701846965699206,2,10,0.2,175,369,0.4742547425474255,68,87,0.7816091954022989,60,130,190,86,70,32,33,179,424,2007_Quinton Ross
2007,Sam Cassell,PG,37,261,625,0.4176,32,109,0.29357798165137616,229,516,0.4437984496124031,160,182,0.8791208791208791,27,140,167,270,28,8,101,126,714,2007_Sam Cassell
2007,Sergio Rodriguez,PG,20,101,239,0.4225941422594142,24,85,0.2823529411764706,77,154,0.5,21,26,0.8076923076923077,20,71,91,218,35,2,77,72,247,2007_Sergio Rodriguez
2007,Shannon Brown,SG,21,28,74,0.3783783783783784,7,25,0.28,21,49,0.42857142857142855,10,14,0.7142857142857143,6,15,21,10,7,3,14,24,73,2007_Shannon Brown
2007,Steven Hunter,PF,25,188,326,0.5766871165644172,0,0,NaN,188,326,0.5766871165644172,74,151,0.4900662251655629,114,221,335,26,13,76,65,137,450,2007_Steven Hunter
2008,Aaron Gray,C,23,103,204,0.5049019607843137,0,1,0.0,103,203,0.5073891625615764,56,99,0.5656565656565656,70,98,168,41,21,16,57,117,262,2008_Aaron Gray
2008,Antonio Daniels,PG,32,205,447,0.45861297539149887,17,74,0.22972972972972974,188,373,0.5040214477211796,170,219,0.776255707762557,23,180,203,340,69,2,91,78,597,2008_Antonio Daniels
2008,Bobby Jones,C-SF_SF_C,24,120,280,0.42857142857142855,36,106,0.33962264150943394,84,174,0.4827586206896552,80,102,0.7843137254901961,58,126,184,56,30,6,56,170,356,2008_Bobby Jones
2008,Brandon Roy,SG,23,531,1170,0.45384615384615384,73,215,0.3395348837209302,458,955,0.47958115183246075,281,373,0.7533512064343163,81,267,348,430,79,16,136,147,1416,2008_Brandon Roy
2008,Chris Paul,PG,22,630,1291,0.487993803253292,92,249,0.36947791164658633,538,1042,0.5163147792706334,332,390,0.8512820512820513,62,259,321,925,217,4,201,185,1684,2008_Chris Paul
2008,D.J. Strawberry,SG,22,29,92,0.31521739130434784,6,25,0.24,23,67,0.34328358208955223,9,19,0.47368421052631576,9,19,28,30,12,6,11,36,73,2008_D.J. Strawberry
2008,Daequan Cook,SG,20,196,514,0.38132295719844356,79,238,0.3319327731092437,117,276,0.42391304347826086,47,57,0.8245614035087719,20,157,177,75,23,9,63,157,518,2008_Daequan Cook
2008,Glen Davis,C,22,107,221,0.4841628959276018,0,0,NaN,107,221,0.4841628959276018,99,150,0.66,95,113,208,28,31,20,65,160,313,2008_Glen Davis
2008,Jarron Collins,C,29,36,82,0.43902439024390244,0,1,0.0,36,81,0.4444444444444444,46,74,0.6216216216216216,40,76,116,37,10,6,22,106,118,2008_Jarron Collins
2008,Lance Allred,C,26,1,4,0.25,0,0,NaN,1,4,0.25,1,2,0.5,0,1,1,0,0,0,0,1,3,2008_Lance Allred
2008,Larry Hughes,PG-SG_SG_PG,29,610,1602,0.3807740324594257,134,388,0.34536082474226804,476,1214,0.39209225700164746,300,376,0.7978723404255319,78,382,460,362,198,34,232,278,1654,2008_Larry Hughes
2008,Matt Bonner,PF,27,121,291,0.41580756013745707,46,137,0.3357664233576642,75,154,0.487012987012987,38,44,0.8636363636363636,53,139,192,32,14,17,39,111,326,2008_Matt Bonner
2008,Sam Cassell,PG,38,466,1064,0.43796992481203006,46,152,0.3026315789473684,420,912,0.4605263157894737,254,288,0.8819444444444444,34,238,272,428,74,12,194,196,1232,2008_Sam Cassell
2008,Shannon Brown,SG,22,88,252,0.3492063492063492,18,60,0.3,70,192,0.3645833333333333,34,58,0.5862068965517241,12,28,40,34,22,6,48,58,228,2008_Shannon Brown
2008,Steven Hunter,C,26,15,28,0.5357142857142857,0,0,NaN,15,28,0.5357142857142857,9,20,0.45,10,19,29,0,0,6,7,20,39,2008_Steven Hunter
2008,Trevor Ariza,SF,22,138,272,0.5073529411764706,10,36,0.2777777777777778,128,236,0.5423728813559322,98,150,0.6533333333333333,60,156,216,88,62,22,46,90,384,2008_Trevor Ariza
2009,Antonio Daniels,PG,33,198,472,0.4194915254237288,44,120,0.36666666666666664,154,352,0.4375,160,200,0.8,10,144,154,354,52,2,124,110,600,2009_Antonio Daniels
2009,Bobby Brown,SG-PG_SG_PG,24,282,720,0.39166666666666666,90,260,0.34615384615384615,192,460,0.41739130434782606,68,86,0.7906976744186046,28,76,104,234,42,6,126,190,722,2009_Bobby Brown
2009,Brandan Wright,PF,21,130,246,0.5284552845528455,0,4,0.0,130,242,0.5371900826446281,63,85,0.7411764705882353,62,95,157,21,22,37,23,74,323,2009_Brandan Wright
2009,Brandon Roy,SG,24,633,1318,0.4802731411229135,83,220,0.37727272727272726,550,1098,0.5009107468123861,416,505,0.8237623762376237,104,266,370,400,88,22,152,127,1765,2009_Brandon Roy
2009,Jared Dudley,SF,23,272,570,0.47719298245614034,58,148,0.3918918918918919,214,422,0.5071090047393365,142,210,0.6761904761904762,164,246,410,112,114,16,86,210,744,2009_Jared Dudley
2009,Jason Collins,C,30,22,70,0.3142857142857143,0,0,NaN,22,70,0.3142857142857143,13,28,0.4642857142857143,28,42,70,11,9,13,12,73,57,2009_Jason Collins
2009,Matt Bonner,PF,28,266,536,0.4962686567164179,118,268,0.44029850746268656,148,268,0.5522388059701493,17,23,0.7391304347826086,97,289,386,82,47,26,37,190,667,2009_Matt Bonner
2009,Shannon Brown,SG,23,156,330,0.4727272727272727,28,74,0.3783783783783784,128,256,0.5,64,78,0.8205128205128205,22,66,88,76,44,14,76,84,404,2009_Shannon Brown
2009,Thomas Gardner,SG,23,9,36,0.25,4,23,0.17391304347826086,5,13,0.38461538461538464,2,4,0.5,0,7,7,2,4,1,3,4,24,2009_Thomas Gardner
2010,Brandon Jennings,PG,20,451,1216,0.37088815789473684,145,388,0.37371134020618557,306,828,0.3695652173913043,223,273,0.8168498168498168,49,233,282,470,105,18,200,191,1270,2010_Brandon Jennings
2010,Chris Bosh,C,25,600,1158,0.5181347150259067,8,22,0.36363636363636365,592,1136,0.5211267605633803,470,590,0.7966101694915254,205,554,759,166,43,68,169,170,1678,2010_Chris Bosh
2010,Etan Thomas,C,31,31,68,0.45588235294117646,0,0,NaN,31,68,0.45588235294117646,13,22,0.5909090909090909,18,46,64,1,4,16,18,39,75,2010_Etan Thomas
2010,Ian Mahinmi,C,23,35,55,0.6363636363636364,0,0,NaN,35,55,0.6363636363636364,31,47,0.6595744680851063,13,39,52,2,3,8,15,32,101,2010_Ian Mahinmi
2010,Joel Przybilla,C,30,45,86,0.5232558139534884,0,0,NaN,45,86,0.5232558139534884,33,51,0.6470588235294118,72,166,238,8,8,43,39,95,123,2010_Joel Przybilla
2010,Johan Petro,C,24,54,101,0.5346534653465347,0,1,0.0,54,100,0.54,14,21,0.6666666666666666,32,97,129,14,10,13,23,80,122,2010_Johan Petro
2010,Jrue Holiday,PG,19,230,520,0.4423076923076923,62,159,0.389937106918239,168,361,0.46537396121883656,65,86,0.7558139534883721,56,135,191,280,79,18,156,153,587,2010_Jrue Holiday
2010,Luke Ridnour,PG,28,328,686,0.478134110787172,69,181,0.3812154696132597,259,505,0.5128712871287129,127,140,0.9071428571428571,24,119,143,324,54,7,106,182,852,2010_Luke Ridnour
2010,Malik Hairston,SG,22,40,76,0.5263157894736842,2,11,0.18181818181818182,38,65,0.5846153846153846,17,30,0.5666666666666667,13,36,49,16,4,9,11,29,99,2010_Malik Hairston
2010,Mario West,SG,25,12,21,0.5714285714285714,0,1,0.0,12,20,0.6,6,10,0.6,8,19,27,9,8,0,7,25,30,2010_Mario West
2010,Paul Davis,PF,25,2,4,0.5,0,0,NaN,2,4,0.5,1,2,0.5,0,0,0,3,0,1,0,0,5,2010_Paul Davis
2010,Quentin Richardson,SF,29,242,561,0.43137254901960786,142,358,0.39664804469273746,100,203,0.49261083743842365,52,71,0.7323943661971831,64,310,374,93,70,18,62,169,678,2010_Quentin Richardson
2010,Renaldo Balkman,SF,25,6,18,0.3333333333333333,0,7,0.0,6,11,0.5454545454545454,2,6,0.3333333333333333,4,19,23,7,8,2,6,16,14,2010_Renaldo Balkman
2011,Antoine Wright,SG,26,1,8,0.125,0,4,0.0,1,4,0.25,0,0,NaN,2,1,3,0,1,0,1,3,2,2011_Antoine Wright
2011,Ben Gordon,SG,27,339,770,0.44025974025974024,107,266,0.40225563909774437,232,504,0.4603174603174603,136,160,0.85,41,154,195,171,48,16,141,178,921,2011_Ben Gordon
2011,Didier Ilunga-Mbenga,C,30,23,49,0.46938775510204084,0,0,NaN,23,49,0.46938775510204084,13,18,0.7222222222222222,35,51,86,6,6,27,21,52,59,2011_Didier Ilunga-Mbenga
2011,Etan Thomas,C,32,10,21,0.47619047619047616,0,0,NaN,10,21,0.47619047619047616,12,15,0.8,6,17,23,2,1,4,5,11,32,2011_Etan Thomas
2011,Ian Mahinmi,C,24,55,98,0.5612244897959183,0,2,0.0,55,96,0.5729166666666666,63,82,0.7682926829268293,43,77,120,8,14,15,25,105,173,2011_Ian Mahinmi
2011,Johan Petro,C,25,129,290,0.44482758620689655,0,4,0.0,129,286,0.45104895104895104,15,28,0.5357142857142857,62,150,212,44,34,34,46,178,273,2011_Johan Petro
2011,Jon Brockman,C,23,48,94,0.5106382978723404,0,0,NaN,48,94,0.5106382978723404,40,59,0.6779661016949152,74,110,184,18,14,3,24,119,136,2011_Jon Brockman
2011,Matt Bonner,PF,30,172,371,0.4636118598382749,105,230,0.45652173913043476,67,141,0.475177304964539,32,43,0.7441860465116279,60,179,239,60,26,21,27,110,481,2011_Matt Bonner
2011,Mike Bibby,PG,32,496,1152,0.4305555555555556,306,696,0.4396551724137931,190,456,0.4166666666666667,78,124,0.6290322580645161,34,356,390,530,100,18,202,350,1376,2011_Mike Bibby
2011,Renaldo Balkman,SF,26,12,26,0.46153846153846156,2,4,0.5,10,22,0.45454545454545453,6,8,0.75,4,10,14,4,8,4,2,30,32,2011_Renaldo Balkman
2011,Rodney Stuckey,PG,24,363,827,0.43893591293833134,26,90,0.28888888888888886,337,737,0.45725915875169604,330,381,0.8661417322834646,70,146,216,361,76,10,155,177,1082,2011_Rodney Stuckey
2011,Shaquille O'Neal,C,38,134,201,0.6666666666666666,0,0,NaN,134,201,0.6666666666666666,73,131,0.5572519083969466,48,130,178,26,16,42,56,120,341,2011_Shaquille O'Neal
2011,Tony Allen,SG,29,251,492,0.5101626016260162,4,23,0.17391304347826086,247,469,0.5266524520255863,137,182,0.7527472527472527,70,123,193,104,129,44,86,161,643,2011_Tony Allen
2012,Derek Fisher,PG,37,258,696,0.3706896551724138,70,218,0.3211009174311927,188,478,0.39330543933054396,114,134,0.8507462686567164,24,218,242,340,102,8,146,234,700,2012_Derek Fisher
2012,Dexter Pittman,C,23,44,94,0.46808510638297873,0,0,NaN,44,94,0.46808510638297873,18,28,0.6428571428571429,27,44,71,9,8,8,17,73,106,2012_Dexter Pittman
2012,Emeka Okafor,C,29,114,214,0.5327102803738317,0,0,NaN,114,214,0.5327102803738317,38,74,0.5135135135135135,70,143,213,24,16,26,37,73,266,2012_Emeka Okafor
2012,Ian Mahinmi,C,25,130,238,0.5462184873949579,0,1,0.0,130,237,0.5485232067510548,94,147,0.6394557823129252,108,181,289,12,38,31,50,176,354,2012_Ian Mahinmi
2012,JaVale McGee,C,24,614,1104,0.5561594202898551,0,0,NaN,614,1104,0.5561594202898551,154,334,0.46107784431137727,326,628,954,62,70,264,174,332,1382,2012_JaVale McGee
2012,James Anderson,SG,22,66,174,0.3793103448275862,19,68,0.27941176470588236,47,106,0.44339622641509435,39,52,0.75,16,63,79,41,8,2,30,35,190,2012_James Anderson
2012,Jeremy Lin,PG,23,171,383,0.4464751958224543,24,75,0.32,147,308,0.4772727272727273,146,183,0.7978142076502732,18,89,107,216,55,9,126,78,512,2012_Jeremy Lin
2012,Johan Petro,C,26,109,260,0.41923076923076924,1,1,1.0,108,259,0.416988416988417,31,37,0.8378378378378378,68,156,224,45,21,23,38,122,250,2012_Johan Petro
2012,Kendrick Perkins,C,27,128,262,0.48854961832061067,0,0,NaN,128,262,0.48854961832061067,73,112,0.6517857142857143,120,306,426,78,25,73,118,189,329,2012_Kendrick Perkins
2012,Kris Humphries,PF,26,323,671,0.481371087928465,0,0,NaN,323,671,0.481371087928465,209,278,0.7517985611510791,233,448,681,90,50,74,119,173,855,2012_Kris Humphries
2012,Matt Bonner,PF,31,154,350,0.44,105,250,0.42,49,100,0.49,16,21,0.7619047619047619,29,185,214,61,15,21,14,68,429,2012_Matt Bonner
2012,Paul Millsap,PF,26,426,861,0.49477351916376305,7,31,0.22580645161290322,419,830,0.5048192771084338,202,255,0.792156862745098,180,383,563,150,118,52,112,222,1061,2012_Paul Millsap
2012,Renaldo Balkman,SF,27,16,32,0.5,2,9,0.2222222222222222,14,23,0.6086956521739131,8,11,0.7272727272727273,6,20,26,5,4,3,6,14,42,2012_Renaldo Balkman
2013,Anderson Varejao,C,30,138,289,0.47750865051903113,0,5,0.0,138,284,0.4859154929577465,77,102,0.7549019607843137,138,223,361,84,37,14,44,68,353,2013_Anderson Varejao
2013,Bismack Biyombo,C,20,156,346,0.4508670520231214,0,0,NaN,156,346,0.4508670520231214,74,142,0.5211267605633803,194,388,582,35,28,143,82,195,386,2013_Bismack Biyombo
2013,Ian Mahinmi,C,26,149,329,0.45288753799392095,0,2,0.0,149,327,0.45565749235474007,104,171,0.6081871345029239,115,196,311,27,39,66,92,201,402,2013_Ian Mahinmi
2013,Jared Cunningham,SG,21,6,14,0.42857142857142855,2,3,0.6666666666666666,4,11,0.36363636363636365,2,2,1.0,1,2,3,1,1,0,2,3,16,2013_Jared Cunningham
2013,Johan Petro,C,27,48,110,0.43636363636363634,1,4,0.25,47,106,0.44339622641509435,11,12,0.9166666666666666,33,79,112,16,10,9,24,48,108,2013_Johan Petro
2013,Matt Bonner,PF,32,112,230,0.48695652173913045,53,120,0.44166666666666665,59,110,0.5363636363636364,11,15,0.7333333333333333,25,104,129,36,17,19,16,86,288,2013_Matt Bonner
2013,Orlando Johnson,SG,23,72,180,0.4,36,94,0.3829787234042553,36,86,0.4186046511627907,23,32,0.71875,20,90,110,47,11,9,29,51,203,2013_Orlando Johnson
2013,Pablo Prigioni,PG,35,100,220,0.45454545454545453,53,134,0.39552238805970147,47,86,0.5465116279069767,22,25,0.88,41,102,143,236,69,2,86,127,275,2013_Pablo Prigioni
2014,Al Horford,C,27,238,420,0.5666666666666667,4,11,0.36363636363636365,234,409,0.5721271393643031,58,85,0.6823529411764706,66,178,244,76,27,44,64,56,538,2014_Al Horford
2014,Antawn Jamison,PF,37,29,92,0.31521739130434784,8,41,0.1951219512195122,21,51,0.4117647058823529,18,25,0.72,9,46,55,7,9,3,7,29,84,2014_Antawn Jamison
2014,Bismack Biyombo,C,21,88,144,0.6111111111111112,0,0,NaN,88,144,0.6111111111111112,46,89,0.5168539325842697,105,261,366,8,7,86,40,124,222,2014_Bismack Biyombo
2014,Brandon Rush,SG,28,30,90,0.3333333333333333,16,47,0.3404255319148936,14,43,0.32558139534883723,3,5,0.6,5,39,44,24,5,9,20,31,79,2014_Brandon Rush
2014,Devin Harris,PG,30,96,254,0.3779527559055118,31,101,0.3069306930693069,65,153,0.42483660130718953,92,115,0.8,8,77,85,178,28,2,59,72,315,2014_Devin Harris
2014,Dwight Buycks,PG,24,15,48,0.3125,5,17,0.29411764705882354,10,31,0.3225806451612903,8,9,0.8888888888888888,4,19,23,10,8,0,10,11,43,2014_Dwight Buycks
2014,Hamady N'Diaye,C,27,3,9,0.3333333333333333,0,0,NaN,3,9,0.3333333333333333,0,1,0.0,5,13,18,3,0,4,3,15,6,2014_Hamady N'Diaye
2014,Ian Mahinmi,C,27,91,189,0.48148148148148145,0,1,0.0,91,188,0.48404255319148937,90,145,0.6206896551724138,107,150,257,24,41,72,58,207,272,2014_Ian Mahinmi
2014,Josh Childress,SF,30,0,0,NaN,0,0,NaN,0,0,NaN,0,0,NaN,0,3,3,2,1,0,1,1,0,2014_Josh Childress
2014,Matt Bonner,PF,33,73,164,0.4451219512195122,42,98,0.42857142857142855,31,66,0.4696969696969697,9,12,0.75,16,114,130,31,15,11,16,49,197,2014_Matt Bonner
2014,Miroslav Raduljica,C,26,68,126,0.5396825396825397,0,0,NaN,68,126,0.5396825396825397,45,55,0.8181818181818182,54,54,108,23,7,13,28,84,181,2014_Miroslav Raduljica
2014,Orlando Johnson,SG,24,72,226,0.3185840707964602,18,94,0.19148936170212766,54,132,0.4090909090909091,38,52,0.7307692307692307,18,92,110,40,12,4,30,52,200,2014_Orlando Johnson
2014,Seth Curry,PG,23,2,6,0.3333333333333333,2,2,1.0,0,4,0.0,0,0,NaN,0,2,2,0,4,0,0,0,6,2014_Seth Curry
2014,Tiago Splitter,C,29,181,346,0.523121387283237,0,3,0.0,181,343,0.5276967930029155,121,173,0.6994219653179191,123,240,363,90,29,31,75,117,483,2014_Tiago Splitter
2014,Trey Burke,PG,21,341,897,0.3801560758082497,111,336,0.33035714285714285,230,561,0.40998217468805703,102,113,0.9026548672566371,37,171,208,396,42,6,131,145,895,2014_Trey Burke
2014,Vince Carter,SG,37,330,811,0.406905055487053,146,371,0.3935309973045822,184,440,0.41818181818181815,161,196,0.8214285714285714,67,217,284,212,61,35,108,209,967,2014_Vince Carter
2015,Bismack Biyombo,C,22,101,186,0.543010752688172,0,0,NaN,101,186,0.543010752688172,102,175,0.5828571428571429,159,248,407,16,18,99,52,140,304,2015_Bismack Biyombo
2015,Boris Diaw,PF,32,291,632,0.46044303797468356,54,169,0.31952662721893493,237,463,0.5118790496760259,72,93,0.7741935483870968,78,270,348,233,36,23,126,148,708,2015_Boris Diaw
2015,Dwight Buycks,PG,25,18,40,0.45,7,11,0.6363636363636364,11,29,0.3793103448275862,9,10,0.9,2,10,12,14,3,0,12,3,52,2015_Dwight Buycks
2015,Ian Mahinmi,C,28,117,212,0.5518867924528302,0,0,NaN,117,212,0.5518867924528302,31,102,0.30392156862745096,105,251,356,33,30,46,59,172,265,2015_Ian Mahinmi
2015,J.J. Hickson,C,26,218,459,0.4749455337690632,0,2,0.0,218,457,0.47702407002188185,116,201,0.5771144278606966,150,302,452,57,36,35,96,136,552,2015_J.J. Hickson
2015,James Harden,SG,25,647,1470,0.44013605442176873,208,555,0.3747747747747748,439,915,0.47978142076502733,715,824,0.8677184466019418,75,384,459,565,154,60,321,208,2217,2015_James Harden
2015,Kevin Love,PF,26,413,952,0.4338235294117647,144,392,0.3673469387755102,269,560,0.48035714285714287,258,321,0.8037383177570093,142,589,731,168,51,39,122,140,1228,2015_Kevin Love
2015,Kyle Singler,SF,26,344,892,0.38565022421524664,192,482,0.3983402489626556,152,410,0.37073170731707317,80,104,0.7692307692307693,66,322,388,170,94,42,110,306,960,2015_Kyle Singler
2015,Matt Bonner,PF,34,94,230,0.40869565217391307,46,126,0.36507936507936506,48,104,0.46153846153846156,30,37,0.8108108108108109,29,86,115,47,10,12,11,65,264,2015_Matt Bonner
2015,Shabazz Napier,PG,23,87,228,0.3815789473684211,43,118,0.3644067796610169,44,110,0.4,44,56,0.7857142857142857,17,96,113,130,40,4,81,76,261,2015_Shabazz Napier
2015,Tarik Black,C,23,314,546,0.575091575091575,0,2,0.0,314,544,0.5772058823529411,130,236,0.5508474576271186,284,452,736,84,38,48,96,316,758,2015_Tarik Black
2015,Timofey Mozgov,C,28,628,1132,0.5547703180212014,4,12,0.3333333333333333,624,1120,0.5571428571428572,310,432,0.7175925925925926,406,776,1182,110,66,194,232,454,1570,2015_Timofey Mozgov
2015,Tyler Ennis,PG,20,104,288,0.3611111111111111,24,86,0.27906976744186046,80,202,0.39603960396039606,10,14,0.7142857142857143,14,56,70,146,36,10,84,72,242,2015_Tyler Ennis
2016,Alec Burks,SG,24,137,334,0.4101796407185629,32,79,0.4050632911392405,105,255,0.4117647058823529,106,141,0.75177304964539,16,93,109,63,18,4,51,71,412,2016_Alec Burks
2016,Bismack Biyombo,C,23,156,288,0.5416666666666666,0,1,0.0,156,287,0.5435540069686411,142,226,0.6283185840707964,182,473,655,29,19,133,71,225,454,2016_Bismack Biyombo
2016,Corey Brewer,SF,29,212,552,0.38405797101449274,61,224,0.27232142857142855,151,328,0.4603658536585366,105,140,0.75,42,157,199,109,84,19,78,168,590,2016_Corey Brewer
2016,Ian Mahinmi,C,29,264,448,0.5892857142857143,0,0,NaN,264,448,0.5892857142857143,132,225,0.5866666666666667,138,369,507,104,65,75,100,220,660,2016_Ian Mahinmi
2016,JaKarr Sampson,SF,22,280,634,0.4416403785488959,28,126,0.2222222222222222,252,508,0.49606299212598426,160,244,0.6557377049180327,92,288,380,92,46,66,140,284,748,2016_JaKarr Sampson
2016,Justise Winslow,SF,19,195,462,0.42207792207792205,32,116,0.27586206896551724,163,346,0.47109826589595377,80,117,0.6837606837606838,81,322,403,117,68,26,95,184,502,2016_Justise Winslow
2016,Kenneth Faried,PF,26,349,626,0.5575079872204473,1,2,0.5,348,624,0.5576923076923077,136,222,0.6126126126126126,235,346,581,79,32,60,91,169,835,2016_Kenneth Faried
2016,LeBron James,SF,31,737,1416,0.5204802259887006,87,282,0.30851063829787234,650,1134,0.5731922398589065,359,491,0.7311608961303462,111,454,565,514,104,49,249,143,1920,2016_LeBron James
2016,Matt Bonner,C,35,29,57,0.5087719298245614,15,34,0.4411764705882353,14,23,0.6086956521739131,3,4,0.75,3,24,27,9,6,1,3,16,76,2016_Matt Bonner
2016,Nikola Pekovic,C,30,19,50,0.38,0,0,NaN,19,50,0.38,16,20,0.8,7,14,21,11,1,0,9,22,54,2016_Nikola Pekovic
2016,Norman Powell,SG,22,97,229,0.42358078602620086,36,89,0.4044943820224719,61,140,0.4357142857142857,43,53,0.8113207547169812,16,95,111,47,29,10,32,59,273,2016_Norman Powell
2016,Orlando Johnson,SG,26,18,68,0.2647058823529412,4,20,0.2,14,48,0.2916666666666667,12,16,0.75,8,22,30,4,6,6,8,18,52,2016_Orlando Johnson
2016,Tarik Black,C,24,57,104,0.5480769230769231,0,0,NaN,57,104,0.5480769230769231,19,45,0.4222222222222222,44,113,157,16,14,18,22,78,133,2016_Tarik Black
2016,Tony Snell,SF,24,126,339,0.37168141592920356,56,155,0.36129032258064514,70,184,0.3804347826086957,30,33,0.9090909090909091,19,180,199,63,16,17,52,100,338,2016_Tony Snell
2016,Tyler Ennis,PG,21,84,187,0.44919786096256686,13,39,0.3333333333333333,71,148,0.4797297297297297,25,34,0.7352941176470589,13,62,75,95,25,1,46,64,206,2016_Tyler Ennis
2016,Victor Oladipo,SG,23,425,970,0.4381443298969072,98,282,0.3475177304964539,327,688,0.4752906976744186,205,247,0.8299595141700404,48,297,345,282,116,54,153,174,1153,2016_Victor Oladipo
2017,Bismack Biyombo,C,24,179,339,0.528023598820059,0,0,NaN,179,339,0.528023598820059,125,234,0.5341880341880342,157,410,567,74,25,91,95,202,483,2017_Bismack Biyombo
2017,Bobby Brown,PG,32,23,60,0.38333333333333336,14,35,0.4,9,25,0.36,2,2,1.0,0,6,6,14,1,0,5,5,62,2017_Bobby Brown
2017,Demetrius Jackson,PG,22,3,4,0.75,1,1,1.0,2,3,0.6666666666666666,3,6,0.5,2,2,4,3,0,0,0,0,10,2017_Demetrius Jackson
2017,Mike Scott,PF,28,17,59,0.288135593220339,4,27,0.14814814814814814,13,32,0.40625,7,8,0.875,10,27,37,17,4,3,8,12,45,2017_Mike Scott
2017,Nene Hilario,C,34,245,397,0.6171284634760705,3,9,0.3333333333333333,242,388,0.6237113402061856,116,197,0.5888324873096447,95,186,281,65,56,40,73,163,609,2017_Nene Hilario
2017,Nerlens Noel,C,22,368,618,0.5954692556634305,0,2,0.0,368,616,0.5974025974025974,154,222,0.6936936936936937,186,402,588,100,130,102,102,252,890,2017_Nerlens Noel
2017,Norman Powell,SG,23,227,506,0.44861660079051385,56,173,0.3236994219653179,171,333,0.5135135135135135,126,159,0.7924528301886793,26,142,168,82,51,14,70,127,636,2017_Norman Powell
2017,Sam Dekker,SF,22,203,429,0.4731934731934732,60,187,0.32085561497326204,143,242,0.5909090909090909,38,68,0.5588235294117647,94,190,284,76,38,21,41,83,504,2017_Sam Dekker
2017,Tarik Black,C,25,150,294,0.5102040816326531,1,2,0.5,149,292,0.5102739726027398,82,109,0.7522935779816514,143,199,342,39,30,44,58,173,383,2017_Tarik Black
2017,Thon Maker,C,19,83,181,0.4585635359116022,28,74,0.3783783783783784,55,107,0.514018691588785,32,49,0.6530612244897959,40,74,114,23,10,26,17,84,226,2017_Thon Maker
2017,Tyler Ennis,PG,22,180,416,0.4326923076923077,54,140,0.38571428571428573,126,276,0.45652173913043476,42,50,0.84,20,72,92,172,52,4,90,116,456,2017_Tyler Ennis
2003,Aaron McKie,SF,30,286,666,0.4294294294294294,37,112,0.33035714285714285,249,554,0.44945848375451264,112,134,0.835820895522388,61,289,350,278,131,9,109,177,721,2003_Aaron McKie
2003,Brian Grant,C,30,344,676,0.5088757396449705,0,0,NaN,344,676,0.5088757396449705,158,205,0.7707317073170732,241,596,837,104,63,47,129,300,846,2003_Brian Grant
2003,Charlie Ward,PG,32,165,414,0.39855072463768115,101,267,0.3782771535580524,64,147,0.43537414965986393,41,53,0.7735849056603774,25,152,177,306,78,11,95,146,472,2003_Charlie Ward
2003,Damone Brown,PF,23,11,35,0.3142857142857143,0,2,0.0,11,33,0.3333333333333333,6,8,0.75,3,12,15,3,1,0,6,14,28,2003_Damone Brown
2003,Desmond Mason,SF,25,914,2034,0.44936086529006886,42,144,0.2916666666666667,872,1890,0.4613756613756614,424,566,0.7491166077738516,308,738,1046,326,134,64,230,420,2294,2003_Desmond Mason
2003,Dikembe Mutombo,C,36,49,131,0.37404580152671757,0,0,NaN,49,131,0.37404580152671757,40,55,0.7272727272727273,54,99,153,19,4,37,34,54,138,2003_Dikembe Mutombo
2003,Glenn Robinson,SF,30,539,1248,0.43189102564102566,90,263,0.34220532319391633,449,985,0.4558375634517767,268,306,0.8758169934640523,86,371,457,205,91,26,248,183,1436,2003_Glenn Robinson
2003,J.R. Bremer,PG,22,171,464,0.36853448275862066,101,286,0.3531468531468531,70,178,0.39325842696629215,85,111,0.7657657657657657,18,127,145,164,38,3,59,80,528,2003_J.R. Bremer
2003,Kwame Brown,C,20,224,502,0.44621513944223107,0,3,0.0,224,499,0.44889779559118237,145,217,0.6682027649769585,128,298,426,58,50,80,110,159,593,2003_Kwame Brown
2003,Michael Redd,SG,23,455,971,0.4685890834191555,182,416,0.4375,273,555,0.4918918918918919,149,185,0.8054054054054054,98,273,371,117,100,13,74,143,1241,2003_Michael Redd
2003,Predrag Drobnjak,C,27,325,789,0.41191381495564006,30,85,0.35294117647058826,295,704,0.4190340909090909,91,115,0.7913043478260869,111,209,320,86,48,38,65,180,771,2003_Predrag Drobnjak
2003,Rick Brunson,PG,30,23,50,0.46,4,6,0.6666666666666666,19,44,0.4318181818181818,10,12,0.8333333333333334,4,15,19,36,10,3,17,20,60,2003_Rick Brunson
2003,Vincent Yarbrough,SG,21,168,428,0.3925233644859813,21,78,0.2692307692307692,147,350,0.42,49,62,0.7903225806451613,36,126,162,130,57,33,81,145,406,2003_Vincent Yarbrough
2004,Aaron McKie,SF,31,265,577,0.4592720970537262,75,172,0.436046511627907,190,405,0.4691358024691358,84,111,0.7567567567567568,45,208,253,195,85,23,103,142,689,2004_Aaron McKie
2004,Alan Henderson,PF,31,10,21,0.47619047619047616,0,0,NaN,10,21,0.47619047619047616,4,6,0.6666666666666666,11,10,21,2,1,2,3,1,24,2004_Alan Henderson
2004,Alex Garcia,SG,23,1,7,0.14285714285714285,0,0,NaN,1,7,0.14285714285714285,1,2,0.5,0,0,0,0,2,0,1,0,3,2004_Alex Garcia
2004,Brian Grant,C,31,289,613,0.47145187601957583,0,1,0.0,289,612,0.4722222222222222,86,110,0.7818181818181819,174,350,524,69,51,35,82,254,664,2004_Brian Grant
2004,Desmond Mason,SF,26,409,867,0.4717416378316032,9,39,0.23076923076923078,400,828,0.4830917874396135,356,463,0.7688984881209503,93,266,359,152,60,24,148,191,1183,2004_Desmond Mason
2004,Dikembe Mutombo,C,37,141,295,0.47796610169491527,0,0,NaN,141,295,0.47796610169491527,81,119,0.680672268907563,145,292,437,25,17,123,54,141,363,2004_Dikembe Mutombo
2004,J.R. Bremer,PG,23,86,316,0.2721518987341772,38,148,0.25675675675675674,48,168,0.2857142857142857,26,40,0.65,18,54,72,102,36,8,48,64,236,2004_J.R. Bremer
2004,Jabari Smith,C,26,26,70,0.37142857142857144,0,3,0.0,26,67,0.3880597014925373,12,20,0.6,11,20,31,11,2,6,7,25,64,2004_Jabari Smith
2004,Jamal Sampson,C,20,11,23,0.4782608695652174,0,0,NaN,11,23,0.4782608695652174,7,12,0.5833333333333334,23,29,52,7,2,4,6,16,29,2004_Jamal Sampson
2004,Kwame Brown,PF,21,288,589,0.48896434634974534,1,2,0.5,287,587,0.4889267461669506,228,334,0.6826347305389222,178,372,550,112,66,52,140,144,805,2004_Kwame Brown
2004,Latrell Sprewell,SF,33,518,1266,0.40916271721958924,99,299,0.3311036789297659,419,967,0.4332988624612203,240,295,0.8135593220338984,56,254,310,286,88,21,158,101,1375,2004_Latrell Sprewell
2004,Lindsey Hunter,SG,33,49,143,0.34265734265734266,14,50,0.28,35,93,0.3763440860215054,5,8,0.625,13,54,67,85,39,6,34,45,117,2004_Lindsey Hunter
2004,Sasha Pavlovic,SF,20,149,376,0.3962765957446808,19,70,0.2714285714285714,130,306,0.42483660130718953,65,84,0.7738095238095238,44,115,159,60,41,16,67,187,382,2004_Sasha Pavlovic
2005,Aaron McKie,SG,32,61,142,0.4295774647887324,20,62,0.3225806451612903,41,80,0.5125,10,16,0.625,20,152,172,103,48,17,31,116,152,2005_Aaron McKie
2005,Adrian Griffin,SF,30,58,161,0.36024844720496896,2,9,0.2222222222222222,56,152,0.3684210526315789,33,44,0.75,52,94,146,53,43,4,30,78,151,2005_Adrian Griffin
2005,Alex Garcia,SG,24,18,52,0.34615384615384615,5,18,0.2777777777777778,13,34,0.38235294117647056,3,4,0.75,7,8,15,18,4,1,8,15,44,2005_Alex Garcia
2005,Anthony Carter,PG,29,72,177,0.4067796610169492,2,17,0.11764705882352941,70,160,0.4375,35,51,0.6862745098039216,12,57,69,161,35,18,62,88,181,2005_Anthony Carter
2005,Anthony Johnson,PG,30,203,456,0.4451754385964912,41,108,0.37962962962962965,162,348,0.46551724137931033,85,113,0.7522123893805309,32,147,179,302,59,15,96,144,532,2005_Anthony Johnson
2005,Brian Grant,C,32,103,209,0.49282296650717705,0,0,NaN,103,209,0.49282296650717705,57,79,0.7215189873417721,101,156,257,34,23,23,43,175,263,2005_Brian Grant
2005,Chauncey Billups,PG,28,404,913,0.4424972617743702,165,387,0.4263565891472868,239,526,0.4543726235741445,343,382,0.8979057591623036,48,223,271,464,81,9,180,194,1316,2005_Chauncey Billups
2005,Chris Bosh,PF,20,473,1005,0.47064676616915424,3,10,0.3,470,995,0.4723618090452261,412,542,0.7601476014760148,194,524,718,153,76,113,187,226,1361,2005_Chris Bosh
2005,Desmond Mason,SF,27,478,1079,0.44300278035217794,1,8,0.125,477,1071,0.44537815126050423,420,524,0.8015267175572519,85,227,312,217,58,27,164,198,1377,2005_Desmond Mason
2005,Dikembe Mutombo,C,38,108,217,0.4976958525345622,0,0,NaN,108,217,0.4976958525345622,106,143,0.7412587412587412,150,276,426,10,16,101,51,135,322,2005_Dikembe Mutombo
2005,Jamal Sampson,PF,21,28,62,0.45161290322580644,0,0,NaN,28,62,0.45161290322580644,23,39,0.5897435897435898,36,86,122,8,4,17,17,53,79,2005_Jamal Sampson
2005,Jerome James,C,29,174,342,0.5087719298245614,0,2,0.0,174,340,0.5117647058823529,47,65,0.7230769230769231,81,160,241,19,23,111,88,279,395,2005_Jerome James
2005,John Salmons,SG,25,85,210,0.40476190476190477,31,91,0.34065934065934067,54,119,0.453781512605042,35,48,0.7291666666666666,12,109,121,114,40,13,51,92,236,2005_John Salmons
2005,Kwame Brown,PF,22,109,237,0.459915611814346,0,0,NaN,109,237,0.459915611814346,74,129,0.5736434108527132,72,134,206,39,25,15,67,112,292,2005_Kwame Brown
2005,Luis Flores,PG,23,28,58,0.4827586206896552,10,20,0.5,18,38,0.47368421052631576,4,4,1.0,2,4,6,22,4,0,22,18,70,2005_Luis Flores
2005,Luke Ridnour,PG,23,299,739,0.40460081190798375,67,178,0.37640449438202245,232,561,0.41354723707664887,159,180,0.8833333333333333,55,149,204,483,94,23,149,185,824,2005_Luke Ridnour
2005,Othella Harrington,PF,31,217,424,0.5117924528301887,0,0,NaN,217,424,0.5117924528301887,127,177,0.7175141242937854,106,186,292,56,24,18,84,188,561,2005_Othella Harrington
2005,Quentin Richardson,SG,24,407,1045,0.3894736842105263,226,631,0.358161648177496,181,414,0.43719806763285024,136,184,0.7391304347826086,91,388,479,158,96,27,102,197,1176,2005_Quentin Richardson
2005,Richie Frahm,SG,27,56,140,0.4,31,80,0.3875,25,60,0.4166666666666667,21,25,0.84,17,44,61,30,15,4,14,35,164,2005_Richie Frahm
2005,Robert Swift,C,19,5,11,0.45454545454545453,0,0,NaN,5,11,0.45454545454545453,5,9,0.5555555555555556,1,4,5,2,1,7,4,16,15,2005_Robert Swift
2005,Viktor Khryapa,SF,22,54,124,0.43548387096774194,4,11,0.36363636363636365,50,113,0.4424778761061947,23,42,0.5476190476190477,28,80,108,25,20,18,33,80,135,2005_Viktor Khryapa
2006,Aaron McKie,PG,33,3,12,0.25,0,2,0.0,3,10,0.3,1,2,0.5,3,17,20,11,5,0,2,7,7,2006_Aaron McKie
2006,Andray Blatche,PF,19,26,67,0.3880597014925373,3,13,0.23076923076923078,23,54,0.42592592592592593,10,12,0.8333333333333334,12,26,38,10,5,7,12,36,65,2006_Andray Blatche
2006,Anthony Johnson,PG,31,267,603,0.4427860696517413,51,155,0.32903225806451614,216,448,0.48214285714285715,106,141,0.75177304964539,31,137,168,324,63,22,115,132,691,2006_Anthony Johnson
2006,Antoine Wright,SG,21,29,81,0.35802469135802467,1,15,0.06666666666666667,28,66,0.42424242424242425,11,22,0.5,8,22,30,12,4,3,21,42,70,2006_Antoine Wright
2006,Ben Gordon,SG,22,486,1152,0.421875,166,382,0.43455497382198954,320,770,0.4155844155844156,211,268,0.7873134328358209,43,176,219,240,75,5,180,238,1349,2006_Ben Gordon
2006,Brian Grant,C,33,27,65,0.4153846153846154,0,0,NaN,27,65,0.4153846153846154,7,8,0.875,11,46,57,7,5,3,7,45,61,2006_Brian Grant
2006,Darius Miles,SF,24,235,510,0.46078431372549017,2,10,0.2,233,500,0.466,87,163,0.5337423312883436,24,158,182,73,42,39,99,100,559,2006_Darius Miles
2006,Desmond Mason,SF,28,275,690,0.39855072463768115,1,6,0.16666666666666666,274,684,0.40058479532163743,206,302,0.6821192052980133,64,234,298,66,42,17,113,136,757,2006_Desmond Mason
2006,Dikembe Mutombo,C,39,50,95,0.5263157894736842,0,0,NaN,50,95,0.5263157894736842,69,91,0.7582417582417582,100,206,306,4,17,57,35,128,169,2006_Dikembe Mutombo
2006,Jamal Sampson,PF,22,5,7,0.7142857142857143,0,0,NaN,5,7,0.7142857142857143,0,2,0.0,5,13,18,5,0,4,0,5,10,2006_Jamal Sampson
2006,Kwame Brown,C,23,204,388,0.5257731958762887,0,1,0.0,204,387,0.5271317829457365,128,235,0.5446808510638298,182,291,473,72,27,46,100,196,536,2006_Kwame Brown
2006,Maciej Lampe,C,20,4,22,0.18181818181818182,0,0,NaN,4,22,0.18181818181818182,0,4,0.0,8,10,18,4,0,0,6,4,8,2006_Maciej Lampe
2006,Mark Madsen,C,30,27,66,0.4090909090909091,0,7,0.0,27,59,0.4576271186440678,20,47,0.425531914893617,50,91,141,11,23,17,26,114,74,2006_Mark Madsen
2006,Shandon Anderson,SF,32,54,126,0.42857142857142855,5,19,0.2631578947368421,49,107,0.45794392523364486,13,18,0.7222222222222222,18,63,81,30,17,6,24,75,126,2006_Shandon Anderson
2006,Shaquille O'Neal,C,33,480,800,0.6,0,0,NaN,480,800,0.6,221,471,0.4692144373673036,172,369,541,113,23,104,168,230,1181,2006_Shaquille O'Neal
2006,Tony Allen,PG,24,129,274,0.4708029197080292,11,34,0.3235294117647059,118,240,0.49166666666666664,100,134,0.746268656716418,32,79,111,67,51,18,67,126,369,2006_Tony Allen
2007,Aaron McKie,SF,34,11,17,0.6470588235294118,0,0,NaN,11,17,0.6470588235294118,0,0,NaN,1,17,18,13,4,0,8,14,22,2007_Aaron McKie
2007,Anthony Johnson,PG,32,284,686,0.4139941690962099,50,146,0.3424657534246575,234,540,0.43333333333333335,92,122,0.7540983606557377,44,158,202,402,66,6,152,238,710,2007_Anthony Johnson
2007,Derek Fisher,SG,32,258,675,0.38222222222222224,48,156,0.3076923076923077,210,519,0.4046242774566474,262,307,0.8534201954397395,30,119,149,274,83,6,120,234,826,2007_Derek Fisher
2007,Desmond Mason,SF,29,407,900,0.45222222222222225,0,0,NaN,407,900,0.45222222222222225,214,323,0.6625386996904025,124,221,345,115,52,22,192,174,1028,2007_Desmond Mason
2007,Dijon Thompson,SF,23,6,15,0.4,0,2,0.0,6,13,0.46153846153846156,5,6,0.8333333333333334,3,5,8,2,0,0,1,2,17,2007_Dijon Thompson
2007,Emeka Okafor,C,24,394,740,0.5324324324324324,0,0,NaN,394,740,0.5324324324324324,175,295,0.5932203389830508,258,499,757,80,57,172,111,210,963,2007_Emeka Okafor
2007,Jamal Sampson,C,23,9,14,0.6428571428571429,0,1,0.0,9,13,0.6923076923076923,6,14,0.42857142857142855,15,33,48,5,2,7,10,17,24,2007_Jamal Sampson
2007,James Augustine,PF,22,1,3,0.3333333333333333,0,0,NaN,1,3,0.3333333333333333,0,0,NaN,1,2,3,2,0,0,0,2,2,2007_James Augustine
2007,Jeremy Richardson,SF_SG_SG-SF,22,6,12,0.5,4,6,0.6666666666666666,2,6,0.3333333333333333,0,0,NaN,2,2,4,0,2,0,2,4,16,2007_Jeremy Richardson
2007,Kendrick Perkins,C,22,132,269,0.49070631970260226,0,3,0.0,132,266,0.49624060150375937,60,100,0.6,113,259,372,94,23,96,113,214,324,2007_Kendrick Perkins
2007,Kris Humphries,PF,21,87,185,0.4702702702702703,0,0,NaN,87,185,0.4702702702702703,53,79,0.6708860759493671,78,109,187,18,14,21,32,98,227,2007_Kris Humphries
2007,Kwame Brown,C,24,143,242,0.5909090909090909,0,1,0.0,143,241,0.5933609958506224,59,134,0.44029850746268656,81,163,244,75,39,49,76,124,345,2007_Kwame Brown
2007,Lynn Greer,SG,27,61,141,0.4326241134751773,18,52,0.34615384615384615,43,89,0.48314606741573035,27,32,0.84375,2,25,27,53,17,1,18,32,167,2007_Lynn Greer
2007,Mark Madsen,C,31,23,43,0.5348837209302325,0,0,NaN,23,43,0.5348837209302325,15,29,0.5172413793103449,35,52,87,10,10,10,21,100,61,2007_Mark Madsen
2007,Paul Millsap,PF,21,209,398,0.5251256281407035,1,3,0.3333333333333333,208,395,0.5265822784810127,140,208,0.6730769230769231,183,240,423,62,67,74,94,236,559,2007_Paul Millsap
2007,Salim Stoudamire,SG,24,177,425,0.4164705882352941,56,155,0.36129032258064514,121,270,0.44814814814814813,61,68,0.8970588235294118,6,68,74,61,21,2,55,88,471,2007_Salim Stoudamire
2008,Anthony Johnson,PG,33,310,710,0.43661971830985913,84,186,0.45161290322580644,226,524,0.4312977099236641,70,86,0.813953488372093,44,230,274,524,104,18,168,230,774,2008_Anthony Johnson
2008,Casey Jacobsen,SG,26,39,115,0.3391304347826087,16,72,0.2222222222222222,23,43,0.5348837209302325,13,17,0.7647058823529411,12,53,65,20,5,1,16,34,107,2008_Casey Jacobsen
2008,James Augustine,PF,23,18,34,0.5294117647058824,0,0,NaN,18,34,0.5294117647058824,4,8,0.5,16,14,30,2,5,2,6,18,40,2008_James Augustine
2008,Jeremy Richardson,SF_SG_SG-SF,23,32,88,0.36363636363636365,14,38,0.3684210526315789,18,50,0.36,4,4,1.0,2,16,18,4,6,0,12,26,82,2008_Jeremy Richardson
2008,Kwame Brown,C,25,144,284,0.5070422535211268,0,0,NaN,144,284,0.5070422535211268,80,196,0.40816326530612246,102,274,376,90,44,46,102,164,368,2008_Kwame Brown
2008,Mark Madsen,PF,32,3,19,0.15789473684210525,0,0,NaN,3,19,0.15789473684210525,3,12,0.25,18,20,38,4,3,2,9,25,9,2008_Mark Madsen
2008,Orien Greene,SG,25,3,11,0.2727272727272727,0,1,0.0,3,10,0.3,0,0,NaN,0,6,6,3,3,1,7,9,6,2008_Orien Greene
2008,Robert Horry,PF,37,38,119,0.31932773109243695,18,70,0.2571428571428571,20,49,0.40816326530612246,18,28,0.6428571428571429,35,74,109,47,21,19,22,55,112,2008_Robert Horry
2008,Wally Szczerbiak,SF,30,622,1444,0.4307479224376731,180,436,0.41284403669724773,442,1008,0.4384920634920635,298,350,0.8514285714285714,68,366,434,208,46,24,152,206,1722,2008_Wally Szczerbiak
2009,Al Horford,C,22,312,594,0.5252525252525253,0,1,0.0,312,593,0.5261382799325464,149,205,0.7268292682926829,145,479,624,163,53,95,103,190,773,2009_Al Horford
2009,Antawn Jamison,PF,32,674,1441,0.4677307425399028,112,319,0.3510971786833856,562,1122,0.5008912655971479,341,452,0.754424778761062,196,525,721,153,95,25,125,218,1801,2009_Antawn Jamison
2009,Anthony Johnson,PG,34,154,381,0.4041994750656168,52,133,0.39097744360902253,102,248,0.4112903225806452,61,81,0.7530864197530864,29,118,147,200,46,5,82,111,421,2009_Anthony Johnson
2009,Brandon Rush,SG,23,243,575,0.4226086956521739,78,209,0.37320574162679426,165,366,0.45081967213114754,46,66,0.696969696969697,34,199,233,66,38,37,75,128,610,2009_Brandon Rush
2009,Brook Lopez,C,20,448,844,0.5308056872037915,0,2,0.0,448,842,0.5320665083135392,172,217,0.7926267281105991,225,440,665,86,44,151,147,257,1068,2009_Brook Lopez
2009,Delonte West,SG,25,285,624,0.4567307692307692,91,228,0.3991228070175439,194,396,0.4898989898989899,90,108,0.8333333333333334,31,172,203,226,94,13,92,125,751,2009_Delonte West
2009,Hamed Haddadi,C,23,15,31,0.4838709677419355,0,0,NaN,15,31,0.4838709677419355,18,30,0.6,16,31,47,8,1,12,9,20,48,2009_Hamed Haddadi
2009,Jeremy Richardson,SF,24,14,49,0.2857142857142857,6,17,0.35294117647058826,8,32,0.25,3,6,0.5,1,13,14,3,0,0,3,6,37,2009_Jeremy Richardson
2009,Josh Boone,C,24,113,214,0.5280373831775701,0,0,NaN,113,214,0.5280373831775701,32,85,0.3764705882352941,104,154,258,31,22,48,31,106,258,2009_Josh Boone
2009,Kwame Brown,C,26,90,169,0.5325443786982249,0,0,NaN,90,169,0.5325443786982249,63,122,0.5163934426229508,91,199,290,32,24,24,50,138,243,2009_Kwame Brown
2009,Mark Madsen,C,33,3,14,0.21428571428571427,0,0,NaN,3,14,0.21428571428571427,0,4,0.0,10,8,18,4,1,1,3,18,6,2009_Mark Madsen
2009,Vince Carter,SG,32,588,1345,0.43717472118959105,151,392,0.3852040816326531,437,953,0.45855194123819515,335,410,0.8170731707317073,74,336,410,376,82,38,166,234,1662,2009_Vince Carter
2010,Andrea Bargnani,PF,24,537,1143,0.46981627296587924,121,325,0.3723076923076923,416,818,0.508557457212714,181,234,0.7735042735042735,105,388,493,93,25,111,120,215,1376,2010_Andrea Bargnani
2010,Boris Diaw,PF,27,373,773,0.48253557567917205,66,206,0.32038834951456313,307,567,0.5414462081128748,113,147,0.7687074829931972,131,293,424,325,60,57,178,219,925,2010_Boris Diaw
2010,Coby Karl,SF_SG_SF-SG,26,22,64,0.34375,4,22,0.18181818181818182,18,42,0.42857142857142855,8,12,0.6666666666666666,8,28,36,30,6,2,20,28,56,2010_Coby Karl
2010,Desmond Mason,SF,32,5,12,0.4166666666666667,0,0,NaN,5,12,0.4166666666666667,3,4,0.75,4,9,13,2,1,1,4,5,13,2010_Desmond Mason
2010,Earl Clark,PF,22,56,151,0.3708609271523179,2,5,0.4,54,146,0.3698630136986301,26,36,0.7222222222222222,18,44,62,21,7,13,23,25,140,2010_Earl Clark
2010,James Singleton,SF_PF_PF-SF,28,194,508,0.38188976377952755,14,74,0.1891891891891892,180,434,0.4147465437788018,106,124,0.8548387096774194,216,336,552,62,56,86,98,226,508,2010_James Singleton
2010,Jonny Flynn,PG,20,397,952,0.4170168067226891,77,215,0.3581395348837209,320,737,0.43419267299864317,223,270,0.825925925925926,24,167,191,356,82,2,233,98,1094,2010_Jonny Flynn
2010,Juwan Howard,C,36,191,375,0.5093333333333333,0,1,0.0,191,374,0.5106951871657754,55,70,0.7857142857142857,108,227,335,61,27,10,72,191,437,2010_Juwan Howard
2010,Marcus Camby,C_PF_PF-C,35,476,1002,0.4750499001996008,4,14,0.2857142857142857,472,988,0.4777327935222672,156,244,0.639344262295082,498,1244,1742,372,190,292,182,322,1112,2010_Marcus Camby
2010,Mike Harris,PF,26,22,60,0.36666666666666664,0,2,0.0,22,58,0.3793103448275862,14,22,0.6363636363636364,20,28,48,6,10,2,18,28,58,2010_Mike Harris
2010,Mo Williams,PG,27,378,855,0.4421052631578947,159,371,0.42857142857142855,219,484,0.4524793388429752,177,198,0.8939393939393939,28,178,206,368,70,21,173,170,1092,2010_Mo Williams
2010,Rafer Alston,PG,33,310,892,0.3475336322869955,116,336,0.34523809523809523,194,556,0.3489208633093525,118,162,0.7283950617283951,26,232,258,352,100,20,190,206,854,2010_Rafer Alston
2010,Richard Hamilton,SG,31,293,717,0.4086471408647141,41,138,0.2971014492753623,252,579,0.43523316062176165,204,241,0.8464730290456431,30,92,122,202,30,3,115,115,831,2010_Richard Hamilton
2010,Rudy Fernandez,SG,24,160,423,0.37825059101654845,98,266,0.3684210526315789,62,157,0.39490445859872614,85,98,0.8673469387755102,35,129,164,127,62,11,72,87,503,2010_Rudy Fernandez
2010,Tayshaun Prince,SF,29,282,580,0.4862068965517241,27,73,0.3698630136986301,255,507,0.5029585798816568,70,98,0.7142857142857143,71,177,248,161,34,22,60,77,661,2010_Tayshaun Prince
2011,Andrea Bargnani,C,25,525,1173,0.4475703324808184,77,223,0.3452914798206278,448,950,0.47157894736842104,287,350,0.82,74,269,343,119,34,46,152,160,1414,2011_Andrea Bargnani
2011,Caron Butler,SF,30,170,378,0.4497354497354497,28,65,0.4307692307692308,142,313,0.4536741214057508,68,88,0.7727272727272727,22,96,118,46,28,8,49,59,436,2011_Caron Butler
2011,Eric Bledsoe,PG,21,206,486,0.42386831275720166,32,116,0.27586206896551724,174,370,0.4702702702702703,99,133,0.7443609022556391,68,155,223,289,92,26,194,130,543,2011_Eric Bledsoe
2011,Jawad Williams,SF,27,41,126,0.3253968253968254,13,45,0.28888888888888886,28,81,0.345679012345679,9,12,0.75,7,41,48,22,9,3,16,34,104,2011_Jawad Williams
2011,Jonny Flynn,PG,21,108,296,0.36486486486486486,31,100,0.31,77,196,0.39285714285714285,32,42,0.7619047619047619,12,65,77,182,34,3,113,58,279,2011_Jonny Flynn
2011,LeBron James,SF,26,758,1485,0.5104377104377105,92,279,0.32974910394265233,666,1206,0.5522388059701493,503,663,0.7586726998491704,80,510,590,554,124,50,284,163,2111,2011_LeBron James
2011,Matt Carroll,SG,30,89,199,0.4472361809045226,17,46,0.3695652173913043,72,153,0.47058823529411764,40,52,0.7692307692307693,12,56,68,23,17,6,23,43,235,2011_Matt Carroll
2011,Mike Harris,PF,27,3,6,0.5,0,0,NaN,3,6,0.5,2,4,0.5,2,3,5,1,0,1,1,2,8,2011_Mike Harris
2011,Mo Williams,PG,28,582,1460,0.39863013698630134,158,488,0.3237704918032787,424,972,0.43621399176954734,302,354,0.8531073446327684,42,264,306,760,106,20,342,300,1624,2011_Mo Williams
2011,Nikola Pekovic,C,25,136,263,0.5171102661596958,0,0,NaN,136,263,0.5171102661596958,87,114,0.7631578947368421,90,103,193,27,18,35,91,181,359,2011_Nikola Pekovic
2011,Shawn Marion,SF,32,434,834,0.5203836930455635,5,33,0.15151515151515152,429,801,0.5355805243445693,126,164,0.7682926829268293,168,383,551,110,68,50,130,144,999,2011_Shawn Marion
2011,Tyreke Evans,SG,21,382,933,0.40943193997856375,43,148,0.2905405405405405,339,785,0.4318471337579618,205,266,0.7706766917293233,46,229,275,319,85,30,184,143,1012,2011_Tyreke Evans
2012,Andrea Bargnani,C,26,209,484,0.4318181818181818,34,115,0.2956521739130435,175,369,0.4742547425474255,151,173,0.8728323699421965,24,148,172,61,18,15,69,52,603,2012_Andrea Bargnani
2012,Blake Ahearn,PG,27,4,14,0.2857142857142857,2,9,0.2222222222222222,2,5,0.4,0,0,NaN,0,2,2,1,0,0,5,4,10,2012_Blake Ahearn
2012,Brandon Knight,PG,20,319,769,0.41482444733420026,105,276,0.3804347826086957,214,493,0.4340770791075051,104,137,0.7591240875912408,33,178,211,251,49,10,171,154,847,2012_Brandon Knight
2012,DeMarcus Cousins,C,21,448,999,0.44844844844844844,2,14,0.14285714285714285,446,985,0.4527918781725888,262,373,0.7024128686327078,265,438,703,102,93,75,170,257,1160,2012_DeMarcus Cousins
2012,Eduardo Najera,PF,35,24,64,0.375,8,29,0.27586206896551724,16,35,0.45714285714285713,2,4,0.5,11,39,50,12,19,4,7,40,58,2012_Eduardo Najera
2012,Elliot Williams,SG,22,37,74,0.5,8,27,0.2962962962962963,29,47,0.6170212765957447,6,18,0.3333333333333333,7,12,19,6,6,3,5,18,88,2012_Elliot Williams
2012,Jared Jeffries,PF,30,59,144,0.4097222222222222,3,16,0.1875,56,128,0.4375,49,72,0.6805555555555556,69,83,152,26,29,25,29,89,170,2012_Jared Jeffries
2012,Jonny Flynn,PG,22,92,262,0.3511450381679389,20,68,0.29411764705882354,72,194,0.3711340206185567,58,78,0.7435897435897436,16,62,78,192,12,4,72,46,262,2012_Jonny Flynn
2012,Julyan Stone,SG,23,13,31,0.41935483870967744,2,11,0.18181818181818182,11,20,0.55,8,11,0.7272727272727273,5,20,25,37,8,6,11,18,36,2012_Julyan Stone
2012,Luis Scola,PF,31,436,888,0.49099099099099097,0,3,0.0,436,885,0.49265536723163844,153,198,0.7727272727272727,122,306,428,140,35,24,153,214,1025,2012_Luis Scola
2012,Mo Williams,SG,29,260,611,0.425531914893617,93,239,0.3891213389121339,167,372,0.4489247311827957,72,80,0.9,23,76,99,160,51,7,86,103,685,2012_Mo Williams
2012,Nene Hilario,C,29,422,786,0.5368956743002544,0,8,0.0,422,778,0.5424164524421594,226,336,0.6726190476190477,126,456,582,160,84,76,192,190,1070,2012_Nene Hilario
2012,Tobias Harris,SF,19,79,169,0.46745562130177515,6,23,0.2608695652173913,73,146,0.5,44,54,0.8148148148148148,30,71,101,22,13,7,31,45,208,2012_Tobias Harris
2013,Andrea Bargnani,PF,27,170,426,0.39906103286384975,38,123,0.3089430894308943,132,303,0.43564356435643564,65,77,0.8441558441558441,26,102,128,38,21,23,54,64,443,2013_Andrea Bargnani
2013,C.J. Miles,SF,25,255,614,0.4153094462540717,126,328,0.38414634146341464,129,286,0.45104895104895104,93,107,0.8691588785046729,24,150,174,63,49,17,69,138,729,2013_C.J. Miles
2013,Darius Johnson-Odom,SG,23,0,4,0.0,0,1,0.0,0,3,0.0,0,0,NaN,1,3,4,1,0,0,0,0,0,2013_Darius Johnson-Odom
2013,Festus Ezeli,C,23,74,169,0.4378698224852071,0,0,NaN,74,169,0.4378698224852071,43,81,0.5308641975308642,141,172,313,22,23,74,63,157,191,2013_Festus Ezeli
2013,Jarrett Jack,SG,29,387,857,0.4515752625437573,82,203,0.4039408866995074,305,654,0.46636085626911317,167,198,0.8434343434343434,21,222,243,439,60,11,157,134,1023,2013_Jarrett Jack
2013,Keith Bogans,SG,32,108,284,0.38028169014084506,84,245,0.34285714285714286,24,39,0.6153846153846154,11,17,0.6470588235294118,16,104,120,76,28,4,49,108,311,2013_Keith Bogans
2013,Kwame Brown,C,30,17,37,0.4594594594594595,0,0,NaN,17,37,0.4594594594594595,7,19,0.3684210526315789,23,51,74,9,6,10,8,37,41,2013_Kwame Brown
2013,Lamar Odom,PF,33,146,366,0.3989071038251366,18,90,0.2,128,276,0.463768115942029,20,42,0.47619047619047616,117,363,480,142,69,58,86,214,330,2013_Lamar Odom
2014,Aaron Gray,C,29,54,122,0.4426229508196721,0,2,0.0,54,120,0.45,22,40,0.55,84,138,222,44,20,16,62,128,130,2014_Aaron Gray
2014,Andrea Bargnani,C,28,222,502,0.44223107569721115,30,108,0.2777777777777778,192,394,0.4873096446700508,84,102,0.8235294117647058,69,153,222,45,14,52,58,100,558,2014_Andrea Bargnani
2014,Anthony Morrow,SG,28,238,520,0.4576923076923077,88,195,0.4512820512820513,150,325,0.46153846153846156,72,87,0.8275862068965517,29,111,140,59,38,12,51,102,636,2014_Anthony Morrow
2014,Chris Paul,PG,28,406,870,0.4666666666666667,78,212,0.36792452830188677,328,658,0.49848024316109424,295,345,0.855072463768116,38,230,268,663,154,4,145,157,1185,2014_Chris Paul
2014,Chris Wright,SF,25,21,35,0.6,0,1,0.0,21,34,0.6176470588235294,6,15,0.4,10,10,20,5,7,5,5,17,48,2014_Chris Wright
2014,Darius Johnson-Odom,SG,24,0,7,0.0,0,3,0.0,0,4,0.0,0,2,0.0,0,2,2,1,1,0,2,3,0,2014_Darius Johnson-Odom
2014,Diante Garrett,PG,25,101,265,0.38113207547169814,36,96,0.375,65,169,0.38461538461538464,10,12,0.8333333333333334,11,86,97,120,41,5,75,75,248,2014_Diante Garrett
2014,Elliot Williams,SG,24,140,337,0.41543026706231456,37,125,0.296,103,212,0.4858490566037736,87,119,0.7310924369747899,30,100,130,72,35,3,68,126,404,2014_Elliot Williams
2014,Glen Davis,PF,28,542,1186,0.45699831365935917,8,22,0.36363636363636365,534,1164,0.4587628865979381,190,274,0.6934306569343066,216,486,702,154,116,58,152,318,1282,2014_Glen Davis
2014,Isaiah Canaan,PG,22,31,87,0.3563218390804598,18,55,0.32727272727272727,13,32,0.40625,21,29,0.7241379310344828,7,17,24,22,8,4,21,25,101,2014_Isaiah Canaan
2014,Jeremy Evans,SF,26,175,332,0.5271084337349398,0,2,0.0,175,330,0.5303030303030303,51,75,0.68,120,190,310,44,42,46,40,139,401,2014_Jeremy Evans
2014,Luke Babbitt,PF,24,60,154,0.38961038961038963,36,95,0.37894736842105264,24,59,0.4067796610169492,14,18,0.7777777777777778,18,70,88,29,7,11,15,52,170,2014_Luke Babbitt
2014,Ricky Ledo,SG,21,6,17,0.35294117647058826,3,8,0.375,3,9,0.3333333333333333,4,4,1.0,0,2,2,2,1,0,2,2,19,2014_Ricky Ledo
2014,Thaddeus Young,PF,25,582,1283,0.45362431800467656,90,292,0.3082191780821918,492,991,0.496468213925328,163,229,0.7117903930131004,166,310,476,182,167,36,165,213,1417,2014_Thaddeus Young
2014,Tony Wroten,PG,20,345,808,0.42698019801980197,40,188,0.2127659574468085,305,620,0.49193548387096775,209,326,0.6411042944785276,69,159,228,217,78,16,204,151,939,2014_Tony Wroten
2014,Trevor Ariza,SF,28,389,853,0.45603751465416176,180,442,0.4072398190045249,209,411,0.5085158150851582,149,193,0.772020725388601,99,376,475,191,126,20,132,179,1107,2014_Trevor Ariza
2015,Andrea Bargnani,C,29,164,361,0.45429362880886426,15,41,0.36585365853658536,149,320,0.465625,87,107,0.8130841121495327,32,95,127,46,2,27,42,53,430,2015_Andrea Bargnani
2015,Brandan Wright,PF,27,466,726,0.6418732782369146,0,6,0.0,466,720,0.6472222222222223,156,224,0.6964285714285714,256,386,642,82,100,188,68,204,1088,2015_Brandan Wright
2015,Charlie Villanueva,PF,30,150,362,0.4143646408839779,83,221,0.3755656108597285,67,141,0.475177304964539,20,35,0.5714285714285714,30,119,149,19,15,22,28,64,403,2015_Charlie Villanueva
2015,Chase Budinger,SF,26,169,390,0.43333333333333335,52,143,0.36363636363636365,117,247,0.47368421052631576,67,81,0.8271604938271605,33,165,198,64,44,10,49,72,457,2015_Chase Budinger
2015,Elliot Williams,SG,25,28,74,0.3783783783783784,16,36,0.4444444444444444,12,38,0.3157894736842105,2,8,0.25,0,16,16,24,8,0,8,24,74,2015_Elliot Williams
2015,Gary Harris,SG,20,66,217,0.30414746543778803,21,103,0.20388349514563106,45,114,0.39473684210526316,35,47,0.7446808510638298,21,43,64,29,39,7,38,71,188,2015_Gary Harris
2015,Gary Neal,SG,30,376,1006,0.37375745526838966,100,328,0.3048780487804878,276,678,0.40707964601769914,234,270,0.8666666666666667,28,230,258,200,46,2,130,176,1086,2015_Gary Neal
2015,Isaiah Canaan,PG,23,292,756,0.3862433862433862,182,492,0.3699186991869919,110,264,0.4166666666666667,98,120,0.8166666666666667,36,138,174,196,58,6,124,166,864,2015_Isaiah Canaan
2015,Jared Dudley,SG,29,198,423,0.46808510638297873,74,192,0.3854166666666667,124,231,0.5367965367965368,48,67,0.7164179104477612,45,175,220,130,72,11,62,113,518,2015_Jared Dudley
2015,Kalin Lucas,PG,25,0,1,0.0,0,0,NaN,0,1,0.0,0,0,NaN,0,0,0,0,1,0,0,1,0,2015_Kalin Lucas
2015,Shayne Whittington,PF,23,19,42,0.4523809523809524,1,6,0.16666666666666666,18,36,0.5,18,23,0.782608695652174,10,19,29,6,5,2,5,18,57,2015_Shayne Whittington
2015,Tony Wroten,PG,21,175,434,0.4032258064516129,37,142,0.2605633802816901,138,292,0.4726027397260274,120,180,0.6666666666666666,22,64,86,157,48,8,113,72,507,2015_Tony Wroten
2016,Bruno Caboclo,SF,20,1,12,0.08333333333333333,1,7,0.14285714285714285,0,5,0.0,0,0,NaN,1,1,2,1,2,1,4,2,3,2016_Bruno Caboclo
2016,Chris Bosh,PF,31,358,767,0.4667535853976532,81,222,0.36486486486486486,277,545,0.5082568807339449,213,268,0.7947761194029851,48,342,390,128,36,34,78,101,1010,2016_Chris Bosh
2016,Elliot Williams,PG,26,2,10,0.2,1,4,0.25,1,6,0.16666666666666666,3,4,0.75,1,3,4,4,0,0,1,2,8,2016_Elliot Williams
2016,Gary Harris,SG,21,359,765,0.469281045751634,105,297,0.35353535353535354,254,468,0.5427350427350427,109,133,0.8195488721804511,54,166,220,147,97,18,98,143,932,2016_Gary Harris
2016,Gary Neal,SG,31,151,325,0.4646153846153846,41,100,0.41,110,225,0.4888888888888889,47,55,0.8545454545454545,11,72,83,47,20,1,29,55,390,2016_Gary Neal
2016,Greg Smith,PF,25,18,32,0.5625,0,0,NaN,18,32,0.5625,7,17,0.4117647058823529,12,30,42,6,4,1,7,28,43,2016_Greg Smith
2016,Isaiah Canaan,SG,24,260,722,0.3601108033240997,176,485,0.3628865979381443,84,237,0.35443037974683544,150,180,0.8333333333333334,20,154,174,137,56,12,91,133,846,2016_Isaiah Canaan
2016,Jrue Holiday,PG,25,410,935,0.4385026737967914,87,259,0.3359073359073359,323,676,0.47781065088757396,182,216,0.8425925925925926,27,168,195,391,88,22,167,148,1089,2016_Jrue Holiday
2016,Luis Montero,SG,22,5,19,0.2631578947368421,1,9,0.1111111111111111,4,10,0.4,3,4,0.75,0,4,4,1,0,0,4,1,14,2016_Luis Montero
2016,Marcus Smart,PG,21,184,529,0.34782608695652173,61,241,0.25311203319502074,123,288,0.4270833333333333,129,166,0.7771084337349398,76,179,255,185,91,18,80,183,558,2016_Marcus Smart
2016,Tony Wroten,PG,22,22,65,0.3384615384615385,3,17,0.17647058823529413,19,48,0.3958333333333333,20,37,0.5405405405405406,2,19,21,20,3,0,29,11,67,2016_Tony Wroten
2017,Brandon Ingram,SF,19,276,686,0.40233236151603496,55,187,0.29411764705882354,221,499,0.44288577154308617,133,214,0.6214953271028038,60,257,317,166,50,36,116,158,740,2017_Brandon Ingram
2017,Brice Johnson,PF,22,2,7,0.2857142857142857,0,0,NaN,2,7,0.2857142857142857,0,0,NaN,1,2,3,1,2,1,1,0,4,2017_Brice Johnson
2017,Bruno Caboclo,SF,21,6,16,0.375,2,6,0.3333333333333333,4,10,0.4,0,0,NaN,5,5,10,4,2,1,2,4,14,2017_Bruno Caboclo
2017,Danilo Gallinari,SF,28,335,750,0.44666666666666666,126,324,0.3888888888888889,209,426,0.49061032863849763,349,387,0.9018087855297158,39,287,326,135,40,15,81,93,1145,2017_Danilo Gallinari
2017,Davis Bertans,PF,24,103,234,0.44017094017094016,69,173,0.3988439306358382,34,61,0.5573770491803278,28,34,0.8235294117647058,22,77,99,46,20,28,32,75,303,2017_Davis Bertans
2017,Elijah Millsap,SG,29,1,7,0.14285714285714285,0,2,0.0,1,5,0.2,1,2,0.5,3,3,6,1,0,0,2,2,3,2017_Elijah Millsap
2017,Gary Harris,SG,22,320,637,0.5023547880690737,107,255,0.4196078431372549,213,382,0.5575916230366492,104,134,0.7761194029850746,48,130,178,164,71,8,76,92,851,2017_Gary Harris
2017,Gary Neal,SG,32,0,7,0.0,0,2,0.0,0,5,0.0,4,4,1.0,0,1,1,1,0,0,0,1,4,2017_Gary Neal
2017,Henry Ellenson,PF,20,23,64,0.359375,10,35,0.2857142857142857,13,29,0.4482758620689655,4,8,0.5,8,33,41,7,1,1,14,6,60,2017_Henry Ellenson
2017,Isaiah Canaan,SG,25,63,173,0.36416184971098264,25,94,0.26595744680851063,38,79,0.4810126582278481,30,33,0.9090909090909091,6,43,49,37,22,1,20,35,181,2017_Isaiah Canaan
2017,Joel Bolomboy,PF,23,9,16,0.5625,1,4,0.25,8,12,0.6666666666666666,3,6,0.5,4,13,17,2,1,2,2,1,22,2017_Joel Bolomboy
2017,Josh McRoberts,PF,29,44,118,0.3728813559322034,13,31,0.41935483870967744,31,87,0.3563218390804598,6,9,0.6666666666666666,23,51,74,50,10,4,23,31,107,2017_Josh McRoberts
2017,Lance Stephenson,SG,26,108,240,0.45,12,40,0.3,96,200,0.48,16,26,0.6153846153846154,8,96,104,118,10,6,52,64,244,2017_Lance Stephenson
2017,Nik Stauskas,SG,23,251,634,0.39589905362776023,132,359,0.36768802228412256,119,275,0.43272727272727274,122,150,0.8133333333333334,21,205,226,188,45,32,128,144,756,2017_Nik Stauskas
2017,Patricio Garino,SG,23,0,7,0.0,0,5,0.0,0,2,0.0,0,0,NaN,1,6,7,0,0,0,3,4,0,2017_Patricio Garino
2017,Rodney Stuckey,PG,30,91,244,0.3729508196721312,19,60,0.31666666666666665,72,184,0.391304347826087,80,107,0.7476635514018691,6,78,84,84,16,0,53,44,281,2017_Rodney Stuckey
2017,Tony Allen,SG,35,274,595,0.46050420168067224,15,54,0.2777777777777778,259,541,0.4787430683918669,80,130,0.6153846153846154,166,225,391,98,115,29,100,178,643,2017_Tony Allen
2017,Tyler Ulis,PG,21,184,437,0.42105263157894735,21,79,0.26582278481012656,163,358,0.4553072625698324,55,71,0.7746478873239436,20,75,95,226,48,5,77,73,444,2017_Tyler Ulis
2003,Austin Croshere,PF,27,86,209,0.41148325358851673,27,69,0.391304347826087,59,140,0.42142857142857143,53,65,0.8153846153846154,40,115,155,56,6,13,28,48,252,2003_Austin Croshere
2003,Bostjan Nachbar,SF,22,11,31,0.3548387096774194,2,10,0.2,9,21,0.42857142857142855,5,10,0.5,3,8,11,3,2,2,6,13,29,2003_Bostjan Nachbar
2003,Brendan Haywood,C,23,173,339,0.5103244837758112,0,0,NaN,173,339,0.5103244837758112,155,245,0.6326530612244898,192,212,404,29,32,119,65,225,501,2003_Brendan Haywood
2003,Clifford Robinson,PF,36,372,935,0.39786096256684494,87,259,0.3359073359073359,285,676,0.42159763313609466,161,238,0.6764705882352942,81,237,318,268,87,88,158,259,992,2003_Clifford Robinson
2003,Eric Piatkowski,SG,32,210,446,0.47085201793721976,80,201,0.39800995024875624,130,245,0.5306122448979592,101,122,0.8278688524590164,44,112,156,70,33,9,56,92,601,2003_Eric Piatkowski
2003,Guy Rucker,PF,25,0,0,NaN,0,0,NaN,0,0,NaN,0,0,NaN,0,1,1,1,0,0,0,1,0,2003_Guy Rucker
2003,Joseph Forte,SG,21,10,35,0.2857142857142857,0,3,0.0,10,32,0.3125,4,6,0.6666666666666666,4,7,11,11,4,0,10,6,24,2003_Joseph Forte
2003,Mark Blount,C,27,300,694,0.4322766570605187,0,0,NaN,300,694,0.4322766570605187,202,278,0.7266187050359713,222,394,616,112,84,136,206,374,802,2003_Mark Blount
2003,Mateen Cleaves,PG,25,6,23,0.2608695652173913,1,1,1.0,5,22,0.22727272727272727,3,4,0.75,1,7,8,10,2,0,14,6,16,2003_Mateen Cleaves
2003,Steve Francis,PG,25,571,1312,0.43521341463414637,85,240,0.3541666666666667,486,1072,0.4533582089552239,476,595,0.8,159,340,499,502,141,41,299,251,1703,2003_Steve Francis
2003,Tierre Brown,PG,23,27,59,0.4576271186440678,0,1,0.0,27,58,0.46551724137931033,11,14,0.7857142857142857,8,22,30,39,13,0,22,9,65,2003_Tierre Brown
2003,Toni Kukoc,PF,34,249,577,0.43154246100519933,95,263,0.3612167300380228,154,314,0.49044585987261147,137,194,0.7061855670103093,67,199,266,230,81,29,122,134,730,2003_Toni Kukoc
2003,Wally Szczerbiak,SF,25,351,729,0.48148148148148145,61,145,0.4206896551724138,290,584,0.4965753424657534,150,173,0.8670520231213873,53,188,241,136,44,22,87,123,913,2003_Wally Szczerbiak
2004,Antawn Jamison,SF,27,488,913,0.5345016429353778,16,40,0.4,472,873,0.5406643757159221,220,294,0.7482993197278912,233,287,520,70,83,30,81,174,1212,2004_Antawn Jamison
2004,Austin Croshere,PF,28,119,307,0.38762214983713356,56,144,0.3888888888888889,63,163,0.38650306748466257,93,104,0.8942307692307693,60,183,243,52,24,14,55,101,387,2004_Austin Croshere
2004,Bostjan Nachbar,SF,23,47,132,0.3560606060606061,23,63,0.36507936507936506,24,69,0.34782608695652173,21,29,0.7241379310344828,8,62,70,30,14,14,23,72,138,2004_Bostjan Nachbar
2004,Brendan Haywood,C,24,200,388,0.5154639175257731,0,1,0.0,200,387,0.5167958656330749,137,234,0.5854700854700855,186,201,387,43,32,100,80,154,537,2004_Brendan Haywood
2004,Cezary Trybanski,C,24,0,8,0.0,0,0,NaN,0,8,0.0,2,4,0.5,0,2,2,0,2,2,4,6,2,2004_Cezary Trybanski
2004,Clifford Robinson,PF,37,366,945,0.3873015873015873,112,314,0.35668789808917195,254,631,0.40253565768621236,123,173,0.7109826589595376,54,268,322,271,68,73,173,237,967,2004_Clifford Robinson
2004,Eric Piatkowski,SF,33,72,191,0.3769633507853403,43,122,0.3524590163934426,29,69,0.42028985507246375,14,16,0.875,10,63,73,26,16,5,29,42,201,2004_Eric Piatkowski
2004,Jerome Williams,PF,30,316,672,0.47023809523809523,0,16,0.0,316,656,0.4817073170731707,212,310,0.6838709677419355,354,596,950,144,180,16,148,268,844,2004_Jerome Williams
2004,Mark Blount,C,28,342,604,0.5662251655629139,0,0,NaN,342,604,0.5662251655629139,159,221,0.7194570135746606,207,382,589,75,80,106,150,253,843,2004_Mark Blount
2004,Robert Archibald,C_PF_C-PF,23,18,66,0.2727272727272727,0,0,NaN,18,66,0.2727272727272727,28,62,0.45161290322580644,42,62,104,26,28,6,20,100,64,2004_Robert Archibald
2004,Stanislav Medvedenko,PF,24,237,537,0.441340782122905,0,3,0.0,237,534,0.4438202247191011,89,116,0.7672413793103449,148,195,343,57,38,18,59,191,563,2004_Stanislav Medvedenko
2004,Steve Blake,PG,23,157,407,0.3857493857493858,75,202,0.3712871287128713,82,205,0.4,55,67,0.8208955223880597,18,99,117,209,57,7,128,100,444,2004_Steve Blake
2004,Steve Francis,PG,26,450,1117,0.40286481647269473,73,250,0.292,377,867,0.4348327566320646,337,435,0.774712643678161,116,317,433,493,139,35,294,257,1310,2004_Steve Francis
2004,Torraye Braggs,PF,27,32,66,0.48484848484848486,0,0,NaN,32,66,0.48484848484848486,16,24,0.6666666666666666,36,42,78,14,8,4,26,58,80,2004_Torraye Braggs
2004,Vince Carter,SG,27,608,1457,0.4172958133150309,93,243,0.38271604938271603,515,1214,0.4242174629324547,336,417,0.8057553956834532,95,254,349,348,88,65,223,212,1645,2004_Vince Carter
2004,Zeljko Rebraca,C,31,68,154,0.44155844155844154,0,0,NaN,68,154,0.44155844155844154,46,60,0.7666666666666667,46,70,116,12,10,22,34,104,182,2004_Zeljko Rebraca
2005,Anthony Goldwire,PG,33,114,272,0.41911764705882354,64,160,0.4,50,112,0.44642857142857145,52,62,0.8387096774193549,20,98,118,156,30,0,30,64,344,2005_Anthony Goldwire
2005,Austin Croshere,PF,29,188,497,0.3782696177062374,45,174,0.25862068965517243,143,323,0.44272445820433437,226,256,0.8828125,103,272,375,98,48,17,104,154,647,2005_Austin Croshere
2005,Boris Diaw,SG,22,124,294,0.4217687074829932,9,50,0.18,115,244,0.4713114754098361,57,77,0.7402597402597403,54,116,170,149,37,18,87,123,314,2005_Boris Diaw
2005,Bostjan Nachbar,SF_PF_PF-SF,24,322,822,0.39172749391727496,150,392,0.3826530612244898,172,430,0.4,194,234,0.8290598290598291,48,316,364,148,58,32,146,366,988,2005_Bostjan Nachbar
2005,Brendan Haywood,C,25,239,427,0.5597189695550351,0,0,NaN,239,427,0.5597189695550351,159,261,0.6091954022988506,202,262,464,57,52,114,96,218,637,2005_Brendan Haywood
2005,Clifford Robinson,C_PF_C-PF,38,404,1046,0.3862332695984704,134,386,0.3471502590673575,270,660,0.4090909090909091,124,194,0.6391752577319587,108,310,418,208,124,106,132,362,1066,2005_Clifford Robinson
2005,Dan Dickau,PG,26,612,1512,0.40476190476190477,170,490,0.3469387755102041,442,1022,0.4324853228962818,380,456,0.8333333333333334,68,292,360,694,152,8,290,402,1774,2005_Dan Dickau
2005,Eric Piatkowski,SG,34,111,258,0.43023255813953487,57,134,0.4253731343283582,54,124,0.43548387096774194,45,56,0.8035714285714286,15,64,79,51,29,1,37,67,324,2005_Eric Piatkowski
2005,Jerome Williams,SF,31,122,243,0.5020576131687243,0,5,0.0,122,238,0.5126050420168067,115,172,0.6686046511627907,115,168,283,41,55,10,65,155,359,2005_Jerome Williams
2005,Juwan Howard,PF,31,244,541,0.4510166358595194,0,1,0.0,244,540,0.45185185185185184,97,115,0.8434782608695652,126,220,346,94,32,5,79,143,585,2005_Juwan Howard
2005,Marcus Camby,C,30,279,600,0.465,0,4,0.0,279,596,0.46812080536912754,125,173,0.7225433526011561,131,530,661,152,61,199,103,177,683,2005_Marcus Camby
2005,Mark Blount,C,29,327,618,0.529126213592233,0,1,0.0,327,617,0.5299837925445705,117,164,0.7134146341463414,143,254,397,129,33,64,158,229,771,2005_Mark Blount
2005,Steve Blake,PG,24,61,186,0.3279569892473118,36,93,0.3870967741935484,25,93,0.26881720430107525,33,41,0.8048780487804879,18,53,71,69,13,0,39,47,191,2005_Steve Blake
2005,Steve Francis,PG,27,563,1330,0.42330827067669174,38,127,0.2992125984251969,525,1203,0.43640897755610975,499,606,0.8234323432343235,126,324,450,547,112,28,317,273,1663,2005_Steve Francis
2005,Yao Ming,C,24,538,975,0.5517948717948717,0,0,NaN,538,975,0.5517948717948717,389,497,0.7826961770623743,208,461,669,61,34,160,196,298,1465,2005_Yao Ming
2006,Bostjan Nachbar,SF_PF_PF-SF,25,108,312,0.34615384615384615,38,142,0.2676056338028169,70,170,0.4117647058823529,60,88,0.6818181818181818,16,104,120,54,32,10,48,130,314,2006_Bostjan Nachbar
2006,Brendan Haywood,C,26,222,432,0.5138888888888888,0,0,NaN,222,432,0.5138888888888888,131,224,0.5848214285714286,200,267,467,46,30,104,97,232,575,2006_Brendan Haywood
2006,Charlie Bell,SG,26,180,410,0.43902439024390244,71,168,0.4226190476190476,109,242,0.45041322314049587,63,89,0.7078651685393258,21,99,120,130,59,5,41,126,494,2006_Charlie Bell
2006,Clifford Robinson,PF,39,219,513,0.4269005847953216,60,175,0.34285714285714286,159,338,0.47041420118343197,52,79,0.6582278481012658,55,212,267,89,44,40,62,206,550,2006_Clifford Robinson
2006,Corliss Williamson,SF,32,43,103,0.4174757281553398,2,2,1.0,41,101,0.40594059405940597,38,49,0.7755102040816326,21,46,67,14,7,4,30,56,126,2006_Corliss Williamson
2006,David Harrison,C,23,148,294,0.5034013605442177,0,0,NaN,148,294,0.5034013605442177,89,174,0.5114942528735632,84,170,254,14,23,59,79,193,385,2006_David Harrison
2006,Eric Piatkowski,SG,35,24,61,0.39344262295081966,9,33,0.2727272727272727,15,28,0.5357142857142857,2,5,0.4,4,19,23,13,6,1,11,20,59,2006_Eric Piatkowski
2006,LeBron James,SF,21,875,1823,0.4799780581459133,127,379,0.33509234828496043,748,1444,0.518005540166205,601,814,0.7383292383292384,75,481,556,521,123,66,260,181,2478,2006_LeBron James
2006,Lonny Baxter,C_PF_C-PF,27,90,208,0.4326923076923077,0,0,NaN,90,208,0.4326923076923077,56,70,0.8,90,144,234,8,22,16,40,112,236,2006_Lonny Baxter
2006,Steve Blake,PG,25,206,470,0.43829787234042555,76,184,0.41304347826086957,130,286,0.45454545454545453,72,91,0.7912087912087912,26,120,146,306,42,5,83,107,560,2006_Steve Blake
2006,Steve Francis,PG-SG_SG_PG,28,666,1530,0.43529411764705883,50,166,0.30120481927710846,616,1364,0.45161290322580644,628,798,0.7869674185463659,148,432,580,690,148,34,428,408,2010,2006_Steve Francis
2007,Bostjan Nachbar,SF,26,226,495,0.45656565656565656,112,265,0.4226415094339623,114,230,0.4956521739130435,132,164,0.8048780487804879,27,226,253,61,30,26,69,183,696,2007_Bostjan Nachbar
2007,Brendan Haywood,C,27,198,355,0.5577464788732395,0,0,NaN,198,355,0.5577464788732395,115,210,0.5476190476190477,195,282,477,47,34,88,90,208,511,2007_Brendan Haywood
2007,Daniel Ewing,PG,23,65,161,0.40372670807453415,14,44,0.3181818181818182,51,117,0.4358974358974359,35,45,0.7777777777777778,9,64,73,90,32,4,50,62,179,2007_Daniel Ewing
2007,Eduardo Najera,PF,30,204,354,0.576271186440678,1,12,0.08333333333333333,203,342,0.5935672514619883,88,123,0.7154471544715447,131,179,310,64,73,26,56,207,497,2007_Eduardo Najera
2007,Eric Piatkowski,SG,36,9,25,0.36,7,18,0.3888888888888889,2,7,0.2857142857142857,2,2,1.0,2,7,9,4,0,1,5,6,27,2007_Eric Piatkowski
2007,Michael Finley,SF,33,273,663,0.4117647058823529,104,286,0.36363636363636365,169,377,0.4482758620689655,90,98,0.9183673469387755,34,189,223,108,32,16,46,76,740,2007_Michael Finley
2007,Michael Olowokandi,C,31,19,46,0.41304347826086957,0,0,NaN,19,46,0.41304347826086957,2,3,0.6666666666666666,14,34,48,5,8,13,17,48,40,2007_Michael Olowokandi
2007,Nene Hilario,C,24,294,516,0.5697674418604651,0,1,0.0,294,515,0.570873786407767,195,283,0.6890459363957597,150,299,449,77,62,59,127,209,783,2007_Nene Hilario
2007,Raja Bell,SG,30,410,950,0.43157894736842106,205,496,0.41330645161290325,205,454,0.45154185022026433,118,152,0.7763157894736842,48,203,251,196,50,22,83,233,1143,2007_Raja Bell
2007,Steve Blake,PG,26,418,1018,0.4106090373280943,134,416,0.32211538461538464,284,602,0.4717607973421927,86,128,0.671875,42,296,338,816,122,16,258,242,1056,2007_Steve Blake
2007,Steve Francis,SG,29,140,343,0.40816326530612246,42,111,0.3783783783783784,98,232,0.4224137931034483,175,211,0.8293838862559242,33,124,157,170,41,12,100,126,497,2007_Steve Francis
2007,Willie Green,SG,25,357,868,0.4112903225806452,51,157,0.3248407643312102,306,711,0.43037974683544306,74,111,0.6666666666666666,42,116,158,112,56,4,106,144,839,2007_Willie Green
2008,Bostjan Nachbar,PF,27,245,609,0.40229885057471265,94,262,0.35877862595419846,151,347,0.43515850144092216,154,196,0.7857142857142857,56,204,260,88,44,21,85,182,738,2008_Bostjan Nachbar
2008,Brendan Haywood,C,28,316,599,0.5275459098497496,0,0,NaN,316,599,0.5275459098497496,216,294,0.7346938775510204,273,303,576,71,31,133,108,216,848,2008_Brendan Haywood
2008,C.J. Miles,SG,20,113,236,0.4788135593220339,30,77,0.38961038961038963,83,159,0.5220125786163522,41,52,0.7884615384615384,16,62,78,53,32,8,27,98,297,2008_C.J. Miles
2008,Dan Gadzuric,C,29,64,154,0.4155844155844156,0,1,0.0,64,153,0.41830065359477125,33,63,0.5238095238095238,67,77,144,11,20,24,34,83,161,2008_Dan Gadzuric
2008,Eric Piatkowski,SF,37,12,33,0.36363636363636365,11,26,0.4230769230769231,1,7,0.14285714285714285,4,4,1.0,1,11,12,10,0,1,6,11,39,2008_Eric Piatkowski
2008,Greg Buckner,SG,31,45,117,0.38461538461538464,15,50,0.3,30,67,0.44776119402985076,19,22,0.8636363636363636,10,55,65,39,21,2,29,63,124,2008_Greg Buckner
2008,Jamario Moon,SF,27,279,575,0.4852173913043478,40,122,0.32786885245901637,239,453,0.5275938189845475,63,85,0.7411764705882353,92,392,484,90,80,108,51,152,661,2008_Jamario Moon
2008,Jarrett Jack,SG,24,267,620,0.4306451612903226,65,190,0.34210526315789475,202,430,0.4697674418604651,215,248,0.8669354838709677,31,203,234,313,61,1,178,129,814,2008_Jarrett Jack
2008,Jarvis Hayes,SF,26,217,504,0.4305555555555556,73,194,0.37628865979381443,144,310,0.4645161290322581,45,60,0.75,35,143,178,62,47,6,47,137,552,2008_Jarvis Hayes
2008,Jason Smith,PF,21,141,310,0.45483870967741935,4,14,0.2857142857142857,137,296,0.46283783783783783,54,82,0.6585365853658537,77,153,230,20,22,50,48,142,340,2008_Jason Smith
2008,Juan Carlos,SG,27,308,766,0.402088772845953,156,432,0.3611111111111111,152,334,0.4550898203592814,124,146,0.8493150684931506,34,176,210,177,48,1,134,94,896,2008_Juan Carlos
2008,Quinton Ross,SG,26,131,335,0.39104477611940297,9,21,0.42857142857142855,122,314,0.3885350318471338,40,60,0.6666666666666666,54,118,172,88,43,33,29,132,311,2008_Quinton Ross
2008,Raja Bell,SG,31,317,753,0.4209827357237716,176,439,0.4009111617312073,141,314,0.44904458598726116,79,91,0.8681318681318682,47,227,274,168,54,27,65,220,889,2008_Raja Bell
2008,Sergio Rodriguez,PG,21,69,196,0.3520408163265306,17,58,0.29310344827586204,52,138,0.37681159420289856,25,38,0.6578947368421053,13,45,58,123,24,0,53,57,180,2008_Sergio Rodriguez
2008,Stephane Lasme,SF_PF_PF-SF,25,64,142,0.4507042253521127,0,0,NaN,64,142,0.4507042253521127,38,64,0.59375,52,54,106,6,26,44,30,70,166,2008_Stephane Lasme
2008,Steve Blake,PG,27,261,640,0.4078125,121,298,0.40604026845637586,140,342,0.4093567251461988,49,64,0.765625,31,164,195,413,55,4,113,133,692,2008_Steve Blake
2008,Tim Thomas,PF,30,291,705,0.4127659574468085,83,271,0.3062730627306273,208,434,0.4792626728110599,115,153,0.7516339869281046,62,261,323,171,40,29,98,192,780,2008_Tim Thomas
2009,Aaron Gray,C,24,81,167,0.48502994011976047,0,1,0.0,81,166,0.4879518072289157,34,59,0.576271186440678,84,136,220,46,14,18,40,135,196,2009_Aaron Gray
2009,Alex Acker,SG,26,60,152,0.39473684210526316,14,40,0.35,46,112,0.4107142857142857,10,20,0.5,16,32,48,24,10,8,14,18,144,2009_Alex Acker
2009,Anthony Morrow,SG,23,255,534,0.47752808988764045,86,184,0.4673913043478261,169,350,0.4828571428571429,80,92,0.8695652173913043,78,121,199,80,36,12,52,130,676,2009_Anthony Morrow
2009,Brendan Haywood,C,29,24,50,0.48,0,0,NaN,24,50,0.48,10,21,0.47619047619047616,13,31,44,8,4,15,9,14,58,2009_Brendan Haywood
2009,Chris Paul,PG,23,631,1255,0.502788844621514,64,176,0.36363636363636365,567,1079,0.5254865616311399,455,524,0.8683206106870229,69,363,432,861,216,10,231,212,1781,2009_Chris Paul
2009,Daequan Cook,SF,21,242,645,0.3751937984496124,153,395,0.38734177215189874,89,250,0.356,49,56,0.875,19,170,189,71,39,10,42,125,686,2009_Daequan Cook
2009,Darnell Jackson,PF,23,37,86,0.43023255813953487,0,2,0.0,37,84,0.44047619047619047,24,35,0.6857142857142857,32,55,87,8,10,4,14,77,98,2009_Darnell Jackson
2009,Donte Greene,SF,20,77,236,0.326271186440678,26,100,0.26,51,136,0.375,29,34,0.8529411764705882,19,67,86,30,16,14,37,68,209,2009_Donte Greene
2009,Glen Davis,C,23,199,450,0.44222222222222224,2,5,0.4,197,445,0.44269662921348313,130,178,0.7303370786516854,121,180,301,69,53,19,71,230,530,2009_Glen Davis
2009,Raja Bell,SG,32,598,1368,0.4371345029239766,228,542,0.42066420664206644,370,826,0.44794188861985473,174,204,0.8529411764705882,82,404,486,284,100,16,172,332,1598,2009_Raja Bell
2009,Steve Blake,PG,28,277,647,0.4281298299845441,140,328,0.4268292682926829,137,319,0.42946708463949845,63,75,0.84,28,145,173,348,69,4,108,126,757,2009_Steve Blake
2009,Thaddeus Young,PF,20,475,960,0.4947916666666667,56,164,0.34146341463414637,419,796,0.5263819095477387,139,189,0.7354497354497355,139,238,377,86,100,23,118,165,1145,2009_Thaddeus Young
2009,Trevor Ariza,SF,23,274,596,0.4597315436241611,61,191,0.3193717277486911,213,405,0.5259259259259259,120,169,0.7100591715976331,111,241,352,145,137,24,87,166,729,2009_Trevor Ariza
2010,Alonzo Gee,SG,22,28,59,0.4745762711864407,7,9,0.7777777777777778,21,50,0.42,18,29,0.6206896551724138,15,18,33,7,7,1,10,13,81,2010_Alonzo Gee
2010,Brendan Haywood,C,30,552,982,0.5621181262729125,0,2,0.0,552,980,0.563265306122449,304,490,0.6204081632653061,556,874,1430,86,52,316,198,418,1408,2010_Brendan Haywood
2010,Brian Scalabrine,PF,31,29,85,0.3411764705882353,16,49,0.32653061224489793,13,36,0.3611111111111111,4,6,0.6666666666666666,9,39,48,27,9,4,17,59,78,2010_Brian Scalabrine
2010,Carlos Delfino,SF,27,299,732,0.40846994535519127,134,365,0.36712328767123287,165,367,0.44959128065395093,93,119,0.7815126050420168,51,343,394,202,80,21,119,138,825,2010_Carlos Delfino
2010,Charlie Villanueva,PF,25,363,827,0.43893591293833134,99,282,0.35106382978723405,264,545,0.48440366972477067,106,130,0.8153846153846154,85,280,365,53,48,55,74,223,931,2010_Charlie Villanueva
2010,Chris Duhon,PG,27,168,451,0.37250554323725055,90,258,0.3488372093023256,78,193,0.40414507772020725,68,95,0.7157894736842105,28,150,178,378,59,3,110,83,494,2010_Chris Duhon
2010,Chris Hunter,C,25,109,217,0.5023041474654378,0,4,0.0,109,213,0.5117370892018779,52,69,0.7536231884057971,56,111,167,37,13,35,30,132,270,2010_Chris Hunter
2010,DeMar DeRozan,SG,20,255,512,0.498046875,4,16,0.25,251,496,0.5060483870967742,148,194,0.7628865979381443,66,157,223,53,43,18,62,176,662,2010_DeMar DeRozan
2010,J.R. Giddens,SF,24,56,120,0.4666666666666667,0,20,0.0,56,100,0.56,26,46,0.5652173913043478,32,70,102,26,18,4,34,58,138,2010_J.R. Giddens
2010,JamesOn Curry,PG,24,0,0,NaN,0,0,NaN,0,0,NaN,0,0,NaN,0,0,0,0,0,0,0,0,0,2010_JamesOn Curry
2010,Kenny Thomas,PF,32,17,35,0.4857142857142857,0,0,NaN,17,35,0.4857142857142857,7,12,0.5833333333333334,35,51,86,15,10,10,17,42,41,2010_Kenny Thomas
2010,Kevin Durant,SF,21,794,1668,0.47601918465227816,128,351,0.3646723646723647,666,1317,0.5056947608200456,756,840,0.9,105,518,623,231,112,84,271,171,2472,2010_Kevin Durant
2010,Kevin Ollie,PG,37,18,45,0.4,0,1,0.0,18,44,0.4090909090909091,8,8,1.0,3,22,25,20,9,0,6,16,44,2010_Kevin Ollie
2010,Kyle Korver,SG,28,138,280,0.4928571428571429,59,110,0.5363636363636364,79,170,0.4647058823529412,39,49,0.7959183673469388,10,101,111,89,26,12,42,76,374,2010_Kyle Korver
2010,Kyle Weaver,SG,23,12,33,0.36363636363636365,7,19,0.3684210526315789,5,14,0.35714285714285715,5,6,0.8333333333333334,1,17,18,11,6,6,4,13,36,2010_Kyle Weaver
2010,Lindsey Hunter,PG,39,5,30,0.16666666666666666,1,13,0.07692307692307693,4,17,0.23529411764705882,2,2,1.0,1,13,14,9,1,0,4,12,13,2010_Lindsey Hunter
2010,Mike Conley,PG,22,369,830,0.44457831325301206,82,212,0.3867924528301887,287,618,0.46440129449838186,139,187,0.7433155080213903,30,161,191,425,109,12,170,178,959,2010_Mike Conley
2010,Ryan Bowen,SF,34,1,1,1.0,0,0,NaN,1,1,1.0,2,2,1.0,1,1,2,0,1,0,0,2,4,2010_Ryan Bowen
2010,Sasha Pavlovic,SF,26,109,300,0.36333333333333334,35,118,0.2966101694915254,74,182,0.4065934065934066,10,26,0.38461538461538464,12,105,117,58,23,6,53,84,263,2010_Sasha Pavlovic
2010,Troy Murphy,PF,29,384,813,0.47232472324723246,128,333,0.3843843843843844,256,480,0.5333333333333333,154,193,0.7979274611398963,129,608,737,150,72,34,100,175,1050,2010_Troy Murphy
2010,Zach Randolph,PF,28,652,1336,0.4880239520958084,15,52,0.28846153846153844,637,1284,0.4961059190031153,362,465,0.7784946236559139,330,620,950,149,80,34,174,226,1681,2010_Zach Randolph
2011,Brandon Jennings,PG,21,361,926,0.3898488120950324,98,303,0.3234323432343234,263,623,0.42215088282504015,199,246,0.8089430894308943,42,192,234,305,95,21,146,131,1019,2011_Brandon Jennings
2011,Brendan Haywood,C,31,128,223,0.5739910313901345,0,1,0.0,128,222,0.5765765765765766,64,177,0.3615819209039548,129,247,376,19,16,74,51,146,320,2011_Brendan Haywood
2011,Chris Bosh,PF,26,524,1056,0.4962121212121212,6,25,0.24,518,1031,0.5024248302618817,384,471,0.8152866242038217,141,500,641,144,59,49,138,172,1438,2011_Chris Bosh
2011,Chris Duhon,PG,28,49,129,0.3798449612403101,13,52,0.25,36,77,0.4675324675324675,14,25,0.56,9,43,52,118,16,2,61,30,125,2011_Chris Duhon
2011,David Andersen,PF,30,112,242,0.4628099173553719,16,46,0.34782608695652173,96,196,0.4897959183673469,28,44,0.6363636363636364,40,128,168,26,10,18,44,80,268,2011_David Andersen
2011,DeMar DeRozan,SG,21,539,1154,0.46707105719237435,5,52,0.09615384615384616,534,1102,0.484573502722323,327,402,0.8134328358208955,75,240,315,148,85,31,144,217,1410,2011_DeMar DeRozan
2011,Hassan Whiteside,C,21,0,0,NaN,0,0,NaN,0,0,NaN,0,0,NaN,0,0,0,0,0,0,0,2,0,2011_Hassan Whiteside
2011,Joel Przybilla,C,31,50,88,0.5681818181818182,0,0,NaN,50,88,0.5681818181818182,28,54,0.5185185185185185,74,216,290,26,10,30,58,158,128,2011_Joel Przybilla
2011,Kyle Korver,SG,29,242,557,0.43447037701974867,120,289,0.41522491349480967,122,268,0.4552238805970149,77,87,0.8850574712643678,12,138,150,124,35,20,60,156,681,2011_Kyle Korver
2011,Kyle Weaver,SG,24,9,25,0.36,3,7,0.42857142857142855,6,18,0.3333333333333333,7,8,0.875,2,8,10,7,2,2,7,3,28,2011_Kyle Weaver
2011,Landry Fields,SG,22,299,602,0.49667774086378735,86,219,0.3926940639269406,213,383,0.556135770234987,113,147,0.7687074829931972,105,416,521,155,80,17,107,114,797,2011_Landry Fields
2011,Luke Ridnour,PG,29,319,681,0.4684287812041116,81,184,0.44021739130434784,238,497,0.4788732394366197,121,137,0.8832116788321168,37,162,199,384,89,10,158,146,840,2011_Luke Ridnour
2011,Mario West,SG,26,9,21,0.42857142857142855,1,4,0.25,8,17,0.47058823529411764,3,5,0.6,2,9,11,10,7,0,2,13,22,2011_Mario West
2011,Mike Conley,PG,23,423,953,0.4438614900314795,80,217,0.3686635944700461,343,736,0.46603260869565216,181,247,0.7327935222672065,32,215,247,528,144,18,176,182,1107,2011_Mike Conley
2011,Omer Asik,C,24,78,141,0.5531914893617021,0,0,NaN,78,141,0.5531914893617021,73,145,0.503448275862069,112,194,306,32,20,56,64,153,229,2011_Omer Asik
2011,Reggie Evans,PF,30,42,103,0.4077669902912621,0,1,0.0,42,102,0.4117647058823529,48,88,0.5454545454545454,119,226,345,38,29,6,39,89,132,2011_Reggie Evans
2011,Steve Blake,PG,30,110,306,0.35947712418300654,73,193,0.37823834196891193,37,113,0.3274336283185841,26,30,0.8666666666666667,19,137,156,170,40,3,73,99,319,2011_Steve Blake
2011,Zach Randolph,PF,29,598,1188,0.5033670033670034,8,43,0.18604651162790697,590,1145,0.5152838427947598,300,396,0.7575757575757576,326,588,914,163,63,25,151,175,1504,2011_Zach Randolph
2012,Ben Gordon,SG,28,234,530,0.44150943396226416,63,147,0.42857142857142855,171,383,0.4464751958224543,117,136,0.8602941176470589,14,107,121,127,34,11,115,114,648,2012_Ben Gordon
2012,Brendan Haywood,C,32,118,228,0.5175438596491229,0,0,NaN,118,228,0.5175438596491229,45,96,0.46875,139,185,324,19,24,54,46,121,281,2012_Brendan Haywood
2012,Chandler Parsons,SF,23,248,549,0.4517304189435337,60,178,0.33707865168539325,188,371,0.5067385444743935,43,78,0.5512820512820513,90,210,300,134,73,29,81,142,599,2012_Chandler Parsons
2012,Chris Duhon,PG,29,85,203,0.4187192118226601,50,119,0.42016806722689076,35,84,0.4166666666666667,17,21,0.8095238095238095,14,88,102,151,35,9,81,71,237,2012_Chris Duhon
2012,DeMar DeRozan,SG,22,381,903,0.4219269102990033,24,92,0.2608695652173913,357,811,0.4401972872996301,268,331,0.8096676737160121,40,171,211,128,48,17,123,162,1054,2012_DeMar DeRozan
2012,Greg Stiemsma,C,26,66,121,0.5454545454545454,0,0,NaN,66,121,0.5454545454545454,29,41,0.7073170731707317,48,129,177,28,37,85,33,144,161,2012_Greg Stiemsma
2012,Gustavo Ayon,PF,26,140,261,0.5363984674329502,0,1,0.0,140,260,0.5384615384615384,39,63,0.6190476190476191,86,179,265,74,53,46,46,118,319,2012_Gustavo Ayon
2012,Jon Brockman,PF,24,15,45,0.3333333333333333,0,1,0.0,15,44,0.3409090909090909,7,15,0.4666666666666667,33,42,75,9,4,1,10,33,37,2012_Jon Brockman
2012,Lance Thomas,PF,23,57,126,0.4523809523809524,0,1,0.0,57,125,0.456,52,62,0.8387096774193549,49,77,126,12,10,7,24,78,166,2012_Lance Thomas
2012,Landry Fields,SG,23,236,513,0.4600389863547758,31,121,0.256198347107438,205,392,0.5229591836734694,77,137,0.5620437956204379,59,219,278,169,79,17,102,99,580,2012_Landry Fields
2012,Mike Bibby,PG,33,35,124,0.28225806451612906,27,85,0.3176470588235294,8,39,0.20512820512820512,6,8,0.75,5,54,59,80,21,3,20,45,103,2012_Mike Bibby
2012,Mike Conley,PG,24,296,684,0.4327485380116959,60,159,0.37735849056603776,236,525,0.44952380952380955,136,158,0.8607594936708861,22,134,156,404,136,11,125,133,788,2012_Mike Conley
2012,Omer Asik,C,25,79,156,0.5064102564102564,0,0,NaN,79,156,0.5064102564102564,47,103,0.4563106796116505,127,223,350,32,30,68,68,121,205,2012_Omer Asik
2012,Rodney Stuckey,SG,25,256,597,0.4288107202680067,33,104,0.3173076923076923,223,493,0.45233265720081134,267,320,0.834375,38,104,142,210,44,10,106,124,812,2012_Rodney Stuckey
2012,Steve Blake,PG,31,101,268,0.376865671641791,53,158,0.33544303797468356,48,110,0.43636363636363634,21,27,0.7777777777777778,9,76,85,175,39,2,72,75,276,2012_Steve Blake
2013,Beno Udrih,SG-PG_SG_PG,30,420,952,0.4411764705882353,68,204,0.3333333333333333,352,748,0.47058823529411764,168,206,0.8155339805825242,68,214,282,604,82,6,216,180,1076,2013_Beno Udrih
2013,Brendan Haywood,C,33,93,216,0.4305555555555556,0,1,0.0,93,215,0.4325581395348837,30,66,0.45454545454545453,125,165,290,29,16,49,50,125,216,2013_Brendan Haywood
2013,DeMar DeRozan,SG,23,548,1231,0.44516653127538586,34,120,0.2833333333333333,514,1111,0.46264626462646263,355,427,0.8313817330210773,48,272,320,204,76,24,151,173,1485,2013_DeMar DeRozan
2013,DeQuan Jones,SF,22,95,218,0.43577981651376146,9,35,0.2571428571428571,86,183,0.46994535519125685,34,51,0.6666666666666666,17,88,105,16,19,22,30,55,233,2013_DeQuan Jones
2013,Derek Fisher,SG-PG_SG_PG,38,110,322,0.3416149068322981,60,160,0.375,50,162,0.30864197530864196,70,76,0.9210526315789473,4,70,74,94,38,6,60,110,350,2013_Derek Fisher
2013,Dexter Pittman,C,24,8,22,0.36363636363636365,0,0,NaN,8,22,0.36363636363636365,0,6,0.0,14,10,24,0,0,0,6,16,16,2013_Dexter Pittman
2013,Grant Hill,SF,40,38,98,0.3877551020408163,3,11,0.2727272727272727,35,87,0.40229885057471265,14,24,0.5833333333333334,6,43,49,26,11,7,25,39,93,2013_Grant Hill
2013,Greg Stiemsma,C,27,127,278,0.4568345323741007,0,0,NaN,127,278,0.4568345323741007,53,69,0.7681159420289855,61,200,261,30,44,90,59,184,307,2013_Greg Stiemsma
2013,JaVale McGee,C,25,303,527,0.5749525616698292,1,1,1.0,302,526,0.5741444866920152,110,186,0.5913978494623656,158,223,381,24,30,157,90,184,717,2013_JaVale McGee
2013,James Anderson,SF_SG_SG-SF,23,104,252,0.4126984126984127,42,120,0.35,62,132,0.4696969696969697,48,56,0.8571428571428571,36,108,144,84,30,10,50,50,298,2013_James Anderson
2013,Jeremy Lin,PG,24,396,897,0.4414715719063545,87,257,0.33852140077821014,309,640,0.4828125,216,275,0.7854545454545454,32,215,247,497,134,29,236,205,1095,2013_Jeremy Lin
2013,Kendrick Perkins,C,28,143,313,0.45686900958466453,0,1,0.0,143,312,0.4583333333333333,44,72,0.6111111111111112,110,356,466,111,43,83,109,227,330,2013_Kendrick Perkins
2013,Kris Humphries,PF,27,139,310,0.4483870967741935,0,2,0.0,139,308,0.4512987012987013,97,123,0.7886178861788617,126,239,365,32,16,33,57,127,375,2013_Kris Humphries
2013,Landry Fields,SF,24,102,223,0.45739910313901344,2,14,0.14285714285714285,100,209,0.4784688995215311,34,53,0.6415094339622641,59,149,208,60,32,8,42,63,240,2013_Landry Fields
2013,Maurice Harkless,SF,19,260,564,0.46099290780141844,32,117,0.27350427350427353,228,447,0.5100671140939598,73,128,0.5703125,122,213,335,50,88,62,69,144,625,2013_Maurice Harkless
2013,Michael Kidd-Gilchrist,SF,19,281,613,0.45840130505709625,2,9,0.2222222222222222,279,604,0.46192052980132453,140,187,0.7486631016042781,131,324,455,117,54,70,101,164,704,2013_Michael Kidd-Gilchrist
2013,Mike Conley,PG,25,414,940,0.44042553191489364,106,293,0.36177474402730375,308,647,0.4760432766615147,234,282,0.8297872340425532,43,182,225,487,174,24,189,171,1168,2013_Mike Conley
2013,Omer Asik,C,26,332,614,0.5407166123778502,0,1,0.0,332,613,0.5415986949429038,168,299,0.5618729096989966,275,681,956,75,46,87,173,223,832,2013_Omer Asik
2013,Paul Millsap,PF,27,429,875,0.49028571428571427,13,39,0.3333333333333333,416,836,0.49760765550239233,264,356,0.7415730337078652,177,377,554,201,102,80,138,232,1135,2013_Paul Millsap
2013,Robert Sacre,C,23,18,48,0.375,0,0,NaN,18,48,0.375,7,11,0.6363636363636364,9,25,34,6,0,10,10,38,43,2013_Robert Sacre
2013,Steve Blake,PG,32,114,270,0.4222222222222222,72,171,0.42105263157894735,42,99,0.42424242424242425,27,35,0.7714285714285715,21,111,132,173,34,6,62,83,327,2013_Steve Blake
2013,Thomas Robinson,PF,21,276,642,0.42990654205607476,0,2,0.0,276,640,0.43125,114,218,0.5229357798165137,244,386,630,92,82,52,176,248,666,2013_Thomas Robinson
2014,Allen Crabbe,SG,21,12,33,0.36363636363636365,6,14,0.42857142857142855,6,19,0.3157894736842105,3,4,0.75,1,8,9,6,2,1,3,10,33,2014_Allen Crabbe
2014,Anderson Varejao,C,31,227,459,0.49455337690631807,0,7,0.0,227,452,0.5022123893805309,92,135,0.6814814814814815,187,442,629,140,69,39,72,164,546,2014_Anderson Varejao
2014,DeMar DeRozan,SG,24,604,1407,0.4292821606254442,64,210,0.3047619047619048,540,1197,0.45112781954887216,519,630,0.8238095238095238,51,292,343,313,86,28,176,197,1791,2014_DeMar DeRozan
2014,Greg Stiemsma,C,28,70,122,0.5737704918032787,0,1,0.0,70,121,0.5785123966942148,19,32,0.59375,72,154,226,36,35,57,44,169,159,2014_Greg Stiemsma
2014,Jared Cunningham,SG,22,12,42,0.2857142857142857,2,14,0.14285714285714285,10,28,0.35714285714285715,26,32,0.8125,2,10,12,16,6,0,4,32,52,2014_Jared Cunningham
2014,Landry Fields,SF,25,27,67,0.40298507462686567,0,5,0.0,27,62,0.43548387096774194,14,22,0.6363636363636364,15,44,59,20,10,3,11,25,68,2014_Landry Fields
2014,Luigi Datome,SF,26,34,97,0.35051546391752575,7,39,0.1794871794871795,27,58,0.46551724137931033,8,10,0.8,14,32,46,11,6,1,11,20,83,2014_Luigi Datome
2014,Mike Conley,PG,26,463,1030,0.4495145631067961,105,291,0.36082474226804123,358,739,0.4844384303112314,225,276,0.8152173913043478,41,172,213,441,110,13,150,141,1256,2014_Mike Conley
2014,Nate Wolters,PG,22,170,389,0.4370179948586118,18,62,0.2903225806451613,152,327,0.4648318042813456,59,90,0.6555555555555556,33,116,149,187,35,15,57,67,417,2014_Nate Wolters
2014,Omer Asik,C,27,101,190,0.531578947368421,0,0,NaN,101,190,0.531578947368421,78,126,0.6190476190476191,101,277,378,25,14,37,59,92,280,2014_Omer Asik
2014,Pablo Prigioni,PG,36,88,191,0.4607329842931937,65,140,0.4642857142857143,23,51,0.45098039215686275,11,12,0.9166666666666666,36,93,129,228,67,2,60,132,252,2014_Pablo Prigioni
2014,Steve Blake,PG,33,266,706,0.37677053824362605,158,420,0.3761904761904762,108,286,0.3776223776223776,66,86,0.7674418604651163,26,292,318,614,108,16,204,170,756,2014_Steve Blake
2014,Thomas Robinson,PF,22,141,293,0.4812286689419795,0,1,0.0,141,292,0.4828767123287671,57,101,0.5643564356435643,105,202,307,34,23,20,57,131,339,2014_Thomas Robinson
2015,Al Horford,C,28,519,965,0.5378238341968912,11,36,0.3055555555555556,508,929,0.5468245425188375,107,141,0.7588652482269503,131,413,544,244,68,98,100,121,1156,2015_Al Horford
2015,Bojan Bogdanovic,SF,25,261,576,0.453125,91,256,0.35546875,170,320,0.53125,87,106,0.8207547169811321,50,163,213,68,34,9,78,104,700,2015_Bojan Bogdanovic
2015,Brandon Rush,SG,29,11,54,0.2037037037037037,3,27,0.1111111111111111,8,27,0.2962962962962963,5,11,0.45454545454545453,4,37,41,12,5,12,11,27,30,2015_Brandon Rush
2015,Brendan Haywood,C,35,14,30,0.4666666666666667,0,0,NaN,14,30,0.4666666666666667,7,13,0.5384615384615384,6,23,29,2,2,10,10,17,35,2015_Brendan Haywood
2015,DeMar DeRozan,SG,25,409,990,0.4131313131313131,25,88,0.2840909090909091,384,902,0.42572062084257206,361,434,0.8317972350230415,41,236,277,210,73,11,137,122,1204,2015_DeMar DeRozan
2015,Devin Harris,PG,31,219,524,0.4179389312977099,95,266,0.35714285714285715,124,258,0.4806201550387597,132,162,0.8148148148148148,13,122,135,237,78,14,85,147,665,2015_Devin Harris
2015,Greg Stiemsma,C,29,6,8,0.75,0,0,NaN,6,8,0.75,2,4,0.5,9,6,15,3,2,0,7,15,14,2015_Greg Stiemsma
2015,Kostas Papanikolaou,SF,24,69,197,0.350253807106599,31,106,0.29245283018867924,38,91,0.4175824175824176,13,18,0.7222222222222222,39,79,118,85,29,13,55,71,182,2015_Kostas Papanikolaou
2015,Landry Fields,SF,26,20,41,0.4878048780487805,1,2,0.5,19,39,0.48717948717948717,5,6,0.8333333333333334,10,16,26,15,11,0,8,9,46,2015_Landry Fields
2015,Mike Conley,PG,27,393,882,0.445578231292517,107,277,0.3862815884476534,286,605,0.4727272727272727,214,249,0.8594377510040161,29,180,209,375,89,14,156,139,1107,2015_Mike Conley
2015,Miroslav Raduljica,C,27,3,8,0.375,0,0,NaN,3,8,0.375,2,2,1.0,2,3,5,0,1,0,2,8,8,2015_Miroslav Raduljica
2015,Omer Asik,C,28,213,412,0.5169902912621359,0,0,NaN,213,412,0.5169902912621359,131,225,0.5822222222222222,244,504,748,72,29,54,95,144,557,2015_Omer Asik
2015,Seth Curry,PG,24,0,3,0.0,0,1,0.0,0,2,0.0,0,0,NaN,0,2,2,1,0,0,0,2,0,2015_Seth Curry
2015,Steve Blake,PG,34,122,327,0.3730886850152905,77,219,0.3515981735159817,45,108,0.4166666666666667,29,41,0.7073170731707317,16,121,137,288,41,5,104,118,350,2015_Steve Blake
2015,Thomas Robinson,PF,23,252,520,0.4846153846153846,0,4,0.0,252,516,0.4883720930232558,112,212,0.5283018867924528,190,416,606,66,64,40,118,208,616,2015_Thomas Robinson
2015,Trey Burke,PG,22,370,1005,0.3681592039800995,124,390,0.31794871794871793,246,615,0.4,109,145,0.7517241379310344,31,173,204,328,65,15,124,119,973,2015_Trey Burke
2015,Vince Carter,SG,38,135,406,0.33251231527093594,69,232,0.2974137931034483,66,174,0.3793103448275862,45,57,0.7894736842105263,27,106,133,79,43,14,43,102,384,2015_Vince Carter
2016,Boris Diaw,PF,33,202,383,0.5274151436031331,25,69,0.36231884057971014,177,314,0.5636942675159236,56,76,0.7368421052631579,58,175,233,176,26,21,97,102,485,2016_Boris Diaw
2016,Coty Clarke,SF,23,2,4,0.5,2,2,1.0,0,2,0.0,0,0,NaN,0,1,1,0,0,0,1,0,6,2016_Coty Clarke
2016,DeMar DeRozan,SG,26,614,1377,0.4458968772694263,47,139,0.3381294964028777,567,1238,0.4579967689822294,555,653,0.8499234303215927,64,285,349,315,81,21,175,167,1830,2016_DeMar DeRozan
2016,J.J. Hickson,C,27,160,310,0.5161290322580645,0,2,0.0,160,308,0.5194805194805194,92,206,0.44660194174757284,78,186,264,46,30,28,50,94,412,2016_J.J. Hickson
2016,James Harden,SG,26,710,1617,0.4390847247990105,236,657,0.3592085235920852,474,960,0.49375,720,837,0.8602150537634409,63,438,501,612,139,51,374,229,2376,2016_James Harden
2016,Kevin Love,PF,27,409,977,0.4186284544524053,158,439,0.35990888382687924,251,538,0.46654275092936803,258,314,0.821656050955414,149,613,762,186,58,41,142,159,1234,2016_Kevin Love
2016,Kostas Papanikolaou,SF,25,24,66,0.36363636363636365,10,32,0.3125,14,34,0.4117647058823529,9,14,0.6428571428571429,8,32,40,16,13,5,21,24,67,2016_Kostas Papanikolaou
2016,Kyle Singler,SF,27,86,221,0.3891402714932127,30,97,0.30927835051546393,56,124,0.45161290322580644,29,44,0.6590909090909091,50,91,141,24,30,9,32,120,231,2016_Kyle Singler
2016,Mike Conley,PG,28,294,696,0.4224137931034483,78,215,0.3627906976744186,216,481,0.4490644490644491,191,229,0.834061135371179,26,138,164,342,67,16,84,100,857,2016_Mike Conley
2016,Omer Asik,C,29,104,195,0.5333333333333333,0,0,NaN,104,195,0.5333333333333333,61,112,0.5446428571428571,120,294,414,26,21,23,60,124,269,2016_Omer Asik
2016,Shabazz Napier,PG,24,68,201,0.3383084577114428,34,104,0.3269230769230769,34,97,0.35051546391752575,33,45,0.7333333333333333,9,46,55,97,23,1,46,38,203,2016_Shabazz Napier
2016,Steve Blake,PG,35,93,240,0.3875,52,151,0.3443708609271523,41,89,0.4606741573033708,16,20,0.8,9,80,89,200,24,5,81,70,254,2016_Steve Blake
2016,Thomas Robinson,PF,24,130,291,0.44673539518900346,0,1,0.0,130,290,0.4482758620689655,47,109,0.43119266055045874,136,223,359,46,39,36,69,111,307,2016_Thomas Robinson
2016,Tibor Pleiss,C,26,11,25,0.44,0,2,0.0,11,23,0.4782608695652174,2,2,1.0,6,9,15,2,1,2,8,19,24,2016_Tibor Pleiss
2016,Timofey Mozgov,C,29,203,359,0.5654596100278552,1,7,0.14285714285714285,202,352,0.5738636363636364,68,95,0.7157894736842105,110,227,337,33,22,57,71,159,475,2016_Timofey Mozgov
2017,Alec Burks,SG,25,99,248,0.39919354838709675,25,76,0.32894736842105265,74,172,0.43023255813953487,60,78,0.7692307692307693,17,103,120,30,18,5,35,50,283,2017_Alec Burks
2017,Bryn Forbes,SG,23,36,99,0.36363636363636365,17,53,0.32075471698113206,19,46,0.41304347826086957,5,6,0.8333333333333334,2,21,23,23,1,0,11,20,94,2017_Bryn Forbes
2017,Buddy Hield,SG,23,654,1536,0.42578125,296,758,0.39050131926121373,358,778,0.4601542416452442,128,152,0.8421052631578947,70,468,538,242,76,18,202,230,1732,2017_Buddy Hield
2017,DeAndre' Bembry,SF,22,47,98,0.47959183673469385,1,18,0.05555555555555555,46,80,0.575,6,16,0.375,14,45,59,28,8,5,16,21,101,2017_DeAndre' Bembry
2017,DeMar DeRozan,SG,27,721,1545,0.4666666666666667,33,124,0.2661290322580645,688,1421,0.48416608022519353,545,647,0.8423493044822257,70,316,386,290,78,13,180,134,2020,2017_DeMar DeRozan
2017,Jason Smith,C,30,174,329,0.5288753799392097,37,78,0.47435897435897434,137,251,0.545816733067729,35,51,0.6862745098039216,64,194,258,37,21,55,58,168,420,2017_Jason Smith
2017,Juan Hernangomez,PF,21,101,224,0.45089285714285715,46,113,0.40707964601769914,55,111,0.4954954954954955,57,76,0.75,43,144,187,29,29,12,31,62,305,2017_Juan Hernangomez
2017,Kenneth Faried,PF,27,228,416,0.5480769230769231,0,6,0.0,228,410,0.5560975609756098,131,189,0.6931216931216931,182,279,461,55,43,40,58,124,587,2017_Kenneth Faried
2017,LeBron James,SF,32,736,1344,0.5476190476190477,124,342,0.36257309941520466,612,1002,0.6107784431137725,358,531,0.6741996233521658,97,543,640,646,92,44,303,134,1954,2017_LeBron James
2017,Mike Conley,PG,29,464,1009,0.45986124876114964,171,419,0.4081145584725537,293,590,0.4966101694915254,316,368,0.8586956521739131,31,211,242,433,92,19,156,126,1415,2017_Mike Conley
2017,Nicolas Brussino,SF,23,52,141,0.36879432624113473,29,95,0.30526315789473685,23,46,0.5,17,22,0.7727272727272727,26,69,95,47,17,8,26,43,150,2017_Nicolas Brussino
2017,Thomas Robinson,PF,25,105,196,0.5357142857142857,0,1,0.0,105,195,0.5384615384615384,31,66,0.4696969696969697,84,139,223,31,26,9,46,76,241,2017_Thomas Robinson
2017,Tony Snell,SG,25,246,541,0.45471349353049906,144,355,0.4056338028169014,102,186,0.5483870967741935,47,58,0.8103448275862069,22,226,248,96,54,14,55,125,683,2017_Tony Snell
2017,Victor Oladipo,SG,24,412,932,0.44206008583690987,127,352,0.36079545454545453,285,580,0.49137931034482757,116,154,0.7532467532467533,39,252,291,176,78,21,119,155,1067,2017_Victor Oladipo
2017,Wayne Selden,SG,22,50,116,0.43103448275862066,14,56,0.25,36,60,0.6,28,44,0.6363636363636364,2,30,32,26,12,2,24,36,142,2017_Wayne Selden
2003,Chris Mihm,C,23,116,287,0.40418118466898956,0,3,0.0,116,284,0.4084507042253521,76,105,0.7238095238095238,93,138,231,28,18,38,48,124,308,2003_Chris Mihm
2003,Derrick Coleman,C,35,223,498,0.44779116465863456,22,67,0.3283582089552239,201,431,0.46635730858468677,134,171,0.783625730994152,151,299,450,87,53,69,96,171,602,2003_Derrick Coleman
2003,Greg Buckner,SG,26,185,398,0.4648241206030151,15,55,0.2727272727272727,170,343,0.4956268221574344,65,81,0.8024691358024691,72,144,216,96,72,16,62,203,450,2003_Greg Buckner
2003,Jermaine O'Neal,PF,24,610,1260,0.48412698412698413,7,21,0.3333333333333333,603,1239,0.48668280871670705,373,510,0.7313725490196078,202,594,796,155,66,178,180,277,1600,2003_Jermaine O'Neal
2003,Jiri Welsch,SF,23,19,75,0.25333333333333335,1,4,0.25,18,71,0.2535211267605634,22,29,0.7586206896551724,12,16,28,27,8,2,19,32,61,2003_Jiri Welsch
2003,Jon Barry,SG,33,191,424,0.45047169811320753,87,214,0.40654205607476634,104,210,0.49523809523809526,86,100,0.86,33,147,180,206,63,14,81,104,555,2003_Jon Barry
2003,Lamar Odom,SF,23,268,611,0.4386252045826514,42,129,0.32558139534883723,226,482,0.46887966804979253,136,175,0.7771428571428571,59,267,326,178,42,41,140,181,714,2003_Lamar Odom
2003,Rodney Rogers,PF,31,183,455,0.4021978021978022,44,132,0.3333333333333333,139,323,0.43034055727554177,68,90,0.7555555555555555,61,202,263,107,50,31,91,192,478,2003_Rodney Rogers
2003,Tim Thomas,SF,25,412,930,0.443010752688172,97,265,0.3660377358490566,315,665,0.47368421052631576,145,186,0.7795698924731183,97,292,389,102,70,49,133,257,1066,2003_Tim Thomas
2003,Tracy Murray,SF,31,23,71,0.323943661971831,8,38,0.21052631578947367,15,33,0.45454545454545453,7,9,0.7777777777777778,5,18,23,12,5,3,14,22,61,2003_Tracy Murray
2004,Bobby Jackson,SG,30,263,592,0.44425675675675674,81,219,0.3698630136986301,182,373,0.4879356568364611,82,109,0.7522935779816514,55,119,174,105,49,8,63,106,689,2004_Bobby Jackson
2004,Charlie Ward,PG,33,320,780,0.41025641025641024,168,412,0.4077669902912621,152,368,0.41304347826086957,40,54,0.7407407407407407,24,264,288,430,128,22,192,214,848,2004_Charlie Ward
2004,Damone Brown,PF,24,1,10,0.1,0,0,NaN,1,10,0.1,1,2,0.5,3,2,5,0,2,0,1,2,3,2004_Damone Brown
2004,Derrick Coleman,C,36,107,259,0.41312741312741313,8,36,0.2222222222222222,99,223,0.4439461883408072,49,65,0.7538461538461538,45,147,192,46,23,26,57,79,271,2004_Derrick Coleman
2004,Erick Strickland,PG,30,79,196,0.4030612244897959,29,66,0.4393939393939394,50,130,0.38461538461538464,44,51,0.8627450980392157,13,58,71,90,26,2,54,63,231,2004_Erick Strickland
2004,Glenn Robinson,SF,31,275,614,0.44788273615635177,34,100,0.34,241,514,0.4688715953307393,114,137,0.8321167883211679,46,143,189,57,42,9,106,96,698,2004_Glenn Robinson
2004,Jermaine O'Neal,PF,25,608,1400,0.4342857142857143,2,18,0.1111111111111111,606,1382,0.4384949348769899,348,460,0.7565217391304347,193,585,778,164,59,199,181,248,1566,2004_Jermaine O'Neal
2004,Jiri Welsch,SG,24,262,612,0.42810457516339867,69,181,0.3812154696132597,193,431,0.44779582366589327,153,206,0.7427184466019418,60,236,296,183,101,7,129,176,746,2004_Jiri Welsch
2004,Jon Barry,SG,34,120,297,0.40404040404040403,51,138,0.3695652173913043,69,159,0.4339622641509434,60,71,0.8450704225352113,25,98,123,147,57,8,53,66,351,2004_Jon Barry
2004,Karl Malone,PF,40,193,400,0.4825,0,1,0.0,193,399,0.48370927318295737,168,225,0.7466666666666667,61,306,367,163,50,20,103,116,554,2004_Karl Malone
2004,Michael Redd,SG,24,633,1439,0.43988881167477417,127,363,0.349862258953168,506,1076,0.47026022304832715,383,441,0.8684807256235828,118,289,407,185,81,6,116,152,1776,2004_Michael Redd
2004,Predrag Drobnjak,C,28,149,379,0.39313984168865435,11,36,0.3055555555555556,138,343,0.40233236151603496,73,86,0.8488372093023255,54,142,196,39,22,24,48,85,382,2004_Predrag Drobnjak
2004,Rick Brunson,PG,31,80,210,0.38095238095238093,22,46,0.4782608695652174,58,164,0.35365853658536583,54,62,0.8709677419354839,18,56,74,164,50,6,66,88,236,2004_Rick Brunson
2004,Rodney Rogers,PF,32,207,505,0.4099009900990099,50,152,0.32894736842105265,157,353,0.4447592067988669,75,98,0.7653061224489796,100,207,307,137,59,27,98,183,539,2004_Rodney Rogers
2005,Alan Henderson,PF,32,116,220,0.5272727272727272,0,2,0.0,116,218,0.5321100917431193,41,76,0.5394736842105263,164,184,348,21,29,37,49,149,273,2005_Alan Henderson
2005,Billy Thomas,SF,29,34,94,0.3617021276595745,17,56,0.30357142857142855,17,38,0.4473684210526316,7,9,0.7777777777777778,7,29,36,17,14,1,9,29,92,2005_Billy Thomas
2005,Bobby Jackson,SG,31,109,255,0.42745098039215684,33,96,0.34375,76,159,0.4779874213836478,50,58,0.8620689655172413,23,62,85,59,14,2,28,58,301,2005_Bobby Jackson
2005,Carlos Delfino,SG,22,42,117,0.358974358974359,9,35,0.2571428571428571,33,82,0.4024390243902439,23,40,0.575,13,42,55,38,22,6,23,44,116,2005_Carlos Delfino
2005,Derrick Coleman,C,37,3,14,0.21428571428571427,0,2,0.0,3,12,0.25,3,3,1.0,3,12,15,0,0,0,2,6,9,2005_Derrick Coleman
2005,Jabari Smith,PF,27,62,148,0.4189189189189189,1,2,0.5,61,146,0.4178082191780822,41,55,0.7454545454545455,29,82,111,38,25,14,39,103,166,2005_Jabari Smith
2005,Jameer Nelson,PG,22,286,628,0.4554140127388535,44,141,0.3120567375886525,242,487,0.49691991786447637,73,107,0.6822429906542056,52,141,193,237,78,3,117,199,689,2005_Jameer Nelson
2005,Jared Reiner,C,22,10,30,0.3333333333333333,0,0,NaN,10,30,0.3333333333333333,1,4,0.25,13,25,38,1,3,7,9,35,21,2005_Jared Reiner
2005,Jermaine O'Neal,PF,26,386,854,0.4519906323185012,1,6,0.16666666666666666,385,848,0.4540094339622642,295,391,0.7544757033248082,85,303,388,82,25,88,131,173,1068,2005_Jermaine O'Neal
2005,Jiri Welsch,SF_SG_SG-SF,25,298,742,0.40161725067385445,68,220,0.3090909090909091,230,522,0.44061302681992337,258,338,0.7633136094674556,52,282,334,206,88,10,146,242,922,2005_Jiri Welsch
2005,Jon Barry,SG,35,322,736,0.4375,142,330,0.4303030303030303,180,406,0.4433497536945813,124,142,0.8732394366197183,52,266,318,334,120,18,134,190,910,2005_Jon Barry
2005,Latrell Sprewell,SF,34,398,961,0.4141519250780437,69,211,0.32701421800947866,329,750,0.43866666666666665,156,188,0.8297872340425532,65,189,254,179,53,21,127,124,1021,2005_Latrell Sprewell
2005,Lindsey Hunter,SG,34,108,302,0.3576158940397351,23,84,0.27380952380952384,85,218,0.38990825688073394,46,58,0.7931034482758621,38,85,123,130,68,13,68,125,285,2005_Lindsey Hunter
2005,Rodney Rogers,SF-PF_SF_PF,33,344,900,0.38222222222222224,96,336,0.2857142857142857,248,564,0.4397163120567376,104,140,0.7428571428571429,122,370,492,172,82,40,172,344,888,2005_Rodney Rogers
2005,Sasha Pavlovic,SG,21,120,276,0.43478260869565216,30,78,0.38461538461538464,90,198,0.45454545454545453,44,64,0.6875,15,56,71,49,29,4,47,121,314,2005_Sasha Pavlovic
2006,Adrian Griffin,SG,31,98,204,0.4803921568627451,0,2,0.0,98,202,0.48514851485148514,41,53,0.7735849056603774,75,152,227,89,51,9,39,113,237,2006_Adrian Griffin
2006,Bobby Jackson,PG,32,286,748,0.38235294117647056,129,332,0.3885542168674699,157,416,0.37740384615384615,107,146,0.7328767123287672,44,179,223,195,61,1,101,155,808,2006_Bobby Jackson
2006,Bracey Wright,SG,21,21,51,0.4117647058823529,6,17,0.35294117647058826,15,34,0.4411764705882353,14,16,0.875,3,15,18,5,1,0,8,8,62,2006_Bracey Wright
2006,Chauncey Billups,PG,29,423,1012,0.41798418972332013,184,425,0.4329411764705882,239,587,0.4071550255536627,465,520,0.8942307692307693,41,211,252,699,71,8,170,160,1495,2006_Chauncey Billups
2006,Chris Bosh,C,21,549,1087,0.5050597976080957,0,13,0.0,549,1074,0.5111731843575419,474,581,0.8158347676419966,204,443,647,181,50,79,157,209,1572,2006_Chris Bosh
2006,David Lee,SF,22,137,230,0.5956521739130435,0,0,NaN,137,230,0.5956521739130435,71,123,0.5772357723577236,109,194,303,43,30,20,51,124,345,2006_David Lee
2006,Donell Taylor,SG,23,53,136,0.3897058823529412,4,17,0.23529411764705882,49,119,0.4117647058823529,30,43,0.6976744186046512,16,37,53,45,30,4,34,47,140,2006_Donell Taylor
2006,Jameer Nelson,PG,23,347,719,0.48261474269819193,70,165,0.42424242424242425,277,554,0.5,141,181,0.7790055248618785,39,141,180,302,70,9,148,174,905,2006_Jameer Nelson
2006,Jermaine O'Neal,PF,27,380,805,0.4720496894409938,3,10,0.3,377,795,0.4742138364779874,261,368,0.7092391304347826,102,374,476,133,27,117,151,177,1024,2006_Jermaine O'Neal
2006,Jiri Welsch,SF,26,86,222,0.38738738738738737,14,49,0.2857142857142857,72,173,0.4161849710982659,65,87,0.7471264367816092,22,89,111,62,34,1,41,65,251,2006_Jiri Welsch
2006,John Salmons,SG,26,219,521,0.42034548944337813,26,87,0.2988505747126437,193,434,0.4447004608294931,155,200,0.775,48,172,220,223,73,13,125,178,619,2006_John Salmons
2006,Jon Barry,SG,36,25,65,0.38461538461538464,12,32,0.375,13,33,0.3939393939393939,24,29,0.8275862068965517,1,30,31,26,13,1,22,25,86,2006_Jon Barry
2006,Lee Nailon,PF,30,40,80,0.5,0,0,NaN,40,80,0.5,13,15,0.8666666666666667,23,19,42,7,8,4,10,32,93,2006_Lee Nailon
2006,Luke Ridnour,PG,24,334,799,0.41802252816020025,43,149,0.28859060402684567,291,650,0.44769230769230767,199,227,0.8766519823788547,47,188,235,550,123,22,162,178,910,2006_Luke Ridnour
2006,Luke Schenscher,C,23,16,26,0.6153846153846154,0,0,NaN,16,26,0.6153846153846154,4,13,0.3076923076923077,8,21,29,7,1,3,5,21,36,2006_Luke Schenscher
2006,Othella Harrington,C,32,135,273,0.4945054945054945,0,0,NaN,135,273,0.4945054945054945,77,123,0.6260162601626016,54,100,154,39,7,13,61,131,347,2006_Othella Harrington
2006,Quentin Richardson,SF,25,163,459,0.355119825708061,64,188,0.3404255319148936,99,271,0.36531365313653136,61,91,0.6703296703296703,65,165,230,88,39,6,56,134,451,2006_Quentin Richardson
2006,Rawle Marshall,SF,23,24,60,0.4,1,3,0.3333333333333333,23,57,0.40350877192982454,22,29,0.7586206896551724,8,23,31,10,8,7,15,17,71,2006_Rawle Marshall
2006,Richie Frahm,SG,28,78,200,0.39,46,140,0.32857142857142857,32,60,0.5333333333333333,14,20,0.7,6,60,66,42,8,4,16,60,216,2006_Richie Frahm
2006,Scot Pollard,C,30,70,154,0.45454545454545453,0,0,NaN,70,154,0.45454545454545453,29,38,0.7631578947368421,73,145,218,24,37,20,26,115,169,2006_Scot Pollard
2006,Viktor Khryapa,SF,23,158,342,0.4619883040935672,10,30,0.3333333333333333,148,312,0.47435897435897434,77,111,0.6936936936936937,114,193,307,88,50,29,84,209,403,2006_Viktor Khryapa
2006,Von Wafer,SG,20,6,38,0.15789473684210525,2,17,0.11764705882352941,4,21,0.19047619047619047,6,8,0.75,5,3,8,4,3,0,1,12,20,2006_Von Wafer
2007,Andreas Glyniadakis,C,25,8,17,0.47058823529411764,0,0,NaN,8,17,0.47058823529411764,1,2,0.5,2,6,8,1,0,0,9,19,17,2007_Andreas Glyniadakis
2007,Andris Biedrins,C,20,348,581,0.5989672977624785,0,0,NaN,348,581,0.5989672977624785,87,167,0.5209580838323353,251,511,762,88,67,136,119,304,783,2007_Andris Biedrins
2007,Antoine Wright,SG,22,110,251,0.43824701195219123,19,59,0.3220338983050847,91,192,0.4739583333333333,44,73,0.6027397260273972,38,137,175,55,30,10,43,120,283,2007_Antoine Wright
2007,Ben Gordon,SG,23,609,1338,0.4551569506726457,155,375,0.41333333333333333,454,963,0.4714434060228453,380,440,0.8636363636363636,35,223,258,296,64,17,249,252,1753,2007_Ben Gordon
2007,Bobby Jackson,SG,33,204,518,0.3938223938223938,54,165,0.32727272727272727,150,353,0.42492917847025496,130,168,0.7738095238095238,42,136,178,141,50,6,78,98,592,2007_Bobby Jackson
2007,Bracey Wright,SG,22,24,60,0.4,6,20,0.3,18,40,0.45,13,18,0.7222222222222222,7,14,21,15,9,1,6,6,67,2007_Bracey Wright
2007,David Lee,PF,23,240,400,0.6,0,0,NaN,240,400,0.6,141,173,0.815028901734104,196,406,602,104,48,23,92,155,621,2007_David Lee
2007,Donell Taylor,SG,24,56,140,0.4,3,17,0.17647058823529413,53,123,0.43089430894308944,11,21,0.5238095238095238,14,39,53,45,17,3,25,34,126,2007_Donell Taylor
2007,Jameer Nelson,PG,24,376,875,0.4297142857142857,65,194,0.33505154639175255,311,681,0.4566813509544787,183,221,0.8280542986425339,50,186,236,330,73,5,184,225,1000,2007_Jameer Nelson
2007,Jeff Foster,C,30,122,260,0.46923076923076923,0,1,0.0,122,259,0.47104247104247104,78,122,0.639344262295082,253,356,609,57,62,37,70,202,322,2007_Jeff Foster
2007,Jermaine O'Neal,C,28,498,1141,0.4364592462751972,0,7,0.0,498,1134,0.43915343915343913,343,447,0.767337807606264,153,508,661,167,50,182,203,232,1339,2007_Jermaine O'Neal
2007,Justin Williams,C,22,54,88,0.6136363636363636,0,1,0.0,54,87,0.6206896551724138,23,63,0.36507936507936506,51,64,115,2,5,16,15,51,131,2007_Justin Williams
2007,Luke Schenscher,C,24,7,23,0.30434782608695654,0,0,NaN,7,23,0.30434782608695654,5,7,0.7142857142857143,10,15,25,1,2,4,4,25,19,2007_Luke Schenscher
2007,Shaquille O'Neal,C,34,283,479,0.5908141962421712,0,0,NaN,283,479,0.5908141962421712,124,294,0.4217687074829932,97,200,297,79,8,55,95,139,690,2007_Shaquille O'Neal
2007,Tony Allen,SG,25,133,259,0.5135135135135135,8,33,0.24242424242424243,125,226,0.5530973451327433,105,134,0.7835820895522388,35,89,124,56,49,12,75,87,379,2007_Tony Allen
2007,Von Wafer,SF,21,0,1,0.0,0,1,0.0,0,0,NaN,0,0,NaN,0,0,0,0,0,0,0,0,0,2007_Von Wafer
2008,Andris Biedrins,C,21,340,543,0.6261510128913443,0,0,NaN,340,543,0.6261510128913443,116,187,0.6203208556149733,256,488,744,75,56,94,85,262,796,2008_Andris Biedrins
2008,Bobby Jackson,SG-PG_SG_PG,34,408,1012,0.4031620553359684,162,452,0.3584070796460177,246,560,0.4392857142857143,128,162,0.7901234567901234,66,296,362,278,90,10,118,192,1106,2008_Bobby Jackson
2008,Darius Washington,SG,22,21,48,0.4375,4,12,0.3333333333333333,17,36,0.4722222222222222,7,13,0.5384615384615384,4,16,20,15,5,0,14,16,53,2008_Darius Washington
2008,David Lee,PF,24,341,618,0.551779935275081,0,2,0.0,341,616,0.5535714285714286,194,237,0.8185654008438819,242,482,724,95,55,29,97,210,876,2008_David Lee
2008,Derek Fisher,PG,33,339,777,0.4362934362934363,112,276,0.4057971014492754,227,501,0.4530938123752495,166,188,0.8829787234042553,24,146,170,239,86,3,90,188,956,2008_Derek Fisher
2008,Emeka Okafor,C,25,460,860,0.5348837209302325,0,0,NaN,460,860,0.5348837209302325,213,374,0.56951871657754,255,621,876,70,62,138,164,241,1133,2008_Emeka Okafor
2008,Jameer Nelson,PG,25,283,603,0.4693200663349917,64,154,0.4155844155844156,219,449,0.48775055679287305,125,151,0.8278145695364238,28,215,243,383,63,4,141,167,755,2008_Jameer Nelson
2008,Jeff Foster,C,31,205,373,0.5495978552278821,0,3,0.0,205,370,0.5540540540540541,86,145,0.593103448275862,264,404,668,129,56,32,62,221,496,2008_Jeff Foster
2008,Jermaine O'Neal,C,29,225,512,0.439453125,0,5,0.0,225,507,0.4437869822485207,121,163,0.7423312883435583,82,201,283,93,20,87,106,129,571,2008_Jermaine O'Neal
2008,Justin Williams,C,23,26,58,0.4482758620689655,0,0,NaN,26,58,0.4482758620689655,16,52,0.3076923076923077,40,58,98,0,10,10,8,34,68,2008_Justin Williams
2008,Kaniel Dickens,PF,29,1,3,0.3333333333333333,0,0,NaN,1,3,0.3333333333333333,0,0,NaN,0,1,1,1,0,1,0,1,2,2008_Kaniel Dickens
2008,Kendrick Perkins,C,23,214,348,0.6149425287356322,0,1,0.0,214,347,0.6167146974063401,114,183,0.6229508196721312,145,329,474,84,31,114,125,242,542,2008_Kendrick Perkins
2008,Kris Humphries,PF,22,161,333,0.48348348348348347,0,2,0.0,161,331,0.486404833836858,75,124,0.6048387096774194,90,169,259,28,25,28,47,107,397,2008_Kris Humphries
2008,Oleksiy Pecherov,C,22,44,125,0.352,17,60,0.2833333333333333,27,65,0.4153846153846154,20,31,0.6451612903225806,21,45,66,7,6,5,17,30,125,2008_Oleksiy Pecherov
2008,Paul Millsap,PF,22,253,502,0.5039840637450199,0,4,0.0,253,498,0.5080321285140562,155,229,0.6768558951965066,167,293,460,81,72,73,87,269,661,2008_Paul Millsap
2008,Peja Stojakovic,SF,30,451,1026,0.4395711500974659,231,524,0.44083969465648853,220,502,0.43824701195219123,130,140,0.9285714285714286,64,267,331,96,57,10,61,127,1263,2008_Peja Stojakovic
2008,Salim Stoudamire,PG,25,65,180,0.3611111111111111,29,85,0.3411764705882353,36,95,0.37894736842105264,41,50,0.82,4,20,24,28,7,5,21,34,200,2008_Salim Stoudamire
2008,Von Wafer,SG,22,34,122,0.2786885245901639,8,52,0.15384615384615385,26,70,0.37142857142857144,16,24,0.6666666666666666,2,36,38,14,4,6,26,14,92,2008_Von Wafer
2009,Andris Biedrins,C,22,308,533,0.5778611632270169,0,1,0.0,308,532,0.5789473684210527,119,216,0.5509259259259259,223,470,693,121,63,96,110,236,735,2009_Andris Biedrins
2009,Bobby Jackson,PG,35,193,485,0.3979381443298969,60,197,0.30456852791878175,133,288,0.4618055555555556,86,101,0.8514851485148515,42,158,200,143,62,4,66,100,532,2009_Bobby Jackson
2009,David Lee,C,25,522,951,0.5488958990536278,0,3,0.0,522,948,0.5506329113924051,249,330,0.7545454545454545,256,695,951,174,80,22,150,260,1293,2009_David Lee
2009,Jameer Nelson,PG,26,267,531,0.5028248587570622,82,181,0.4530386740331492,185,350,0.5285714285714286,86,97,0.8865979381443299,20,125,145,226,51,3,83,123,702,2009_Jameer Nelson
2009,Jeff Foster,C,32,177,353,0.5014164305949008,2,7,0.2857142857142857,175,346,0.5057803468208093,96,146,0.6575342465753424,215,293,508,130,53,49,88,229,452,2009_Jeff Foster
2009,Peja Stojakovic,SF,31,287,719,0.3991655076495132,145,384,0.3776041666666667,142,335,0.42388059701492536,93,104,0.8942307692307693,44,220,264,75,52,3,51,101,812,2009_Peja Stojakovic
2009,Shane Battier,SG,30,145,354,0.4096045197740113,91,237,0.38396624472573837,54,117,0.46153846153846156,55,67,0.8208955223880597,52,233,285,137,48,54,49,114,436,2009_Shane Battier
2009,Von Wafer,SG,23,229,512,0.447265625,64,164,0.3902439024390244,165,348,0.47413793103448276,88,117,0.7521367521367521,19,94,113,71,40,8,59,71,610,2009_Von Wafer
2009,Wally Szczerbiak,SF,31,179,398,0.44974874371859297,69,168,0.4107142857142857,110,230,0.4782608695652174,90,106,0.8490566037735849,43,189,232,82,28,10,55,130,517,2009_Wally Szczerbiak
2010,Devin Harris,PG,26,356,884,0.40271493212669685,60,217,0.2764976958525346,296,667,0.44377811094452774,308,386,0.7979274611398963,24,179,203,423,79,18,181,178,1080,2010_Devin Harris
2010,Earl Boykins,PG,33,172,403,0.4267990074441687,19,60,0.31666666666666665,153,343,0.446064139941691,77,89,0.8651685393258427,17,58,75,171,24,3,69,48,440,2010_Earl Boykins
2010,Jermaine O'Neal,C,31,394,745,0.5288590604026846,0,2,0.0,394,743,0.5302826379542396,162,225,0.72,124,362,486,92,25,95,125,212,950,2010_Jermaine O'Neal
2010,Luke Walton,SF,29,30,84,0.35714285714285715,7,17,0.4117647058823529,23,67,0.34328358208955223,2,4,0.5,12,26,38,40,10,1,12,19,69,2010_Luke Walton
2010,Mickael Pietrus,SF,27,233,539,0.4322820037105751,116,306,0.3790849673202614,117,233,0.5021459227467812,69,109,0.6330275229357798,39,176,215,49,53,31,69,138,651,2010_Mickael Pietrus
2010,O.J. Mayo,SG,22,542,1183,0.45815722738799664,136,355,0.38309859154929576,406,828,0.49033816425120774,212,262,0.8091603053435115,61,250,311,242,98,17,176,174,1432,2010_O.J. Mayo
2010,Taylor Griffin,SF,23,4,10,0.4,0,2,0.0,4,8,0.5,2,4,0.5,0,2,2,1,0,2,1,4,10,2010_Taylor Griffin
2010,Toney Douglas,PG,23,179,391,0.4578005115089514,68,175,0.38857142857142857,111,216,0.5138888888888888,55,68,0.8088235294117647,40,68,108,112,42,3,55,116,481,2010_Toney Douglas
2011,Avery Bradley,PG,20,23,67,0.34328358208955223,0,5,0.0,23,62,0.3709677419354839,6,12,0.5,4,13,17,12,9,0,16,20,52,2011_Avery Bradley
2011,Boris Diaw,PF,28,381,774,0.49224806201550386,78,226,0.34513274336283184,303,548,0.5529197080291971,84,123,0.6829268292682927,105,309,414,337,74,46,166,190,924,2011_Boris Diaw
2011,Earl Clark,SF,23,136,316,0.43037974683544306,0,10,0.0,136,306,0.4444444444444444,54,94,0.574468085106383,74,128,202,18,16,36,56,90,326,2011_Earl Clark
2011,Eugene Jeter,PG,27,106,259,0.4092664092664093,6,30,0.2,100,229,0.4366812227074236,37,41,0.9024390243902439,9,61,70,162,29,2,51,54,255,2011_Eugene Jeter
2011,Jeff Adrien,PF,24,23,54,0.42592592592592593,0,0,NaN,23,54,0.42592592592592593,11,19,0.5789473684210527,23,35,58,10,4,5,9,28,57,2011_Jeff Adrien
2011,Jermaine O'Neal,C,32,50,109,0.45871559633027525,0,1,0.0,50,108,0.46296296296296297,29,43,0.6744186046511628,25,63,88,12,2,30,27,65,129,2011_Jermaine O'Neal
2011,Juwan Howard,PF,37,55,125,0.44,0,0,NaN,55,125,0.44,29,35,0.8285714285714286,36,86,122,23,10,4,25,61,139,2011_Juwan Howard
2011,Larry Sanders,C,22,116,268,0.43283582089552236,0,0,NaN,116,268,0.43283582089552236,28,50,0.56,59,119,178,16,22,72,38,117,260,2011_Larry Sanders
2011,Marcus Camby,C,36,117,294,0.3979591836734694,0,1,0.0,117,293,0.3993174061433447,43,70,0.6142857142857143,182,424,606,121,40,92,62,140,277,2011_Marcus Camby
2011,Mickael Pietrus,SF_SG_SG-SF,28,286,730,0.3917808219178082,170,472,0.3601694915254237,116,258,0.4496124031007752,78,114,0.6842105263157895,30,222,252,66,58,42,78,202,820,2011_Mickael Pietrus
2011,O.J. Mayo,SG,23,304,747,0.4069611780455154,96,264,0.36363636363636365,208,483,0.4306418219461698,99,131,0.7557251908396947,35,135,170,145,73,26,99,127,803,2011_O.J. Mayo
2011,Richard Hamilton,SG,32,288,671,0.42921013412816694,55,144,0.3819444444444444,233,527,0.44212523719165087,146,172,0.8488372093023255,24,102,126,171,39,4,88,95,777,2011_Richard Hamilton
2011,Rudy Fernandez,SG,25,213,575,0.37043478260869567,116,361,0.32132963988919666,97,214,0.4532710280373832,126,146,0.863013698630137,37,135,172,193,87,14,88,134,668,2011_Rudy Fernandez
2011,Toney Douglas,SG,24,314,755,0.41589403973509936,143,383,0.3733681462140992,171,372,0.4596774193548387,85,107,0.794392523364486,65,179,244,244,89,4,89,177,856,2011_Toney Douglas
2011,Willie Warren,PG,21,13,35,0.37142857142857144,5,15,0.3333333333333333,8,20,0.4,6,8,0.75,1,11,12,27,6,0,8,16,37,2011_Willie Warren
2012,Avery Bradley,PG,21,200,402,0.4975124378109453,22,54,0.4074074074074074,178,348,0.5114942528735632,62,78,0.7948717948717948,34,81,115,87,43,12,75,109,484,2012_Avery Bradley
2012,Caron Butler,SF,31,287,705,0.40709219858156026,92,257,0.35797665369649806,195,448,0.43526785714285715,87,107,0.8130841121495327,44,186,230,78,52,9,77,123,753,2012_Caron Butler
2012,Derrick Favors,PF,20,222,445,0.49887640449438203,0,0,NaN,222,445,0.49887640449438203,126,194,0.6494845360824743,158,267,425,43,38,65,103,145,570,2012_Derrick Favors
2012,Eric Bledsoe,PG,22,49,126,0.3888888888888889,6,30,0.2,43,96,0.4479166666666667,28,44,0.6363636363636364,22,43,65,66,31,14,47,58,132,2012_Eric Bledsoe
2012,Jeff Adrien,PF,25,7,16,0.4375,0,0,NaN,7,16,0.4375,7,12,0.5833333333333334,5,17,22,1,0,2,2,13,21,2012_Jeff Adrien
2012,Jermaine O'Neal,C,33,52,120,0.43333333333333335,0,0,NaN,52,120,0.43333333333333335,21,31,0.6774193548387096,37,98,135,10,8,43,21,80,125,2012_Jermaine O'Neal
2012,Larry Sanders,PF,23,84,184,0.45652173913043476,0,2,0.0,84,182,0.46153846153846156,18,38,0.47368421052631576,62,98,160,33,32,76,43,133,186,2012_Larry Sanders
2012,LeBron James,SF,27,621,1169,0.5312232677502139,54,149,0.3624161073825503,567,1020,0.5558823529411765,387,502,0.7709163346613546,94,398,492,387,115,50,213,96,1683,2012_LeBron James
2012,Matt Carroll,SG,31,52,157,0.33121019108280253,8,43,0.18604651162790697,44,114,0.38596491228070173,30,38,0.7894736842105263,8,50,58,38,16,7,24,52,142,2012_Matt Carroll
2012,Mickael Pietrus,SG,29,104,270,0.3851851851851852,61,182,0.33516483516483514,43,88,0.48863636363636365,20,31,0.6451612903225806,18,112,130,25,21,10,33,81,289,2012_Mickael Pietrus
2012,Nikola Pekovic,C,26,256,454,0.5638766519823789,0,0,NaN,256,454,0.5638766519823789,139,187,0.7433155080213903,181,165,346,31,29,31,87,98,651,2012_Nikola Pekovic
2012,O.J. Mayo,SG,24,300,736,0.4076086956521739,100,275,0.36363636363636365,200,461,0.43383947939262474,133,172,0.7732558139534884,30,180,210,169,71,23,124,137,833,2012_O.J. Mayo
2012,Shawn Marion,SF,33,288,646,0.4458204334365325,20,68,0.29411764705882354,268,578,0.46366782006920415,74,93,0.7956989247311828,145,320,465,132,67,36,98,87,670,2012_Shawn Marion
2012,Toney Douglas,PG,25,94,290,0.32413793103448274,27,117,0.23076923076923078,67,173,0.3872832369942196,22,26,0.8461538461538461,16,56,72,77,29,1,56,55,237,2012_Toney Douglas
2012,Tyreke Evans,SG,22,408,900,0.4533333333333333,20,99,0.20202020202020202,388,801,0.484394506866417,201,258,0.7790697674418605,64,225,289,283,84,29,171,136,1037,2012_Tyreke Evans
2013,Avery Bradley,PG,22,192,478,0.401673640167364,40,126,0.31746031746031744,152,352,0.4318181818181818,37,49,0.7551020408163265,30,81,111,104,64,19,72,129,461,2013_Avery Bradley
2013,Brandon Knight,PG,21,357,878,0.40660592255125283,120,327,0.3669724770642202,237,551,0.4301270417422868,165,225,0.7333333333333333,54,193,247,303,58,8,205,157,999,2013_Brandon Knight
2013,DeMarcus Cousins,C,22,482,1036,0.46525096525096526,4,22,0.18181818181818182,478,1014,0.4714003944773176,312,423,0.7375886524822695,222,524,746,199,108,55,225,269,1280,2013_DeMarcus Cousins
2013,Jameer Nelson,PG,30,306,780,0.3923076923076923,121,355,0.3408450704225352,185,425,0.43529411764705883,89,102,0.8725490196078431,23,186,209,413,71,6,154,161,822,2013_Jameer Nelson
2013,Jared Jeffries,PF,31,16,54,0.2962962962962963,0,2,0.0,16,52,0.3076923076923077,12,23,0.5217391304347826,26,34,60,14,6,6,17,58,44,2013_Jared Jeffries
2013,Jarvis Varnado,PF,24,6,14,0.42857142857142855,0,0,NaN,6,14,0.42857142857142855,4,8,0.5,4,14,18,6,2,4,12,20,16,2013_Jarvis Varnado
2013,Jeff Adrien,PF,26,72,168,0.42857142857142855,0,2,0.0,72,166,0.43373493975903615,65,100,0.65,68,128,196,36,18,27,32,80,209,2013_Jeff Adrien
2013,Jermaine O'Neal,C,34,179,371,0.48247978436657685,0,0,NaN,179,371,0.48247978436657685,96,115,0.8347826086956521,82,211,293,42,19,78,73,126,454,2013_Jermaine O'Neal
2013,Joel Anthony,C,30,35,68,0.5147058823529411,0,0,NaN,35,68,0.5147058823529411,17,28,0.6071428571428571,45,70,115,13,13,42,22,49,87,2013_Joel Anthony
2013,Julyan Stone,PG,24,2,2,1.0,0,0,NaN,2,2,1.0,3,4,0.75,2,1,3,2,1,0,2,4,7,2013_Julyan Stone
2013,Justin Holiday,SG,23,16,48,0.3333333333333333,4,16,0.25,12,32,0.375,6,8,0.75,0,14,14,15,3,6,9,7,42,2013_Justin Holiday
2013,Larry Sanders,C,24,306,605,0.5057851239669422,0,2,0.0,306,603,0.5074626865671642,84,136,0.6176470588235294,224,448,672,83,53,201,87,233,696,2013_Larry Sanders
2013,Luis Scola,PF,32,432,915,0.4721311475409836,3,16,0.1875,429,899,0.4771968854282536,181,230,0.7869565217391304,158,383,541,182,67,35,126,257,1048,2013_Luis Scola
2013,O.J. Mayo,SG,25,461,1026,0.449317738791423,142,349,0.4068767908309456,319,677,0.4711964549483013,191,233,0.8197424892703863,36,255,291,361,93,23,210,195,1255,2013_O.J. Mayo
2013,Toney Douglas,PG,26,376,932,0.4034334763948498,164,432,0.37962962962962965,212,500,0.424,152,168,0.9047619047619048,68,208,276,302,142,6,162,290,1068,2013_Toney Douglas
2014,Archie Goodwin,SG,19,76,167,0.4550898203592814,5,36,0.1388888888888889,71,131,0.5419847328244275,37,55,0.6727272727272727,25,62,87,20,20,11,44,45,194,2014_Archie Goodwin
2014,Avery Bradley,PG,23,361,825,0.43757575757575756,79,200,0.395,282,625,0.4512,90,112,0.8035714285714286,48,178,226,85,63,11,96,145,891,2014_Avery Bradley
2014,C.J. Miles,SG,26,178,409,0.4352078239608802,83,211,0.3933649289099526,95,198,0.4797979797979798,64,75,0.8533333333333334,18,85,103,52,46,15,44,103,503,2014_C.J. Miles
2014,David Lee,PF,30,513,981,0.5229357798165137,0,1,0.0,513,980,0.523469387755102,231,296,0.7804054054054054,182,461,643,147,48,26,152,206,1257,2014_David Lee
2014,Hollis Thompson,SF,22,171,372,0.4596774193548387,67,167,0.40119760479041916,104,205,0.5073170731707317,52,73,0.7123287671232876,73,174,247,73,53,12,60,144,461,2014_Hollis Thompson
2014,Jameer Nelson,PG,31,294,747,0.39357429718875503,136,391,0.34782608695652173,158,356,0.4438202247191011,96,112,0.8571428571428571,29,202,231,476,52,5,166,146,820,2014_Jameer Nelson
2014,Jeff Adrien,PF,27,286,550,0.52,0,0,NaN,286,550,0.52,152,238,0.6386554621848739,204,408,612,76,48,72,78,216,724,2014_Jeff Adrien
2014,Jermaine O'Neal,PF,35,125,248,0.5040322580645161,0,0,NaN,125,248,0.5040322580645161,99,132,0.75,85,157,242,25,14,40,52,102,349,2014_Jermaine O'Neal
2014,Keith Bogans,SG,33,3,6,0.5,3,6,0.5,0,0,NaN,3,3,1.0,0,3,3,3,1,0,1,2,12,2014_Keith Bogans
2014,Larry Sanders,C,25,76,162,0.4691358024691358,0,1,0.0,76,161,0.4720496894409938,26,55,0.4727272727272727,60,105,165,19,18,40,26,74,178,2014_Larry Sanders
2014,O.J. Mayo,SG,26,224,550,0.4072727272727273,84,227,0.3700440528634361,140,323,0.43343653250773995,76,88,0.8636363636363636,24,100,124,113,28,13,95,111,608,2014_O.J. Mayo
2014,Ryan Gomes,SF,31,3,8,0.375,0,2,0.0,3,6,0.5,0,0,NaN,0,4,4,1,0,0,1,5,6,2014_Ryan Gomes
2014,Toney Douglas,PG,27,146,380,0.38421052631578945,62,204,0.30392156862745096,84,176,0.4772727272727273,50,68,0.7352941176470589,36,138,174,136,38,10,68,162,404,2014_Toney Douglas
2014,Tony Mitchell,PF,21,5,12,0.4166666666666667,1,1,1.0,4,11,0.36363636363636365,11,19,0.5789473684210527,15,11,26,2,6,3,4,9,22,2014_Tony Mitchell
2014,Toure' Murry,PG,24,56,129,0.43410852713178294,5,12,0.4166666666666667,51,117,0.4358974358974359,23,39,0.5897435897435898,13,31,44,49,19,1,34,46,140,2014_Toure' Murry
2015,Aaron Brooks,PG,30,344,817,0.42105263157894735,121,313,0.3865814696485623,223,504,0.44246031746031744,145,174,0.8333333333333334,32,134,166,261,54,15,157,189,954,2015_Aaron Brooks
2015,Anthony Morrow,SG,29,285,615,0.4634146341463415,141,325,0.4338461538461538,144,290,0.496551724137931,79,89,0.8876404494382022,40,155,195,60,54,11,38,135,790,2015_Anthony Morrow
2015,Avery Bradley,SG,24,434,1012,0.4288537549407115,124,352,0.3522727272727273,310,660,0.4696969696969697,79,100,0.79,46,195,241,135,82,15,109,177,1071,2015_Avery Bradley
2015,Chris Paul,PG,29,568,1170,0.48547008547008547,139,349,0.3982808022922636,429,821,0.5225334957369062,289,321,0.9003115264797508,52,324,376,838,156,15,190,203,1564,2015_Chris Paul
2015,David Lee,PF,31,160,313,0.5111821086261981,0,2,0.0,160,311,0.5144694533762058,68,104,0.6538461538461539,81,176,257,85,31,26,49,83,388,2015_David Lee
2015,Glen Davis,PF,29,117,255,0.4588235294117647,0,4,0.0,117,251,0.46613545816733065,60,95,0.631578947368421,43,126,169,39,41,21,39,132,294,2015_Glen Davis
2015,Hollis Thompson,SG,23,224,543,0.4125230202578269,115,287,0.40069686411149824,109,256,0.42578125,63,89,0.7078651685393258,53,145,198,85,57,26,66,141,626,2015_Hollis Thompson
2015,Jabari Parker,PF,19,129,263,0.49049429657794674,4,16,0.25,125,247,0.5060728744939271,46,66,0.696969696969697,50,88,138,42,31,5,47,42,308,2015_Jabari Parker
2015,Jameer Nelson,PG,32,410,1008,0.40674603174603174,178,516,0.3449612403100775,232,492,0.4715447154471545,48,72,0.6666666666666666,66,226,292,506,94,12,218,272,1046,2015_Jameer Nelson
2015,Jeff Adrien,PF,28,19,44,0.4318181818181818,0,0,NaN,19,44,0.4318181818181818,22,38,0.5789473684210527,23,54,77,15,4,9,9,30,60,2015_Jeff Adrien
2015,Jeremy Evans,SF,27,32,58,0.5517241379310345,2,5,0.4,30,53,0.5660377358490566,24,29,0.8275862068965517,26,45,71,13,11,12,5,29,90,2015_Jeremy Evans
2015,Jordan Adams,SG,20,35,86,0.4069767441860465,10,25,0.4,25,61,0.4098360655737705,14,23,0.6086956521739131,9,19,28,16,16,7,14,24,94,2015_Jordan Adams
2015,Larry Sanders,C,26,86,172,0.5,0,0,NaN,86,172,0.5,24,48,0.5,67,99,166,23,26,39,28,104,196,2015_Larry Sanders
2015,Luke Babbitt,SF,25,92,192,0.4791666666666667,59,115,0.5130434782608696,33,77,0.42857142857142855,13,19,0.6842105263157895,12,99,111,24,17,11,26,63,256,2015_Luke Babbitt
2015,Nick Johnson,SG,22,26,75,0.3466666666666667,5,21,0.23809523809523808,21,54,0.3888888888888889,17,25,0.68,13,26,39,11,7,3,19,34,74,2015_Nick Johnson
2015,O.J. Mayo,SG,27,296,701,0.4222539229671897,99,277,0.3574007220216607,197,424,0.46462264150943394,115,139,0.8273381294964028,30,157,187,197,57,18,128,165,806,2015_O.J. Mayo
2015,Ricky Ledo,SG,22,64,192,0.3333333333333333,20,54,0.37037037037037035,44,138,0.3188405797101449,32,44,0.7272727272727273,32,40,72,38,12,2,52,42,180,2015_Ricky Ledo
2015,Spencer Dinwiddie,PG,21,51,169,0.30177514792899407,12,65,0.18461538461538463,39,104,0.375,31,34,0.9117647058823529,4,44,48,104,19,6,33,53,145,2015_Spencer Dinwiddie
2015,Thaddeus Young,PF,26,902,1936,0.4659090909090909,76,230,0.33043478260869563,826,1706,0.48417350527549824,262,400,0.655,254,568,822,346,248,50,234,342,2142,2015_Thaddeus Young
2015,Toney Douglas,SG,28,19,51,0.37254901960784315,5,18,0.2777777777777778,14,33,0.42424242424242425,8,13,0.6153846153846154,2,20,22,24,11,4,10,20,51,2015_Toney Douglas
2015,Trevor Ariza,SF,29,366,910,0.4021978021978022,194,555,0.34954954954954953,172,355,0.48450704225352115,122,143,0.8531468531468531,77,382,459,209,152,17,141,186,1048,2015_Trevor Ariza
2016,Andrew Wiggins,SF,20,594,1294,0.45904173106646057,57,190,0.3,537,1104,0.48641304347826086,430,565,0.7610619469026548,105,186,291,164,78,46,182,165,1675,2016_Andrew Wiggins
2016,Avery Bradley,SG,25,456,1019,0.4474975466143278,147,407,0.36117936117936117,309,612,0.5049019607843137,96,123,0.7804878048780488,48,172,220,158,117,19,109,164,1155,2016_Avery Bradley
2016,Brandan Wright,PF,28,35,52,0.6730769230769231,0,0,NaN,35,52,0.6730769230769231,13,24,0.5416666666666666,14,29,43,6,5,15,10,21,83,2016_Brandan Wright
2016,Charlie Villanueva,PF,31,125,327,0.382262996941896,47,172,0.27325581395348836,78,155,0.5032258064516129,22,24,0.9166666666666666,24,128,152,24,18,15,31,71,319,2016_Charlie Villanueva
2016,Chase Budinger,SF,27,208,478,0.4351464435146444,48,172,0.27906976744186046,160,306,0.5228758169934641,78,112,0.6964285714285714,86,214,300,128,64,20,88,124,542,2016_Chase Budinger
2016,D'Angelo Russell,PG,19,392,956,0.4100418410041841,130,370,0.35135135135135137,262,586,0.447098976109215,140,190,0.7368421052631579,47,227,274,266,93,13,196,142,1054,2016_D'Angelo Russell
2016,David Lee,PF,32,356,670,0.5313432835820896,0,2,0.0,356,668,0.5329341317365269,142,186,0.7634408602150538,202,408,610,168,44,56,132,228,854,2016_David Lee
2016,Gerald Green,SG,30,230,587,0.39182282793867124,84,260,0.3230769230769231,146,327,0.44648318042813456,72,92,0.782608695652174,25,138,163,56,38,19,46,123,616,2016_Gerald Green
2016,Hollis Thompson,SG,24,270,680,0.39705882352941174,149,392,0.38010204081632654,121,288,0.4201388888888889,69,96,0.71875,54,218,272,99,36,24,76,187,758,2016_Hollis Thompson
2016,Jameer Nelson,PG,33,113,307,0.36807817589576547,43,144,0.2986111111111111,70,163,0.4294478527607362,30,35,0.8571428571428571,19,96,115,190,25,5,66,100,299,2016_Jameer Nelson
2016,Josh Richardson,SG,22,123,272,0.4522058823529412,53,115,0.4608695652173913,70,157,0.445859872611465,42,63,0.6666666666666666,21,86,107,73,36,25,35,107,341,2016_Josh Richardson
2016,O.J. Mayo,SG,28,119,321,0.3707165109034268,52,162,0.32098765432098764,67,159,0.42138364779874216,31,40,0.775,13,92,105,118,48,8,72,126,321,2016_O.J. Mayo
2016,Shayne Whittington,PF,24,5,11,0.45454545454545453,0,2,0.0,5,9,0.5555555555555556,1,2,0.5,5,7,12,3,1,1,5,7,11,2016_Shayne Whittington
2016,Spencer Dinwiddie,PG,22,19,54,0.35185185185185186,1,10,0.1,18,44,0.4090909090909091,19,33,0.5757575757575758,4,13,17,22,3,0,7,20,58,2016_Spencer Dinwiddie
2016,Toney Douglas,PG,29,183,445,0.41123595505617977,81,203,0.39901477832512317,102,242,0.4214876033057851,84,99,0.8484848484848485,25,118,143,157,70,5,64,131,531,2016_Toney Douglas
2016,Willie Reed,C,25,76,133,0.5714285714285714,0,0,NaN,76,133,0.5714285714285714,30,55,0.5454545454545454,49,73,122,10,6,30,16,47,182,2016_Willie Reed
2017,Avery Bradley,SG,26,359,775,0.4632258064516129,108,277,0.3898916967509025,251,498,0.5040160642570282,68,93,0.7311827956989247,65,269,334,121,68,11,88,141,894,2017_Avery Bradley
2017,Caris LeVert,SF,22,171,380,0.45,59,184,0.32065217391304346,112,196,0.5714285714285714,67,93,0.7204301075268817,23,165,188,110,49,8,59,91,468,2017_Caris LeVert
2017,Daniel Ochefu,C,23,12,27,0.4444444444444444,0,0,NaN,12,27,0.4444444444444444,0,2,0.0,5,17,22,3,2,0,3,17,24,2017_Daniel Ochefu
2017,David Lee,PF,33,248,420,0.5904761904761905,0,0,NaN,248,420,0.5904761904761905,80,113,0.7079646017699115,148,292,440,124,31,40,82,125,576,2017_David Lee
2017,Edy Tavares,C,24,8,10,0.8,0,0,NaN,8,10,0.8,0,6,0.0,8,14,22,2,0,12,4,6,16,2017_Edy Tavares
2017,Hollis Thompson,SG,25,154,400,0.385,64,190,0.3368421052631579,90,210,0.42857142857142855,38,58,0.6551724137931034,38,184,222,70,40,12,22,138,410,2017_Hollis Thompson
2017,Jameer Nelson,PG,34,268,604,0.44370860927152317,106,273,0.3882783882783883,162,331,0.48942598187311176,45,63,0.7142857142857143,28,164,192,385,53,8,129,197,687,2017_Jameer Nelson
2017,Josh Richardson,SG,23,202,513,0.3937621832358674,75,227,0.3303964757709251,127,286,0.44405594405594406,60,77,0.7792207792207793,35,133,168,140,60,39,65,132,539,2017_Josh Richardson
2017,Jrue Holiday,PG,26,405,894,0.45302013422818793,100,281,0.35587188612099646,305,613,0.49755301794453505,119,168,0.7083333333333334,46,218,264,488,100,43,194,133,1029,2017_Jrue Holiday
2017,Kris Dunn,PG,22,118,313,0.3769968051118211,21,73,0.2876712328767123,97,240,0.4041666666666667,36,59,0.6101694915254238,24,142,166,188,78,36,89,178,293,2017_Kris Dunn
2017,Larry Sanders,C,28,1,4,0.25,0,0,NaN,1,4,0.25,2,2,1.0,3,1,4,0,1,1,2,5,4,2017_Larry Sanders
2017,Marcus Smart,SG,22,269,749,0.3591455273698264,94,332,0.28313253012048195,175,417,0.4196642685851319,203,250,0.812,78,228,306,364,125,34,159,192,835,2017_Marcus Smart
2017,Pascal Siakam,PF,22,103,205,0.5024390243902439,1,7,0.14285714285714285,102,198,0.5151515151515151,22,32,0.6875,64,121,185,17,26,45,33,109,229,2017_Pascal Siakam
2017,Spencer Dinwiddie,PG,23,134,302,0.44370860927152317,38,101,0.37623762376237624,96,201,0.47761194029850745,126,159,0.7924528301886793,27,137,164,185,44,23,66,119,432,2017_Spencer Dinwiddie
2017,Willie Reed,C,26,162,285,0.5684210526315789,1,4,0.25,161,281,0.5729537366548043,49,88,0.5568181818181818,129,203,332,26,18,47,31,137,374,2017_Willie Reed
2003,Brevin Knight,PG,27,97,228,0.42543859649122806,2,8,0.25,95,220,0.4318181818181818,20,37,0.5405405405405406,15,66,81,233,69,2,94,123,216,2003_Brevin Knight
2003,Charles Smith,SG,27,1,4,0.25,0,1,0.0,1,3,0.3333333333333333,3,4,0.75,0,0,0,1,1,0,1,3,5,2003_Charles Smith
2003,Damon Jones,PG,26,80,210,0.38095238095238093,44,121,0.36363636363636365,36,89,0.4044943820224719,20,27,0.7407407407407407,11,59,70,80,18,4,23,42,224,2003_Damon Jones
2003,David Wesley,SG,32,449,1037,0.43297974927675986,134,316,0.4240506329113924,315,721,0.4368932038834951,185,237,0.7805907172995781,38,137,175,251,109,9,132,173,1217,2003_David Wesley
2003,Derek Fisher,PG,28,339,775,0.4374193548387097,85,212,0.4009433962264151,254,563,0.4511545293072824,100,125,0.8,40,199,239,298,93,15,94,195,863,2003_Derek Fisher
2003,Fred Hoiberg,SG,30,49,126,0.3888888888888889,5,21,0.23809523809523808,44,105,0.41904761904761906,41,50,0.82,11,126,137,70,40,5,25,59,144,2003_Fred Hoiberg
2003,Gary Trent,SF,28,208,389,0.5347043701799485,0,2,0.0,208,387,0.537467700258398,60,101,0.594059405940594,106,185,291,77,32,23,59,142,476,2003_Gary Trent
2003,Grant Hill,SF,30,151,307,0.49185667752442996,1,4,0.25,150,303,0.49504950495049505,118,144,0.8194444444444444,40,166,206,122,28,13,84,46,421,2003_Grant Hill
2003,Jason Collier,C,25,17,36,0.4722222222222222,0,0,NaN,17,36,0.4722222222222222,2,2,1.0,12,17,29,1,2,1,2,10,36,2003_Jason Collier
2003,Jim Jackson,SF,32,204,462,0.44155844155844154,32,71,0.4507042253521127,172,391,0.4398976982097187,47,55,0.8545454545454545,84,178,262,118,31,4,80,132,487,2003_Jim Jackson
2003,Juan Dixon,PG,24,104,271,0.3837638376383764,25,84,0.2976190476190476,79,187,0.42245989304812837,37,46,0.8043478260869565,13,59,72,40,26,3,42,54,270,2003_Juan Dixon
2003,Malik Allen,PF,24,335,790,0.4240506329113924,0,4,0.0,335,786,0.4262086513994911,97,121,0.8016528925619835,134,291,425,54,37,78,128,234,767,2003_Malik Allen
2003,Nick Van,SG,31,342,831,0.41155234657039713,118,312,0.3782051282051282,224,519,0.43159922928709055,110,144,0.7638888888888888,35,173,208,312,42,4,123,86,912,2003_Nick Van
2003,Ruben Wolkowyski,PF,29,2,4,0.5,0,1,0.0,2,3,0.6666666666666666,1,4,0.25,0,1,1,1,0,0,1,3,5,2003_Ruben Wolkowyski
2003,Smush Parker,PG,21,136,338,0.40236686390532544,38,118,0.3220338983050847,98,220,0.44545454545454544,98,118,0.8305084745762712,29,90,119,162,48,12,133,106,408,2003_Smush Parker
2004,Brevin Knight,PG,28,210,492,0.4268292682926829,4,16,0.25,206,476,0.4327731092436975,98,130,0.7538461538461538,28,196,224,408,168,2,144,214,522,2004_Brevin Knight
2004,Damon Jones,PG,27,210,524,0.40076335877862596,98,273,0.358974358974359,112,251,0.44621513944223107,55,72,0.7638888888888888,15,155,170,478,30,4,103,92,573,2004_Damon Jones
2004,Jason Collier,C,26,79,165,0.47878787878787876,1,4,0.25,78,161,0.484472049689441,67,85,0.788235294117647,36,75,111,17,11,11,31,71,226,2004_Jason Collier
2004,Jim Jackson,SF,33,382,900,0.42444444444444446,162,405,0.4,220,495,0.4444444444444444,107,127,0.84251968503937,52,435,487,226,86,23,175,227,1033,2004_Jim Jackson
2004,Malik Allen,PF,25,83,198,0.41919191919191917,0,0,NaN,83,198,0.41919191919191917,25,33,0.7575757575757576,42,77,119,16,12,28,27,81,191,2004_Malik Allen
2004,Mateen Cleaves,PG,26,7,23,0.30434782608695654,0,1,0.0,7,22,0.3181818181818182,1,2,0.5,1,6,7,19,4,2,5,13,15,2004_Mateen Cleaves
2004,Tierre Brown,PG,24,2,4,0.5,0,0,NaN,2,4,0.5,2,4,0.5,0,1,1,2,0,0,7,1,6,2004_Tierre Brown
2004,Toni Kukoc,PF,35,211,506,0.41699604743083,49,168,0.2916666666666667,162,338,0.47928994082840237,145,199,0.7286432160804021,60,211,271,200,59,21,110,110,616,2004_Toni Kukoc
2004,Udonis Haslem,PF,23,205,447,0.45861297539149887,0,3,0.0,205,444,0.4617117117117117,140,183,0.7650273224043715,189,284,473,51,33,24,74,197,550,2004_Udonis Haslem
2004,Wally Szczerbiak,SF,26,106,236,0.4491525423728814,20,46,0.43478260869565216,86,190,0.45263157894736844,53,64,0.828125,24,64,88,33,12,1,28,42,285,2004_Wally Szczerbiak
2005,Antawn Jamison,PF,28,519,1189,0.43650126156433977,71,208,0.34134615384615385,448,981,0.4566768603465851,225,296,0.7601351351351351,160,359,519,154,55,16,118,151,1334,2005_Antawn Jamison
2005,Brevin Knight,PG,29,248,587,0.42248722316865417,3,20,0.15,245,567,0.43209876543209874,167,196,0.8520408163265306,21,149,170,591,131,5,147,192,666,2005_Brevin Knight
2005,Damon Jones,PG,28,331,726,0.4559228650137741,225,521,0.43186180422264875,106,205,0.5170731707317073,68,86,0.7906976744186046,14,217,231,350,44,5,98,121,955,2005_Damon Jones
2005,Devin Harris,PG,21,157,366,0.42896174863387976,44,131,0.33587786259541985,113,235,0.4808510638297872,78,103,0.7572815533980582,28,74,102,169,77,19,82,139,436,2005_Devin Harris
2005,Jason Collier,C,27,174,376,0.4627659574468085,6,14,0.42857142857142855,168,362,0.46408839779005523,48,71,0.676056338028169,84,100,184,18,15,13,63,147,402,2005_Jason Collier
2005,Jim Jackson,SF,34,496,1164,0.4261168384879725,244,590,0.4135593220338983,252,574,0.43902439024390244,108,116,0.9310344827586207,66,472,538,366,70,10,230,306,1344,2005_Jim Jackson
2005,Josh Childress,SG,21,302,642,0.470404984423676,13,56,0.23214285714285715,289,586,0.4931740614334471,190,231,0.8225108225108225,195,287,482,151,74,35,106,184,807,2005_Josh Childress
2005,Justin Reed,SF,23,15,29,0.5172413793103449,0,3,0.0,15,26,0.5769230769230769,11,15,0.7333333333333333,8,8,16,10,3,1,5,12,41,2005_Justin Reed
2005,Malik Allen,PF,26,168,354,0.4745762711864407,0,0,NaN,168,354,0.4745762711864407,52,56,0.9285714285714286,80,118,198,36,18,44,36,106,388,2005_Malik Allen
2005,Stanislav Medvedenko,PF,25,71,156,0.4551282051282051,0,1,0.0,71,155,0.45806451612903226,23,28,0.8214285714285714,31,48,79,13,9,2,13,64,165,2005_Stanislav Medvedenko
2005,Torraye Braggs,PF,28,3,7,0.42857142857142855,0,0,NaN,3,7,0.42857142857142855,0,0,NaN,7,5,12,0,0,0,2,4,6,2005_Torraye Braggs
2005,Udonis Haslem,PF,24,346,641,0.5397815912636506,0,4,0.0,346,637,0.543171114599686,178,225,0.7911111111111111,239,487,726,108,63,41,113,260,870,2005_Udonis Haslem
2005,Vince Carter,SF_SG_SF-SG,28,1392,3082,0.4516547696301103,254,626,0.4057507987220447,1138,2456,0.46335504885993484,734,920,0.7978260869565217,212,590,802,654,218,96,336,486,3772,2005_Vince Carter
2005,Zeljko Rebraca,C,32,133,234,0.5683760683760684,0,0,NaN,133,234,0.5683760683760684,73,85,0.8588235294117647,49,135,184,26,13,40,49,130,339,2005_Zeljko Rebraca
2006,Anthony Goldwire,PG,34,1,7,0.14285714285714285,0,2,0.0,1,5,0.2,0,0,NaN,0,1,1,2,0,0,1,0,2,2006_Anthony Goldwire
2006,Boris Diaw,PF,23,449,853,0.5263774912075029,8,30,0.26666666666666666,441,823,0.5358444714459295,174,238,0.7310924369747899,159,399,558,503,58,85,189,260,1080,2006_Boris Diaw
2006,Cuttino Mobley,SF,30,429,1008,0.4255952380952381,83,245,0.33877551020408164,346,763,0.4534731323722149,229,273,0.8388278388278388,50,291,341,238,93,36,145,208,1170,2006_Cuttino Mobley
2006,Damon Jones,PG,29,190,491,0.3869653767820774,140,371,0.37735849056603776,50,120,0.4166666666666667,32,50,0.64,14,119,133,169,37,1,55,112,552,2006_Damon Jones
2006,Dan Dickau,PG,27,17,46,0.3695652173913043,10,20,0.5,7,26,0.2692307692307692,18,18,1.0,5,11,16,40,11,1,18,40,62,2006_Dan Dickau
2006,Darko Milicic,C,20,238,468,0.5085470085470085,0,4,0.0,238,464,0.5129310344827587,56,100,0.56,88,214,302,82,28,154,102,184,532,2006_Darko Milicic
2006,Jackie Butler,C,20,117,215,0.5441860465116279,0,0,NaN,117,215,0.5441860465116279,58,77,0.7532467532467533,67,116,183,25,17,31,62,127,292,2006_Jackie Butler
2006,Jim Jackson,SF,35,94,320,0.29375,36,148,0.24324324324324326,58,172,0.3372093023255814,18,26,0.6923076923076923,22,130,152,70,24,12,70,102,242,2006_Jim Jackson
2006,Justin Reed,SF,24,238,590,0.4033898305084746,0,2,0.0,238,588,0.40476190476190477,174,240,0.725,106,142,248,82,46,30,104,326,650,2006_Justin Reed
2006,Juwan Howard,PF,32,394,859,0.4586728754365541,0,4,0.0,394,855,0.4608187134502924,154,191,0.806282722513089,168,367,535,112,49,8,133,235,942,2006_Juwan Howard
2006,Lawrence Roberts,C,23,20,44,0.45454545454545453,0,2,0.0,20,42,0.47619047619047616,11,23,0.4782608695652174,26,23,49,5,8,2,5,30,51,2006_Lawrence Roberts
2006,Malik Allen,PF,27,121,247,0.4898785425101215,1,1,1.0,120,246,0.4878048780487805,23,38,0.6052631578947368,44,96,140,20,14,16,34,92,266,2006_Malik Allen
2006,Marcus Camby,C,31,302,649,0.46533127889060094,1,11,0.09090909090909091,301,638,0.4717868338557994,111,156,0.7115384615384616,132,536,668,115,79,184,92,158,716,2006_Marcus Camby
2006,Ruben Patterson,SF_SG_SF-SG,30,654,1270,0.5149606299212598,2,26,0.07692307692307693,652,1244,0.5241157556270096,406,676,0.6005917159763313,236,252,488,254,152,42,300,300,1716,2006_Ruben Patterson
2006,Udonis Haslem,PF,25,300,591,0.5076142131979695,0,2,0.0,300,589,0.5093378607809848,157,199,0.7889447236180904,167,467,634,95,50,17,80,216,757,2006_Udonis Haslem
2006,Yao Ming,C,25,467,900,0.5188888888888888,0,1,0.0,467,899,0.5194660734149055,337,395,0.8531645569620253,148,433,581,85,30,94,147,195,1271,2006_Yao Ming
2006,Zendon Hamilton,C,30,14,28,0.5,0,0,NaN,14,28,0.5,24,36,0.6666666666666666,6,16,22,0,8,0,12,10,52,2006_Zendon Hamilton
2007,Charlie Bell,SG,27,426,974,0.43737166324435317,127,361,0.3518005540166205,299,613,0.48776508972267535,131,168,0.7797619047619048,57,181,238,247,97,4,104,213,1110,2007_Charlie Bell
2007,Corliss Williamson,PF,33,236,463,0.509719222462203,0,2,0.0,236,461,0.5119305856832972,148,207,0.714975845410628,63,158,221,39,29,15,97,183,620,2007_Corliss Williamson
2007,Darko Milicic,PF,21,249,548,0.4543795620437956,0,1,0.0,249,547,0.45521023765996343,141,230,0.6130434782608696,145,292,437,90,44,140,124,219,639,2007_Darko Milicic
2007,David Harrison,C,24,30,58,0.5172413793103449,0,0,NaN,30,58,0.5172413793103449,11,22,0.5,9,33,42,6,5,12,26,47,71,2007_David Harrison
2007,Jackie Butler,C,21,16,35,0.45714285714285713,0,0,NaN,16,35,0.45714285714285713,9,10,0.9,6,16,22,5,2,0,10,16,41,2007_Jackie Butler
2007,Justin Reed,PF,25,40,107,0.37383177570093457,0,0,NaN,40,107,0.37383177570093457,26,30,0.8666666666666667,15,31,46,17,5,3,22,44,106,2007_Justin Reed
2007,LeBron James,SF,22,772,1621,0.47624922887106724,99,310,0.3193548387096774,673,1311,0.513348588863463,489,701,0.6975748930099858,83,443,526,470,125,55,250,171,2132,2007_LeBron James
2007,Malik Allen,PF,28,107,258,0.41472868217054265,0,1,0.0,107,257,0.4163424124513619,28,34,0.8235294117647058,42,77,119,16,17,16,21,85,242,2007_Malik Allen
2007,Maurice Taylor,PF,30,8,28,0.2857142857142857,0,0,NaN,8,28,0.2857142857142857,8,13,0.6153846153846154,10,18,28,5,4,1,6,16,24,2007_Maurice Taylor
2007,Ruben Patterson,SF,31,475,867,0.5478662053056517,3,19,0.15789473684210525,472,848,0.5566037735849056,241,376,0.6409574468085106,190,250,440,232,110,25,199,232,1194,2007_Ruben Patterson
2007,Udonis Haslem,PF,26,353,717,0.49232914923291493,0,4,0.0,353,713,0.4950911640953717,138,203,0.6798029556650246,188,466,654,97,49,26,110,236,844,2007_Udonis Haslem
2008,Blake Ahearn,PG,23,15,57,0.2631578947368421,10,34,0.29411764705882354,5,23,0.21739130434782608,30,31,0.967741935483871,1,18,19,19,6,0,16,20,70,2008_Blake Ahearn
2008,Darko Milicic,C,22,219,500,0.438,0,1,0.0,219,499,0.43887775551102204,67,121,0.5537190082644629,127,297,424,58,32,114,101,185,505,2008_Darko Milicic
2008,Eduardo Najera,PF,31,174,368,0.47282608695652173,53,147,0.36054421768707484,121,221,0.5475113122171946,63,89,0.7078651685393258,113,224,337,95,69,40,59,199,464,2008_Eduardo Najera
2008,Malik Allen,PF,29,314,654,0.4801223241590214,2,4,0.5,312,650,0.48,46,50,0.92,132,260,392,88,38,62,90,298,676,2008_Malik Allen
2008,Marco Belinelli,PG,21,36,93,0.3870967741935484,16,41,0.3902439024390244,20,52,0.38461538461538464,7,9,0.7777777777777778,3,11,14,15,5,0,12,15,95,2008_Marco Belinelli
2008,Michael Finley,SG,34,315,761,0.41392904073587383,132,357,0.3697478991596639,183,404,0.452970297029703,64,80,0.8,27,227,254,114,29,10,56,93,826,2008_Michael Finley
2008,Morris Peterson,SG,30,215,516,0.4166666666666667,113,287,0.39372822299651566,102,229,0.44541484716157204,65,85,0.7647058823529411,36,170,206,67,47,7,41,125,608,2008_Morris Peterson
2008,Nene Hilario,PF,25,29,71,0.4084507042253521,0,1,0.0,29,70,0.4142857142857143,27,49,0.5510204081632653,30,57,87,15,9,14,21,46,85,2008_Nene Hilario
2008,Ruben Patterson,SF,32,39,86,0.45348837209302323,0,2,0.0,39,84,0.4642857142857143,24,43,0.5581395348837209,24,40,64,17,21,7,27,37,102,2008_Ruben Patterson
2008,Udonis Haslem,PF,27,237,507,0.46745562130177515,0,0,NaN,237,507,0.46745562130177515,115,142,0.8098591549295775,107,336,443,68,39,18,67,145,589,2008_Udonis Haslem
2008,Willie Green,SG,26,379,870,0.435632183908046,51,179,0.2849162011173184,328,691,0.47467438494934877,112,148,0.7567567567567568,32,150,182,151,54,22,109,119,921,2008_Willie Green
2009,C.J. Miles,SG,21,258,562,0.45907473309608543,63,179,0.35195530726256985,195,383,0.5091383812010444,78,89,0.8764044943820225,45,122,167,107,46,15,64,187,657,2009_C.J. Miles
2009,Chris Douglas-Roberts,SG,22,81,176,0.4602272727272727,3,12,0.25,78,164,0.47560975609756095,51,62,0.8225806451612904,14,36,50,52,12,7,31,34,216,2009_Chris Douglas-Roberts
2009,Darko Milicic,C,23,137,266,0.5150375939849624,0,0,NaN,137,266,0.5150375939849624,59,105,0.5619047619047619,83,181,264,34,22,51,48,134,333,2009_Darko Milicic
2009,Dirk Nowitzki,PF,30,774,1616,0.47896039603960394,61,170,0.3588235294117647,713,1446,0.4930843706777317,485,545,0.8899082568807339,88,593,681,197,61,63,157,176,2094,2009_Dirk Nowitzki
2009,Greg Buckner,SF,32,61,159,0.3836477987421384,13,51,0.2549019607843137,48,108,0.4444444444444444,20,25,0.8,32,98,130,57,29,8,38,108,155,2009_Greg Buckner
2009,Jamario Moon,SF,28,444,948,0.46835443037974683,130,366,0.3551912568306011,314,582,0.5395189003436426,136,160,0.85,116,614,730,190,172,120,86,266,1154,2009_Jamario Moon
2009,Jarrett Jack,SG,25,386,853,0.4525205158264947,78,221,0.35294117647058826,308,632,0.4873417721518987,224,263,0.8517110266159695,44,232,276,338,88,17,184,179,1074,2009_Jarrett Jack
2009,Jarvis Hayes,SF,27,257,577,0.44540727902946275,94,244,0.38524590163934425,163,333,0.4894894894894895,36,52,0.6923076923076923,27,240,267,54,52,7,49,162,644,2009_Jarvis Hayes
2009,Marco Belinelli,SG,22,140,317,0.4416403785488959,52,131,0.3969465648854962,88,186,0.4731182795698925,40,52,0.7692307692307693,10,61,71,88,36,1,59,73,372,2009_Marco Belinelli
2009,Marreese Speights,C,21,252,502,0.50199203187251,2,8,0.25,250,494,0.5060728744939271,102,132,0.7727272727272727,123,170,293,30,27,56,46,181,608,2009_Marreese Speights
2009,Morris Peterson,SG,31,73,183,0.3989071038251366,33,85,0.38823529411764707,40,98,0.40816326530612246,12,19,0.631578947368421,13,71,84,16,15,2,15,51,191,2009_Morris Peterson
2009,Quinton Ross,SF,27,99,259,0.38223938223938225,33,88,0.375,66,171,0.38596491228070173,34,42,0.8095238095238095,29,97,126,47,32,14,36,114,265,2009_Quinton Ross
2009,Ryan Anderson,PF,20,160,407,0.3931203931203931,69,189,0.36507936507936506,91,218,0.41743119266055045,98,116,0.8448275862068966,104,207,311,52,44,20,63,157,487,2009_Ryan Anderson
2009,Sean Singletary,PG,23,62,170,0.36470588235294116,20,50,0.4,42,120,0.35,36,42,0.8571428571428571,20,50,70,58,22,0,46,90,180,2009_Sean Singletary
2009,Sergio Rodriguez,PG,22,129,329,0.39209726443769,37,114,0.32456140350877194,92,215,0.42790697674418604,61,77,0.7922077922077922,43,87,130,286,54,2,119,133,356,2009_Sergio Rodriguez
2009,Tim Thomas,PF,31,378,876,0.4315068493150685,156,378,0.4126984126984127,222,498,0.4457831325301205,178,242,0.7355371900826446,84,318,402,136,62,22,140,288,1090,2009_Tim Thomas
2009,Udonis Haslem,PF,28,333,643,0.5178849144634525,0,0,NaN,333,643,0.5178849144634525,128,170,0.7529411764705882,169,449,618,85,43,25,82,204,794,2009_Udonis Haslem
2009,Walter Sharpe,PF,22,4,11,0.36363636363636365,0,2,0.0,4,9,0.4444444444444444,0,2,0.0,0,3,3,0,0,2,0,3,8,2009_Walter Sharpe
2010,Aaron Brooks,PG,25,575,1331,0.4320060105184072,209,525,0.3980952380952381,366,806,0.45409429280397023,245,298,0.8221476510067114,54,161,215,434,69,14,232,199,1604,2010_Aaron Brooks
2010,Derrick Brown,SF,22,68,147,0.46258503401360546,2,7,0.2857142857142857,66,140,0.4714285714285714,48,72,0.6666666666666666,31,47,78,19,21,10,19,53,186,2010_Derrick Brown
2010,Jonathan Bender,SF,29,40,100,0.4,14,39,0.358974358974359,26,61,0.4262295081967213,24,26,0.9230769230769231,15,37,52,16,2,17,28,33,118,2010_Jonathan Bender
2010,Malik Allen,PF,31,46,116,0.39655172413793105,1,6,0.16666666666666666,45,110,0.4090909090909091,12,13,0.9230769230769231,36,46,82,16,11,5,22,68,105,2010_Malik Allen
2010,Mario Chalmers,PG,23,182,454,0.4008810572687225,75,236,0.3177966101694915,107,218,0.4908256880733945,82,110,0.7454545454545455,25,110,135,246,91,12,123,175,521,2010_Mario Chalmers
2010,Monta Ellis,SG,24,631,1406,0.4487908961593172,77,228,0.33771929824561403,554,1178,0.4702886247877759,292,388,0.7525773195876289,47,210,257,340,143,25,244,189,1631,2010_Monta Ellis
2010,Nenad Krstic,C,26,281,560,0.5017857142857143,1,5,0.2,280,555,0.5045045045045045,76,106,0.7169811320754716,134,249,383,52,32,45,58,177,639,2010_Nenad Krstic
2010,Sean Marks,C,34,4,8,0.5,0,0,NaN,4,8,0.5,2,5,0.4,14,9,23,2,0,3,2,17,10,2010_Sean Marks
2010,Yi Jianlian,PF,22,227,563,0.40319715808170514,15,41,0.36585365853658536,212,522,0.4061302681992337,154,193,0.7979274611398963,115,257,372,47,37,52,77,170,623,2010_Yi Jianlian
2011,Alonzo Gee,SG,23,242,528,0.4583333333333333,34,102,0.3333333333333333,208,426,0.48826291079812206,144,184,0.782608695652174,124,240,364,76,80,36,110,188,662,2011_Alonzo Gee
2011,Brian Cook,PF,30,72,170,0.4235294117647059,34,79,0.43037974683544306,38,91,0.4175824175824176,15,24,0.625,19,77,96,15,12,11,25,75,193,2011_Brian Cook
2011,Brian Scalabrine,PF,32,10,19,0.5263157894736842,0,5,0.0,10,14,0.7142857142857143,0,0,NaN,1,7,8,6,3,4,5,18,20,2011_Brian Scalabrine
2011,Carlos Delfino,SF,28,200,513,0.3898635477582846,105,284,0.36971830985915494,95,229,0.4148471615720524,60,75,0.8,24,176,200,112,76,8,57,72,565,2011_Carlos Delfino
2011,Charlie Villanueva,PF,26,313,708,0.442090395480226,125,323,0.38699690402476783,188,385,0.4883116883116883,89,116,0.7672413793103449,50,245,295,48,42,42,66,175,840,2011_Charlie Villanueva
2011,Derrick Brown,SF,23,148,262,0.5648854961832062,10,20,0.5,138,242,0.5702479338842975,64,120,0.5333333333333333,82,116,198,66,40,20,70,118,370,2011_Derrick Brown
2011,Kevin Durant,SF,22,711,1538,0.46228868660598177,145,414,0.3502415458937198,566,1124,0.50355871886121,594,675,0.88,57,476,533,214,88,76,218,159,2161,2011_Kevin Durant
2011,Linas Kleiza,SF,26,178,406,0.43842364532019706,39,131,0.29770992366412213,139,275,0.5054545454545455,41,65,0.6307692307692307,37,140,177,40,19,7,65,99,436,2011_Linas Kleiza
2011,Luke Harangody,PF,23,158,412,0.38349514563106796,32,132,0.24242424242424243,126,280,0.45,38,52,0.7307692307692307,80,206,286,60,30,34,32,160,386,2011_Luke Harangody
2011,Malik Allen,PF,32,11,31,0.3548387096774194,0,0,NaN,11,31,0.3548387096774194,1,2,0.5,12,20,32,4,1,4,3,30,23,2011_Malik Allen
2011,Monta Ellis,SG,25,726,1611,0.4506517690875233,137,379,0.36147757255936674,589,1232,0.4780844155844156,340,431,0.7888631090487239,44,237,281,450,168,23,252,203,1929,2011_Monta Ellis
2011,Mustafa Shakur,PG,26,21,59,0.3559322033898305,1,10,0.1,20,49,0.40816326530612246,8,15,0.5333333333333333,7,15,22,25,5,3,18,15,51,2011_Mustafa Shakur
2011,Sasha Pavlovic,SF_SG_SF-SG,27,58,144,0.4027777777777778,24,62,0.3870967741935484,34,82,0.4146341463414634,12,20,0.6,2,62,64,32,20,14,24,68,152,2011_Sasha Pavlovic
2011,Udonis Haslem,PF,30,44,86,0.5116279069767442,0,0,NaN,44,86,0.5116279069767442,16,20,0.8,29,77,106,6,7,3,14,39,104,2011_Udonis Haslem
2011,Yi Jianlian,PF,23,145,347,0.41786743515850144,3,13,0.23076923076923078,142,334,0.4251497005988024,62,91,0.6813186813186813,79,169,248,25,27,32,51,115,355,2011_Yi Jianlian
2012,Brandon Jennings,PG,22,469,1121,0.41837644959857273,129,388,0.3324742268041237,340,733,0.4638472032742155,193,239,0.8075313807531381,49,177,226,365,104,22,146,114,1260,2012_Brandon Jennings
2012,Chris Bosh,PF,27,393,807,0.48698884758364314,10,35,0.2857142857142857,383,772,0.4961139896373057,229,279,0.8207885304659498,94,358,452,103,51,45,117,128,1025,2012_Chris Bosh
2012,Dennis Horner,PF,23,1,4,0.25,0,1,0.0,1,3,0.3333333333333333,3,4,0.75,2,3,5,0,0,0,1,1,5,2012_Dennis Horner
2012,Derrick Brown,SF,24,212,409,0.5183374083129584,6,24,0.25,206,385,0.535064935064935,94,141,0.6666666666666666,95,141,236,67,48,12,55,96,524,2012_Derrick Brown
2012,Francisco Garcia,SF,30,86,229,0.37554585152838427,38,131,0.2900763358778626,48,98,0.4897959183673469,24,30,0.8,11,88,99,31,36,37,22,73,234,2012_Francisco Garcia
2012,Hassan Whiteside,C,22,12,27,0.4444444444444444,0,0,NaN,12,27,0.4444444444444444,5,12,0.4166666666666667,16,23,39,0,3,15,5,12,29,2012_Hassan Whiteside
2012,Joel Przybilla,C,32,22,48,0.4583333333333333,0,0,NaN,22,48,0.4583333333333333,11,18,0.6111111111111112,29,109,138,6,4,16,22,66,55,2012_Joel Przybilla
2012,Monta Ellis,SG,26,900,2080,0.4326923076923077,124,402,0.30845771144278605,776,1678,0.46245530393325385,438,550,0.7963636363636364,40,360,400,692,170,36,354,272,2362,2012_Monta Ellis
2012,Reggie Evans,PF,31,34,72,0.4722222222222222,0,0,NaN,34,72,0.4722222222222222,36,71,0.5070422535211268,100,171,271,17,31,6,44,118,104,2012_Reggie Evans
2012,Udonis Haslem,PF,31,151,357,0.42296918767507,0,0,NaN,151,357,0.42296918767507,83,102,0.8137254901960784,117,353,470,42,35,24,60,142,385,2012_Udonis Haslem
2012,Yi Jianlian,PF,24,31,82,0.3780487804878049,3,10,0.3,28,72,0.3888888888888889,14,21,0.6666666666666666,12,37,49,5,7,8,14,23,79,2012_Yi Jianlian
2013,Ben Gordon,SG,29,310,760,0.40789473684210525,113,292,0.386986301369863,197,468,0.42094017094017094,107,127,0.84251968503937,18,112,130,141,35,16,136,134,840,2013_Ben Gordon
2013,Ben Hansbrough,PG,25,15,45,0.3333333333333333,6,23,0.2608695652173913,9,22,0.4090909090909091,21,27,0.7777777777777778,2,16,18,21,7,2,18,23,57,2013_Ben Hansbrough
2013,Chandler Parsons,SF,24,456,939,0.48562300319488816,152,395,0.3848101265822785,304,544,0.5588235294117647,113,155,0.7290322580645161,79,325,404,269,75,32,147,148,1177,2013_Chandler Parsons
2013,Gustavo Ayon,C,27,184,334,0.5508982035928144,0,0,NaN,184,334,0.5508982035928144,40,100,0.4,120,278,398,142,44,34,94,214,408,2013_Gustavo Ayon
2013,Lance Thomas,SF,24,53,106,0.5,0,0,NaN,53,106,0.5,43,59,0.7288135593220338,44,71,115,17,11,7,14,78,149,2013_Lance Thomas
2013,Mirza Teletovic,PF,27,71,185,0.3837837837837838,37,108,0.3425925925925926,34,77,0.44155844155844154,9,11,0.8181818181818182,33,62,95,23,13,8,20,53,188,2013_Mirza Teletovic
2013,Monta Ellis,SG,27,597,1436,0.4157381615598886,94,328,0.2865853658536585,503,1108,0.453971119133574,289,374,0.7727272727272727,45,271,316,496,169,36,254,164,1577,2013_Monta Ellis
2013,Rodney Stuckey,SG,26,304,748,0.40641711229946526,55,182,0.3021978021978022,249,566,0.43992932862190814,213,272,0.7830882352941176,43,169,212,270,51,17,134,127,876,2013_Rodney Stuckey
2013,Tim Ohlbrecht,C,24,1,3,0.3333333333333333,0,0,NaN,1,3,0.3333333333333333,1,1,1.0,0,1,1,1,1,0,4,1,3,2013_Tim Ohlbrecht
2013,Udonis Haslem,PF,32,129,251,0.5139442231075697,0,0,NaN,129,251,0.5139442231075697,32,45,0.7111111111111111,97,307,404,38,30,15,45,173,290,2013_Udonis Haslem
2014,Beno Udrih,SG,31,156,356,0.43820224719101125,38,84,0.4523809523809524,118,272,0.4338235294117647,50,60,0.8333333333333334,20,98,118,232,46,8,94,100,400,2014_Beno Udrih
2014,Derek Fisher,SG,39,141,361,0.39058171745152354,88,229,0.38427947598253276,53,132,0.4015151515151515,55,71,0.7746478873239436,12,110,122,117,70,3,49,157,425,2014_Derek Fisher
2014,Dexter Pittman,C,25,0,1,0.0,0,0,NaN,0,1,0.0,0,2,0.0,3,0,3,0,0,0,0,0,0,2014_Dexter Pittman
2014,Gorgui Dieng,C,24,113,227,0.4977973568281938,1,1,1.0,112,226,0.49557522123893805,59,93,0.6344086021505376,103,197,300,39,30,50,54,108,286,2014_Gorgui Dieng
2014,JaVale McGee,C,26,17,38,0.4473684210526316,0,0,NaN,17,38,0.4473684210526316,1,1,1.0,10,7,17,2,1,7,8,16,35,2014_JaVale McGee
2014,James Anderson,SG,24,309,717,0.4309623430962343,115,351,0.32763532763532766,194,366,0.5300546448087432,77,106,0.7264150943396226,59,241,300,149,74,28,106,154,810,2014_James Anderson
2014,Jeremy Lin,PG,25,295,662,0.44561933534743203,82,229,0.35807860262008734,213,433,0.49191685912240185,218,265,0.8226415094339623,34,153,187,294,68,27,176,166,890,2014_Jeremy Lin
2014,Kendrick Perkins,C,29,87,193,0.45077720207253885,0,1,0.0,87,192,0.453125,37,67,0.5522388059701493,82,223,305,67,26,32,90,177,211,2014_Kendrick Perkins
2014,Kris Humphries,PF,28,231,461,0.5010845986984815,0,2,0.0,231,459,0.5032679738562091,117,144,0.8125,127,282,409,67,31,61,64,136,579,2014_Kris Humphries
2014,Lorenzo Brown,PG,23,26,86,0.3023255813953488,3,30,0.1,23,56,0.4107142857142857,9,13,0.6923076923076923,8,20,28,41,13,3,16,19,64,2014_Lorenzo Brown
2014,Mirza Teletovic,SF,28,221,529,0.41776937618147447,136,349,0.38968481375358166,85,180,0.4722222222222222,44,62,0.7096774193548387,60,206,266,57,29,23,54,143,622,2014_Mirza Teletovic
2014,Monta Ellis,SG,28,576,1278,0.4507042253521127,69,209,0.33014354066985646,507,1069,0.47427502338634236,339,430,0.7883720930232558,38,257,295,471,141,23,264,197,1560,2014_Monta Ellis
2014,Paul Millsap,PF,28,483,1047,0.46131805157593125,76,212,0.3584905660377358,407,835,0.4874251497005988,286,391,0.731457800511509,154,473,627,232,129,78,185,210,1328,2014_Paul Millsap
2014,Robert Sacre,C,24,143,300,0.4766666666666667,0,0,NaN,143,300,0.4766666666666667,64,94,0.6808510638297872,82,172,254,51,24,47,44,134,350,2014_Robert Sacre
2014,Udonis Haslem,PF,33,74,146,0.5068493150684932,0,0,NaN,74,146,0.5068493150684932,25,44,0.5681818181818182,42,133,175,13,11,15,24,79,173,2014_Udonis Haslem
2015,Allen Crabbe,SG,22,63,153,0.4117647058823529,30,85,0.35294117647058826,33,68,0.4852941176470588,12,16,0.75,7,66,73,39,19,15,15,74,168,2015_Allen Crabbe
2015,Anderson Varejao,C,32,111,200,0.555,0,2,0.0,111,198,0.5606060606060606,33,45,0.7333333333333333,57,113,170,35,19,16,35,58,255,2015_Anderson Varejao
2015,Andrew Bogut,C,30,200,355,0.5633802816901409,0,0,NaN,200,355,0.5633802816901409,22,42,0.5238095238095238,141,402,543,180,39,113,106,188,422,2015_Andrew Bogut
2015,C.J. Wilcox,SG,24,16,38,0.42105263157894735,7,19,0.3684210526315789,9,19,0.47368421052631576,2,2,1.0,1,6,7,8,3,1,10,7,41,2015_C.J. Wilcox
2015,David Wear,PF,24,0,2,0.0,0,1,0.0,0,1,0.0,0,0,NaN,2,0,2,1,0,0,0,1,0,2015_David Wear
2015,Giannis Antetokounmpo,SG,20,383,780,0.491025641025641,7,44,0.1590909090909091,376,736,0.5108695652173914,257,347,0.7406340057636888,100,442,542,207,73,85,173,254,1030,2015_Giannis Antetokounmpo
2015,Glenn Robinson,SF_SG_SG-SF,21,52,134,0.3880597014925373,10,38,0.2631578947368421,42,96,0.4375,32,48,0.6666666666666666,30,48,78,22,12,2,22,30,146,2015_Glenn Robinson
2015,Jared Cunningham,SG,23,12,33,0.36363636363636365,4,13,0.3076923076923077,8,20,0.4,7,13,0.5384615384615384,1,8,9,10,3,0,7,12,35,2015_Jared Cunningham
2015,Johnny O'Bryant,PF,21,44,120,0.36666666666666664,0,0,NaN,44,120,0.36666666666666664,12,27,0.4444444444444444,26,38,64,17,5,4,25,44,100,2015_Johnny O'Bryant
2015,Lorenzo Brown,PG,24,52,122,0.4262295081967213,6,28,0.21428571428571427,46,94,0.48936170212765956,12,19,0.631578947368421,14,56,70,90,28,6,30,49,122,2015_Lorenzo Brown
2015,Luigi Datome,SF,27,86,178,0.48314606741573035,36,80,0.45,50,98,0.5102040816326531,2,2,1.0,6,52,58,18,4,14,18,30,210,2015_Luigi Datome
2015,Markel Brown,SG,23,76,210,0.3619047619047619,17,64,0.265625,59,146,0.4041095890410959,47,57,0.8245614035087719,16,91,107,39,31,12,27,57,216,2015_Markel Brown
2015,Mirza Teletovic,PF,29,122,319,0.3824451410658307,62,193,0.32124352331606215,60,126,0.47619047619047616,33,46,0.717391304347826,27,167,194,46,14,16,53,74,339,2015_Mirza Teletovic
2015,Monta Ellis,SG,29,602,1354,0.4446085672082718,81,284,0.2852112676056338,521,1070,0.4869158878504673,228,303,0.7524752475247525,34,156,190,329,148,25,198,197,1513,2015_Monta Ellis
2015,Nate Wolters,PG,23,40,114,0.3508771929824561,0,14,0.0,40,100,0.4,4,12,0.3333333333333333,16,52,68,42,16,4,26,36,84,2015_Nate Wolters
2015,Pablo Prigioni,PG,37,182,456,0.3991228070175439,114,332,0.3433734939759036,68,124,0.5483870967741935,70,82,0.8536585365853658,60,178,238,342,158,2,124,176,548,2015_Pablo Prigioni
2015,Rodney Hood,SG,22,155,374,0.4144385026737968,62,170,0.36470588235294116,93,204,0.45588235294117646,61,80,0.7625,9,108,117,83,30,12,45,119,433,2015_Rodney Hood
2015,Udonis Haslem,PF,34,107,239,0.4476987447698745,2,10,0.2,105,229,0.4585152838427948,45,64,0.703125,71,187,258,46,21,13,41,113,261,2015_Udonis Haslem
2016,Aaron Gordon,PF,20,274,579,0.47322970639032813,42,142,0.29577464788732394,232,437,0.5308924485125858,129,193,0.6683937823834197,154,353,507,128,59,55,66,153,719,2016_Aaron Gordon
2016,Al Horford,C,29,529,1048,0.5047709923664122,88,256,0.34375,441,792,0.5568181818181818,103,129,0.7984496124031008,148,448,596,263,68,121,107,163,1249,2016_Al Horford
2016,Bojan Bogdanovic,SF,26,324,749,0.4325767690253672,129,338,0.3816568047337278,195,411,0.4744525547445255,110,132,0.8333333333333334,36,219,255,99,29,5,115,119,887,2016_Bojan Bogdanovic
2016,C.J. Wilcox,SG,25,26,66,0.3939393939393939,9,23,0.391304347826087,17,43,0.3953488372093023,9,12,0.75,1,11,12,10,10,2,2,15,70,2016_C.J. Wilcox
2016,Cristiano Felicio,C,23,40,72,0.5555555555555556,0,4,0.0,40,68,0.5882352941176471,25,35,0.7142857142857143,30,72,102,26,6,13,13,31,105,2016_Cristiano Felicio
2016,Devin Harris,PG,32,167,374,0.446524064171123,52,158,0.3291139240506329,115,216,0.5324074074074074,101,140,0.7214285714285714,18,120,138,118,60,13,66,124,487,2016_Devin Harris
2016,Giannis Antetokounmpo,PG,21,513,1013,0.506416584402764,28,109,0.25688073394495414,485,904,0.536504424778761,296,409,0.7237163814180929,113,499,612,345,94,113,208,258,1350,2016_Giannis Antetokounmpo
2016,Johnny O'Bryant,PF,22,86,209,0.41148325358851673,1,1,1.0,85,208,0.40865384615384615,27,40,0.675,65,111,176,32,18,8,31,100,200,2016_Johnny O'Bryant
2016,Larry Nance,PF,23,158,300,0.5266666666666666,1,10,0.1,157,290,0.5413793103448276,32,47,0.6808510638297872,101,211,312,44,54,23,41,124,349,2016_Larry Nance
2016,Lorenzo Brown,PG,25,8,25,0.32,1,8,0.125,7,17,0.4117647058823529,3,4,0.75,0,7,7,11,3,1,9,4,20,2016_Lorenzo Brown
2016,R.J. Hunter,SG,22,36,98,0.3673469387755102,19,63,0.30158730158730157,17,35,0.4857142857142857,6,7,0.8571428571428571,2,35,37,13,14,4,11,29,97,2016_R.J. Hunter
2016,Rodney Hood,SG,23,408,972,0.41975308641975306,161,449,0.3585746102449889,247,523,0.4722753346080306,172,200,0.86,38,229,267,213,73,16,125,202,1149,2016_Rodney Hood
2016,Seth Curry,PG,25,102,224,0.45535714285714285,50,111,0.45045045045045046,52,113,0.46017699115044247,45,54,0.8333333333333334,9,51,60,67,22,3,36,41,299,2016_Seth Curry
2016,Trey Burke,PG,23,262,634,0.41324921135646686,88,256,0.34375,174,378,0.4603174603174603,67,82,0.8170731707317073,18,94,112,148,35,6,80,86,679,2016_Trey Burke
2016,Udonis Haslem,PF,35,23,61,0.3770491803278688,1,9,0.1111111111111111,22,52,0.4230769230769231,12,16,0.75,10,65,75,14,5,2,5,25,59,2016_Udonis Haslem
2016,Vince Carter,SG,39,133,343,0.3877551020408163,59,169,0.34911242603550297,74,174,0.42528735632183906,70,84,0.8333333333333334,31,115,146,56,38,16,35,101,395,2016_Vince Carter
2017,Boris Diaw,PF,34,146,327,0.44648318042813456,20,81,0.24691358024691357,126,246,0.5121951219512195,26,35,0.7428571428571429,46,112,158,170,18,9,87,83,338,2017_Boris Diaw
2017,C.J. Wilcox,SG,26,8,31,0.25806451612903225,3,15,0.2,5,16,0.3125,2,2,1.0,4,8,12,12,2,1,6,8,21,2017_C.J. Wilcox
2017,Cristiano Felicio,C,24,128,222,0.5765765765765766,0,0,NaN,128,222,0.5765765765765766,60,93,0.6451612903225806,124,187,311,40,25,16,33,110,316,2017_Cristiano Felicio
2017,Derrick Jones,SF,19,68,121,0.5619834710743802,3,11,0.2727272727272727,65,110,0.5909090909090909,29,41,0.7073170731707317,39,40,79,12,14,13,13,63,168,2017_Derrick Jones
2017,Giannis Antetokounmpo,SF,22,656,1259,0.5210484511517077,49,180,0.2722222222222222,607,1079,0.5625579240037072,471,612,0.7696078431372549,142,558,700,434,131,151,234,246,1832,2017_Giannis Antetokounmpo
2017,James Harden,PG,27,674,1533,0.43966079582517936,262,756,0.34656084656084657,412,777,0.5302445302445302,746,881,0.8467650397275823,95,564,659,906,120,37,464,215,2356,2017_James Harden
2017,Jaylen Brown,SF,20,192,423,0.45390070921985815,46,135,0.34074074074074073,146,288,0.5069444444444444,85,124,0.6854838709677419,45,175,220,64,35,18,68,142,515,2017_Jaylen Brown
2017,Johnny O'Bryant,PF,23,30,60,0.5,6,12,0.5,24,48,0.5,10,12,0.8333333333333334,18,20,38,12,0,2,12,20,76,2017_Johnny O'Bryant
2017,Kevin Love,PF,28,370,867,0.42675893886966554,145,389,0.37275064267352187,225,478,0.4707112970711297,257,295,0.8711864406779661,148,518,666,116,53,22,122,125,1142,2017_Kevin Love
2017,Kyle Singler,SF,28,34,83,0.40963855421686746,7,37,0.1891891891891892,27,46,0.5869565217391305,13,17,0.7647058823529411,8,40,48,9,7,5,11,29,88,2017_Kyle Singler
2017,Larry Nance,PF,24,190,361,0.5263157894736842,10,36,0.2777777777777778,180,325,0.5538461538461539,59,80,0.7375,120,249,369,96,82,40,56,149,449,2017_Larry Nance
2017,Marco Belinelli,SG,30,264,615,0.4292682926829268,102,283,0.36042402826855124,162,332,0.4879518072289157,150,168,0.8928571428571429,14,164,178,147,44,9,70,90,780,2017_Marco Belinelli
2017,Marquese Chriss,PF,19,284,632,0.44936708860759494,72,224,0.32142857142857145,212,408,0.5196078431372549,113,181,0.6243093922651933,96,252,348,60,67,70,108,263,753,2017_Marquese Chriss
2017,R.J. Hunter,SG,23,0,1,0.0,0,1,0.0,0,0,NaN,0,0,NaN,0,1,1,0,0,0,0,0,0,2017_R.J. Hunter
2017,Rodney Hood,SG,24,272,666,0.4084084084084084,114,307,0.3713355048859935,158,359,0.4401114206128134,90,115,0.782608695652174,16,186,202,96,38,11,65,132,748,2017_Rodney Hood
2017,Rodney McGruder,SG,25,190,460,0.41304347826086957,73,220,0.33181818181818185,117,240,0.4875,44,71,0.6197183098591549,95,162,257,124,45,18,56,140,497,2017_Rodney McGruder
2017,Shabazz Napier,PG,25,73,183,0.3989071038251366,34,92,0.3695652173913043,39,91,0.42857142857142855,38,49,0.7755102040816326,8,53,61,67,32,2,41,38,218,2017_Shabazz Napier
2017,Udonis Haslem,C,36,11,23,0.4782608695652174,0,3,0.0,11,20,0.55,9,15,0.6,8,28,36,6,5,1,8,22,31,2017_Udonis Haslem
2003,Dajuan Wagner,SG,19,223,605,0.3685950413223141,55,174,0.3160919540229885,168,431,0.38979118329466356,128,160,0.8,20,62,82,130,38,7,85,107,629,2003_Dajuan Wagner
2003,Eduardo Najera,SF,26,129,231,0.5584415584415584,0,1,0.0,129,230,0.5608695652173913,62,91,0.6813186813186813,90,133,223,47,40,22,23,129,320,2003_Eduardo Najera
2003,Jared Jeffries,SF,21,30,63,0.47619047619047616,3,6,0.5,27,57,0.47368421052631576,16,29,0.5517241379310345,26,32,58,16,8,5,21,28,79,2003_Jared Jeffries
2003,Junior Harrington,PG,22,169,467,0.3618843683083512,7,28,0.25,162,439,0.3690205011389522,73,112,0.6517857142857143,44,206,250,277,80,15,157,250,418,2003_Junior Harrington
2003,Keith Van,PF,27,459,952,0.48214285714285715,65,176,0.3693181818181818,394,776,0.5077319587628866,193,240,0.8041666666666667,159,365,524,93,63,30,150,251,1176,2003_Keith Van
2003,Kirk Haston,SF,23,2,17,0.11764705882352941,0,3,0.0,2,14,0.14285714285714285,2,4,0.5,0,7,7,3,0,5,7,10,6,2003_Kirk Haston
2003,Michael Finley,SF,29,507,1193,0.42497904442581724,119,322,0.3695652173913043,388,871,0.4454649827784156,198,230,0.8608695652173913,107,295,402,205,76,21,114,105,1331,2003_Michael Finley
2003,Michael Olowokandi,C,27,186,436,0.42660550458715596,0,0,NaN,186,436,0.42660550458715596,69,105,0.6571428571428571,57,271,328,47,18,79,98,110,441,2003_Michael Olowokandi
2003,Paul Shirley,PF,25,0,4,0.0,0,0,NaN,0,4,0.0,0,0,NaN,0,1,1,0,0,0,0,0,0,2003_Paul Shirley
2003,Richard Jefferson,SF,22,456,911,0.5005488474204172,6,24,0.25,450,887,0.5073280721533259,324,436,0.7431192660550459,150,364,514,201,80,44,156,216,1242,2003_Richard Jefferson
2003,Stacey Augmon,SG,34,79,192,0.4114583333333333,0,7,0.0,79,185,0.42702702702702705,54,72,0.75,26,93,119,69,27,9,40,80,212,2003_Stacey Augmon
2004,Carmelo Anthony,SF,19,624,1465,0.425938566552901,69,214,0.32242990654205606,555,1251,0.44364508393285373,408,525,0.7771428571428571,183,315,498,227,97,41,247,225,1725,2004_Carmelo Anthony
2004,Chris Mihm,C_PF_C-PF,24,372,762,0.4881889763779528,0,0,NaN,372,762,0.4881889763779528,220,332,0.6626506024096386,312,514,826,42,74,126,180,416,964,2004_Chris Mihm
2004,Curtis Borchardt,C,23,22,56,0.39285714285714285,0,1,0.0,22,55,0.4,14,18,0.7777777777777778,13,41,54,15,4,14,18,40,58,2004_Curtis Borchardt
2004,Darrick Martin,PG,32,20,67,0.29850746268656714,6,26,0.23076923076923078,14,41,0.34146341463414637,9,9,1.0,2,5,7,23,2,1,7,23,55,2004_Darrick Martin
2004,Greg Buckner,SG,27,66,175,0.37714285714285717,12,44,0.2727272727272727,54,131,0.4122137404580153,20,27,0.7407407407407407,28,75,103,45,21,4,34,77,164,2004_Greg Buckner
2004,Keith Bogans,SF,23,183,454,0.40308370044052866,67,187,0.3582887700534759,116,267,0.4344569288389513,65,103,0.6310679611650486,106,211,317,98,46,10,75,128,498,2004_Keith Bogans
2004,Keith Van,SF,28,820,1806,0.4540420819490587,186,466,0.39914163090128757,634,1340,0.47313432835820896,498,580,0.8586206896551725,298,704,1002,240,136,66,338,430,2324,2004_Keith Van
2004,Lamar Odom,PF,24,485,1127,0.4303460514640639,61,205,0.2975609756097561,424,922,0.4598698481561822,340,458,0.74235807860262,160,616,776,327,85,71,236,273,1371,2004_Lamar Odom
2004,Linton Johnson,SF,23,72,203,0.35467980295566504,7,33,0.21212121212121213,65,170,0.38235294117647056,22,37,0.5945945945945946,59,124,183,27,37,32,37,90,173,2004_Linton Johnson
2004,Richard Jefferson,SF,23,555,1115,0.4977578475336323,48,132,0.36363636363636365,507,983,0.5157680569684638,357,468,0.7628205128205128,109,355,464,315,92,28,198,224,1515,2004_Richard Jefferson
2004,Stacey Augmon,SF,35,143,347,0.41210374639769454,1,7,0.14285714285714285,142,340,0.4176470588235294,110,139,0.7913669064748201,52,122,174,85,55,15,76,114,397,2004_Stacey Augmon
2004,Tim Thomas,SF,26,726,1626,0.44649446494464945,146,388,0.37628865979381443,580,1238,0.46849757673667203,342,436,0.7844036697247706,128,512,640,248,128,40,232,392,1940,2004_Tim Thomas
2004,Tracy Murray,SF,32,3,12,0.25,2,5,0.4,1,7,0.14285714285714285,0,1,0.0,3,2,5,1,1,0,2,3,8,2004_Tracy Murray
2005,Andres Nocioni,SF,25,241,601,0.40099833610648916,25,97,0.25773195876288657,216,504,0.42857142857142855,170,222,0.7657657657657657,69,317,386,122,37,34,135,208,677,2005_Andres Nocioni
2005,Charlie Ward,PG,34,24,77,0.3116883116883117,16,51,0.3137254901960784,8,26,0.3076923076923077,11,13,0.8461538461538461,6,33,39,43,15,0,18,22,75,2005_Charlie Ward
2005,Damone Brown,SF,25,23,62,0.3709677419354839,4,11,0.36363636363636365,19,51,0.37254901960784315,4,9,0.4444444444444444,10,18,28,14,1,6,15,17,54,2005_Damone Brown
2005,Dorell Wright,SF,19,3,11,0.2727272727272727,0,4,0.0,3,7,0.42857142857142855,1,1,1.0,0,1,1,3,4,0,3,2,7,2005_Dorell Wright
2005,Erick Strickland,SG,31,114,304,0.375,21,83,0.25301204819277107,93,221,0.42081447963800905,52,64,0.8125,11,92,103,115,30,1,64,103,301,2005_Erick Strickland
2005,Glenn Robinson,SF,32,34,77,0.44155844155844154,2,6,0.3333333333333333,32,71,0.4507042253521127,20,23,0.8695652173913043,4,20,24,8,4,3,7,19,90,2005_Glenn Robinson
2005,Junior Harrington,SG,24,64,178,0.3595505617977528,6,19,0.3157894736842105,58,159,0.36477987421383645,29,35,0.8285714285714286,13,50,63,62,25,5,41,72,163,2005_Junior Harrington
2005,Keith Van,SF-PF_SF_PF,29,514,1128,0.45567375886524825,108,284,0.38028169014084506,406,844,0.48104265402843605,256,314,0.8152866242038217,178,410,588,150,72,42,162,340,1392,2005_Keith Van
2005,Michael Redd,SG,25,625,1418,0.4407616361071932,104,293,0.35494880546075086,521,1125,0.4631111111111111,369,432,0.8541666666666666,72,240,312,172,63,8,133,152,1723,2005_Michael Redd
2005,Nenad Krstic,PF,21,281,570,0.49298245614035086,0,2,0.0,281,568,0.49471830985915494,185,255,0.7254901960784313,161,240,401,77,32,63,112,280,747,2005_Nenad Krstic
2005,Predrag Drobnjak,C,29,238,543,0.43830570902394106,25,71,0.352112676056338,213,472,0.451271186440678,96,120,0.8,73,165,238,49,42,24,78,138,597,2005_Predrag Drobnjak
2005,Richard Jefferson,SF,24,238,564,0.4219858156028369,30,89,0.33707865168539325,208,475,0.4378947368421053,227,269,0.8438661710037175,49,191,240,133,33,17,132,109,733,2005_Richard Jefferson
2005,Rick Brunson,PG,32,166,442,0.3755656108597285,48,130,0.36923076923076925,118,312,0.3782051282051282,57,74,0.7702702702702703,23,164,187,410,82,7,125,106,437,2005_Rick Brunson
2005,Stacey Augmon,SF,36,68,167,0.40718562874251496,0,0,NaN,68,167,0.40718562874251496,57,77,0.7402597402597403,45,54,99,36,23,8,31,83,193,2005_Stacey Augmon
2005,Trevor Ariza,SF,19,172,389,0.442159383033419,3,13,0.23076923076923078,169,376,0.449468085106383,121,174,0.6954022988505747,89,153,242,85,70,18,73,150,468,2005_Trevor Ariza
2006,Alan Henderson,C,33,47,91,0.5164835164835165,0,0,NaN,47,91,0.5164835164835165,33,49,0.673469387755102,60,77,137,10,9,12,22,58,127,2006_Alan Henderson
2006,Carlos Delfino,SG,23,91,226,0.4026548672566372,20,60,0.3333333333333333,71,166,0.42771084337349397,45,67,0.6716417910447762,28,85,113,44,21,15,36,86,247,2006_Carlos Delfino
2006,Charlie Villanueva,PF,21,435,940,0.4627659574468085,70,214,0.32710280373831774,365,726,0.5027548209366391,113,160,0.70625,181,340,521,88,60,63,99,247,1053,2006_Charlie Villanueva
2006,Gerald Green,SG,20,66,138,0.4782608695652174,6,20,0.3,60,118,0.5084745762711864,29,37,0.7837837837837838,10,31,41,18,13,4,22,41,167,2006_Gerald Green
2006,Linas Kleiza,PF,21,77,173,0.44508670520231214,2,13,0.15384615384615385,75,160,0.46875,57,81,0.7037037037037037,38,78,116,15,10,13,16,87,213,2006_Linas Kleiza
2006,Lindsey Hunter,PG,35,37,100,0.37,11,43,0.2558139534883721,26,57,0.45614035087719296,2,4,0.5,10,30,40,62,19,1,20,44,87,2006_Lindsey Hunter
2006,Matt Walsh,SG,23,1,1,1.0,0,0,NaN,1,1,1.0,0,2,0.0,0,0,0,0,0,0,1,0,2,2006_Matt Walsh
2006,Richard Jefferson,SF,25,495,1005,0.4925373134328358,60,188,0.3191489361702128,435,817,0.5324357405140759,471,580,0.8120689655172414,95,439,534,297,59,17,174,193,1521,2006_Richard Jefferson
2006,Ryan Bowen,SF,30,37,124,0.29838709677419356,3,22,0.13636363636363635,34,102,0.3333333333333333,11,14,0.7857142857142857,31,57,88,24,21,6,13,85,88,2006_Ryan Bowen
2006,Sasha Pavlovic,SG,22,87,212,0.41037735849056606,35,96,0.3645833333333333,52,116,0.4482758620689655,32,49,0.6530612244897959,16,64,80,25,19,6,42,103,241,2006_Sasha Pavlovic
2006,Stacey Augmon,SF,37,25,73,0.3424657534246575,0,0,NaN,25,73,0.3424657534246575,21,30,0.7,18,35,53,23,12,6,11,40,71,2006_Stacey Augmon
2007,Adrian Griffin,SF,32,61,129,0.4728682170542636,0,6,0.0,61,123,0.4959349593495935,15,19,0.7894736842105263,40,69,109,59,32,4,38,78,137,2007_Adrian Griffin
2007,Andre Brown,PF,25,42,74,0.5675675675675675,0,1,0.0,42,73,0.5753424657534246,9,15,0.6,26,48,74,2,6,4,29,26,93,2007_Andre Brown
2007,Cedric Bozeman,SG,23,11,39,0.28205128205128205,2,13,0.15384615384615385,9,26,0.34615384615384615,2,6,0.3333333333333333,3,20,23,9,5,2,9,32,26,2007_Cedric Bozeman
2007,Chris Bosh,C,22,543,1094,0.4963436928702011,12,35,0.34285714285714286,531,1059,0.5014164305949008,463,590,0.7847457627118644,186,555,741,175,39,90,179,163,1561,2007_Chris Bosh
2007,John Salmons,SG,27,236,517,0.4564796905222437,40,112,0.35714285714285715,196,405,0.4839506172839506,159,204,0.7794117647058824,47,217,264,254,73,27,119,177,671,2007_John Salmons
2007,Junior Harrington,PG,26,57,137,0.41605839416058393,7,26,0.2692307692307692,50,111,0.45045045045045046,31,46,0.6739130434782609,12,56,68,89,21,5,52,79,152,2007_Junior Harrington
2007,Luke Ridnour,PG,25,301,695,0.4330935251798561,49,139,0.35251798561151076,252,556,0.45323741007194246,128,159,0.8050314465408805,28,136,164,368,83,19,156,181,779,2007_Luke Ridnour
2007,Othella Harrington,PF,33,25,56,0.44642857142857145,0,0,NaN,25,56,0.44642857142857145,17,22,0.7727272727272727,13,25,38,6,1,1,15,49,67,2007_Othella Harrington
2007,Paul Davis,C,22,22,52,0.4230769230769231,0,0,NaN,22,52,0.4230769230769231,7,10,0.7,21,23,44,7,6,5,8,28,51,2007_Paul Davis
2007,Quentin Richardson,SF,26,228,545,0.41834862385321103,97,258,0.375968992248062,131,287,0.4564459930313589,83,120,0.6916666666666667,65,287,352,108,36,7,70,133,636,2007_Quentin Richardson
2007,Rawle Marshall,SG,24,32,89,0.3595505617977528,4,18,0.2222222222222222,28,71,0.39436619718309857,31,45,0.6888888888888889,8,21,29,13,12,5,19,22,99,2007_Rawle Marshall
2007,Richard Jefferson,SF,26,303,665,0.4556390977443609,52,145,0.3586206896551724,251,520,0.4826923076923077,239,326,0.7331288343558282,48,192,240,148,34,8,120,123,897,2007_Richard Jefferson
2007,Scot Pollard,C,31,11,26,0.4230769230769231,0,0,NaN,11,26,0.4230769230769231,2,4,0.5,15,16,31,3,4,1,4,27,24,2007_Scot Pollard
2007,Viktor Khryapa,PF,24,27,70,0.38571428571428573,0,6,0.0,27,64,0.421875,19,26,0.7307692307692307,20,37,57,21,10,1,16,53,73,2007_Viktor Khryapa
2008,Andre Brown,PF,26,39,78,0.5,0,0,NaN,39,78,0.5,22,49,0.4489795918367347,37,55,92,8,7,4,14,38,100,2008_Andre Brown
2008,Antoine Wright,SG,23,272,658,0.4133738601823708,64,220,0.2909090909090909,208,438,0.4748858447488584,92,134,0.6865671641791045,80,214,294,160,56,42,100,254,700,2008_Antoine Wright
2008,Ben Gordon,SG,24,464,1069,0.43405051449953225,142,346,0.41040462427745666,322,723,0.44536652835408025,266,293,0.9078498293515358,40,181,221,213,55,8,150,171,1336,2008_Ben Gordon
2008,Cheikh Samb,C,23,3,4,0.75,0,0,NaN,3,4,0.75,1,2,0.5,3,4,7,0,1,2,1,8,7,2008_Cheikh Samb
2008,Richard Jefferson,SF,27,619,1328,0.4661144578313253,77,213,0.3615023474178404,542,1115,0.4860986547085202,542,679,0.7982326951399117,93,249,342,252,76,21,199,225,1857,2008_Richard Jefferson
2008,Rodney Stuckey,PG,21,153,382,0.4005235602094241,3,16,0.1875,150,366,0.4098360655737705,127,156,0.8141025641025641,32,97,129,160,49,6,78,113,436,2008_Rodney Stuckey
2008,Shaquille O'Neal,C,35,662,1116,0.5931899641577061,0,0,NaN,662,1116,0.5931899641577061,340,676,0.5029585798816568,332,776,1108,186,64,176,362,456,1664,2008_Shaquille O'Neal
2008,Tony Allen,SG,26,169,389,0.43444730077120824,18,57,0.3157894736842105,151,332,0.45481927710843373,138,181,0.7624309392265194,34,134,168,114,62,21,109,168,494,2008_Tony Allen
2009,Andre Brown,PF,27,1,7,0.14285714285714285,0,0,NaN,1,7,0.14285714285714285,2,2,1.0,7,5,12,1,1,0,5,9,4,2009_Andre Brown
2009,Cheikh Samb,C,24,12,64,0.1875,0,6,0.0,12,58,0.20689655172413793,6,14,0.42857142857142855,20,28,48,2,6,20,6,14,30,2009_Cheikh Samb
2009,D.J. Augustin,PG,21,267,621,0.42995169082125606,108,246,0.43902439024390244,159,375,0.424,208,233,0.8927038626609443,17,116,133,250,42,2,119,140,850,2009_D.J. Augustin
2009,Derek Fisher,PG,34,292,688,0.42441860465116277,120,302,0.3973509933774834,172,386,0.44559585492227977,110,130,0.8461538461538461,25,163,188,261,95,6,72,187,814,2009_Derek Fisher
2009,Dontell Jefferson,SG,25,11,22,0.5,1,2,0.5,10,20,0.5,6,9,0.6666666666666666,1,11,12,9,4,1,6,9,29,2009_Dontell Jefferson
2009,Emeka Okafor,C,26,433,772,0.560880829015544,0,0,NaN,433,772,0.560880829015544,219,369,0.5934959349593496,275,552,827,53,48,136,144,247,1085,2009_Emeka Okafor
2009,JaVale McGee,C,21,191,387,0.4935400516795866,0,0,NaN,191,387,0.4935400516795866,107,162,0.6604938271604939,120,174,294,23,33,75,61,155,489,2009_JaVale McGee
2009,Juan Dixon,PG,30,101,256,0.39453125,25,75,0.3333333333333333,76,181,0.4198895027624309,34,39,0.8717948717948718,8,59,67,118,35,6,70,74,261,2009_Juan Dixon
2009,Kendrick Perkins,C,24,276,478,0.5774058577405857,0,2,0.0,276,476,0.5798319327731093,96,160,0.6,204,415,619,96,22,150,165,253,648,2009_Kendrick Perkins
2009,Kris Humphries,SF,23,38,90,0.4222222222222222,0,0,NaN,38,90,0.4222222222222222,38,48,0.7916666666666666,24,46,70,10,8,6,8,31,114,2009_Kris Humphries
2009,Oleksiy Pecherov,C,23,39,101,0.38613861386138615,14,43,0.32558139534883723,25,58,0.43103448275862066,24,29,0.8275862068965517,35,41,76,2,6,3,10,34,116,2009_Oleksiy Pecherov
2009,Paul Millsap,PF,23,400,749,0.5340453938584779,0,4,0.0,400,745,0.5369127516778524,228,326,0.6993865030674846,251,403,654,138,78,73,129,288,1028,2009_Paul Millsap
2009,Richard Jefferson,SF,28,537,1222,0.43944353518821605,116,292,0.3972602739726027,421,930,0.45268817204301076,417,518,0.805019305019305,57,317,374,199,66,14,165,252,1607,2009_Richard Jefferson
2009,Stephen Jackson,SF,30,413,997,0.41424272818455365,103,305,0.3377049180327869,310,692,0.4479768786127168,294,356,0.8258426966292135,70,233,303,381,88,31,229,153,1223,2009_Stephen Jackson
2010,Alexis Ajinca,C,21,5,10,0.5,0,0,NaN,5,10,0.5,0,1,0.0,1,3,4,0,1,1,2,5,10,2010_Alexis Ajinca
2010,Anderson Varejao,PF,27,267,467,0.5717344753747323,1,5,0.2,266,462,0.5757575757575758,116,175,0.6628571428571428,189,389,578,87,71,67,67,223,651,2010_Anderson Varejao
2010,Andrew Bogut,C,25,473,910,0.5197802197802198,0,2,0.0,473,908,0.5209251101321586,149,237,0.6286919831223629,208,493,701,127,39,175,131,222,1095,2010_Andrew Bogut
2010,Anthony Randolph,C,20,137,309,0.44336569579288027,1,5,0.2,136,304,0.4473684210526316,109,136,0.8014705882352942,73,142,215,42,28,51,49,92,384,2010_Anthony Randolph
2010,Carmelo Anthony,SF,25,688,1502,0.4580559254327563,59,187,0.3155080213903743,629,1315,0.4783269961977186,508,612,0.8300653594771242,152,302,454,222,88,30,209,225,1943,2010_Carmelo Anthony
2010,Chris Andersen,PF,31,142,251,0.5657370517928287,0,3,0.0,142,248,0.5725806451612904,164,236,0.6949152542372882,147,336,483,33,42,143,59,171,448,2010_Chris Andersen
2010,Dorell Wright,SF,24,194,419,0.4630071599045346,61,157,0.3885350318471338,133,262,0.5076335877862596,61,69,0.8840579710144928,50,185,235,91,52,32,53,94,510,2010_Dorell Wright
2010,Eric Maynor,PG,22,308,736,0.41847826086956524,44,142,0.30985915492957744,264,594,0.4444444444444444,104,144,0.7222222222222222,42,216,258,532,80,20,170,230,764,2010_Eric Maynor
2010,Jeff Ayres,C,22,43,65,0.6615384615384615,0,0,NaN,43,65,0.6615384615384615,18,20,0.9,25,73,98,1,7,16,12,76,104,2010_Jeff Ayres
2010,Joe Alexander,SF,23,1,6,0.16666666666666666,0,1,0.0,1,5,0.2,2,3,0.6666666666666666,2,3,5,2,1,1,0,9,4,2010_Joe Alexander
2010,Jose Calderon,PG,28,274,568,0.4823943661971831,68,171,0.39766081871345027,206,397,0.5188916876574308,83,104,0.7980769230769231,23,119,142,404,47,7,99,135,699,2010_Jose Calderon
2010,Nicolas Batum,SF,21,139,268,0.5186567164179104,54,132,0.4090909090909091,85,136,0.625,43,51,0.8431372549019608,32,109,141,44,24,25,27,83,375,2010_Nicolas Batum
2010,Thabo Sefolosha,SG,25,194,441,0.4399092970521542,41,131,0.31297709923664124,153,310,0.4935483870967742,60,89,0.6741573033707865,76,311,387,145,97,46,90,154,489,2010_Thabo Sefolosha
2011,Alexis Ajinca,C,22,118,266,0.44360902255639095,24,68,0.35294117647058826,94,198,0.47474747474747475,26,36,0.7222222222222222,34,122,156,20,22,38,36,146,286,2011_Alexis Ajinca
2011,Carmelo Anthony,SF,26,1368,3006,0.4550898203592814,190,502,0.3784860557768924,1178,2504,0.4704472843450479,1014,1210,0.8380165289256198,236,890,1126,442,136,92,412,448,3940,2011_Carmelo Anthony
2011,Craig Brackins,PF,23,4,16,0.25,0,5,0.0,4,11,0.36363636363636365,0,0,NaN,2,2,4,1,1,0,0,3,8,2011_Craig Brackins
2011,Devin Harris,PG,27,686,1626,0.4218942189421894,116,360,0.32222222222222224,570,1266,0.45023696682464454,670,804,0.8333333333333334,34,304,338,1006,140,14,414,326,2158,2011_Devin Harris
2011,Dorell Wright,SF,25,485,1146,0.4232111692844677,194,516,0.375968992248062,291,630,0.46190476190476193,180,228,0.7894736842105263,88,343,431,242,124,63,133,171,1344,2011_Dorell Wright
2011,Earl Boykins,PG,34,156,352,0.4431818181818182,27,71,0.38028169014084506,129,281,0.45907473309608543,69,82,0.8414634146341463,15,40,55,141,38,3,52,43,408,2011_Earl Boykins
2011,Eric Maynor,PG,23,134,333,0.4024024024024024,37,96,0.3854166666666667,97,237,0.4092827004219409,43,59,0.7288135593220338,25,96,121,238,35,6,77,96,348,2011_Eric Maynor
2011,Jose Calderon,PG,29,262,596,0.4395973154362416,57,156,0.36538461538461536,205,440,0.4659090909090909,88,103,0.8543689320388349,30,172,202,605,81,7,148,143,669,2011_Jose Calderon
2011,Josh Childress,SG,27,121,214,0.5654205607476636,1,16,0.0625,120,198,0.6060606060606061,29,59,0.4915254237288136,69,86,155,42,33,23,44,68,272,2011_Josh Childress
2011,Nicolas Batum,SF,22,367,807,0.4547707558859975,118,342,0.34502923976608185,249,465,0.535483870967742,138,164,0.8414634146341463,109,252,361,123,68,49,83,194,990,2011_Nicolas Batum
2011,Richard Jefferson,SF,30,304,642,0.4735202492211838,135,307,0.43973941368078173,169,335,0.5044776119402985,148,195,0.7589743589743589,54,256,310,107,38,34,93,164,891,2011_Richard Jefferson
2011,Thabo Sefolosha,SG,26,157,333,0.47147147147147145,28,102,0.27450980392156865,129,231,0.5584415584415584,59,79,0.7468354430379747,65,281,346,111,97,38,55,171,401,2011_Thabo Sefolosha
2011,Zabian Dowdell,PG,26,51,125,0.408,3,10,0.3,48,115,0.41739130434782606,16,17,0.9411764705882353,5,15,20,51,20,2,29,30,121,2011_Zabian Dowdell
2012,Andrew Goudelock,SG,23,68,174,0.39080459770114945,28,75,0.37333333333333335,40,99,0.40404040404040403,11,12,0.9166666666666666,5,26,31,20,4,0,21,32,175,2012_Andrew Goudelock
2012,Boris Diaw,PF,29,312,702,0.4444444444444444,62,198,0.31313131313131315,250,504,0.49603174603174605,44,70,0.6285714285714286,140,420,560,410,68,50,224,250,730,2012_Boris Diaw
2012,Carmelo Anthony,SF,27,441,1025,0.4302439024390244,68,203,0.33497536945812806,373,822,0.4537712895377129,295,367,0.8038147138964578,88,256,344,200,62,24,144,156,1245,2012_Carmelo Anthony
2012,Dorell Wright,SF,26,222,526,0.4220532319391635,105,292,0.3595890410958904,117,234,0.5,80,98,0.8163265306122449,60,218,278,94,58,26,51,97,629,2012_Dorell Wright
2012,Earl Clark,PF,24,51,139,0.3669064748201439,0,0,NaN,51,139,0.3669064748201439,21,29,0.7241379310344828,35,89,124,18,12,32,25,72,123,2012_Earl Clark
2012,Eric Maynor,PG,24,14,39,0.358974358974359,6,17,0.35294117647058826,8,22,0.36363636363636365,4,4,1.0,3,10,13,22,5,0,11,13,38,2012_Eric Maynor
2012,Juwan Howard,PF,38,17,55,0.3090909090909091,0,0,NaN,17,55,0.3090909090909091,8,10,0.8,18,29,47,10,4,1,20,18,42,2012_Juwan Howard
2012,Kemba Walker,PG,21,281,767,0.3663624511082138,69,226,0.3053097345132743,212,541,0.39186691312384475,168,213,0.7887323943661971,30,204,234,289,60,20,119,79,799,2012_Kemba Walker
2012,MarShon Brooks,SG,23,274,640,0.428125,47,150,0.31333333333333335,227,490,0.463265306122449,113,148,0.7635135135135135,70,130,200,131,52,15,118,116,708,2012_MarShon Brooks
2012,Marcus Camby,C,37,256,574,0.445993031358885,4,10,0.4,252,564,0.44680851063829785,58,128,0.453125,314,746,1060,214,100,170,114,252,574,2012_Marcus Camby
2012,Markieff Morris,PF,22,174,436,0.39908256880733944,43,124,0.3467741935483871,131,312,0.4198717948717949,76,106,0.7169811320754716,69,210,279,65,41,42,70,179,467,2012_Markieff Morris
2012,Nicolas Batum,SF,23,289,641,0.45085803432137284,107,274,0.3905109489051095,182,367,0.49591280653950953,133,159,0.8364779874213837,81,190,271,84,57,60,90,105,818,2012_Nicolas Batum
2012,Richard Hamilton,SG,33,140,310,0.45161290322580644,17,46,0.3695652173913043,123,264,0.4659090909090909,29,37,0.7837837837837838,20,46,66,84,12,1,49,56,326,2012_Richard Hamilton
2012,Richard Jefferson,SF,31,406,976,0.41598360655737704,226,538,0.4200743494423792,180,438,0.410958904109589,118,170,0.6941176470588235,52,386,438,176,74,38,100,242,1156,2012_Richard Jefferson
2012,Rudy Fernandez,SG,26,99,225,0.44,40,122,0.32786885245901637,59,103,0.5728155339805825,30,43,0.6976744186046512,9,56,65,75,31,3,40,37,268,2012_Rudy Fernandez
2012,Thabo Sefolosha,SG,27,67,155,0.432258064516129,31,71,0.43661971830985913,36,84,0.42857142857142855,38,43,0.8837209302325582,21,107,128,47,37,17,40,78,203,2012_Thabo Sefolosha
2013,Carmelo Anthony,PF,28,669,1489,0.4492948287441236,157,414,0.37922705314009664,512,1075,0.4762790697674419,425,512,0.830078125,134,326,460,171,52,32,175,205,1920,2013_Carmelo Anthony
2013,Caron Butler,SF,32,305,720,0.4236111111111111,128,330,0.3878787878787879,177,390,0.45384615384615384,75,90,0.8333333333333334,41,182,223,78,51,11,72,139,813,2013_Caron Butler
2013,Derrick Favors,PF,21,274,568,0.4823943661971831,0,5,0.0,274,563,0.4866785079928952,179,260,0.6884615384615385,184,362,546,75,67,130,129,247,727,2013_Derrick Favors
2013,Dorell Wright,SF,27,237,599,0.39565943238731216,135,361,0.3739612188365651,102,238,0.42857142857142855,120,141,0.851063829787234,42,260,302,150,62,35,64,98,729,2013_Dorell Wright
2013,Eric Bledsoe,PG,23,253,568,0.4454225352112676,31,78,0.3974358974358974,222,490,0.4530612244897959,106,134,0.7910447761194029,78,147,225,233,109,55,137,112,643,2013_Eric Bledsoe
2013,Eric Maynor,PG-SG_SG_PG,25,212,562,0.37722419928825623,68,192,0.3541666666666667,144,370,0.3891891891891892,90,124,0.7258064516129032,18,74,92,364,44,2,158,110,582,2013_Eric Maynor
2013,LeBron James,PF,28,765,1354,0.5649926144756278,103,254,0.40551181102362205,662,1100,0.6018181818181818,403,535,0.7532710280373832,97,513,610,551,129,67,226,110,2036,2013_LeBron James
2013,Markieff Morris,PF,23,266,653,0.40735068912710565,45,134,0.3358208955223881,221,519,0.4258188824662813,93,127,0.7322834645669292,131,265,396,108,77,64,104,209,670,2013_Markieff Morris
2013,Matt Carroll,SG,32,0,0,NaN,0,0,NaN,0,0,NaN,0,0,NaN,0,0,0,1,0,0,0,1,0,2013_Matt Carroll
2013,Nicolas Batum,SF,24,352,833,0.4225690276110444,165,444,0.3716216216216216,187,389,0.480719794344473,178,210,0.8476190476190476,97,315,412,360,91,83,190,139,1047,2013_Nicolas Batum
2013,Nikola Pekovic,C,27,385,741,0.5195681511470985,0,0,NaN,385,741,0.5195681511470985,241,324,0.7438271604938271,230,315,545,53,43,50,101,143,1011,2013_Nikola Pekovic
2013,Richard Jefferson,SF,32,62,136,0.45588235294117646,14,45,0.3111111111111111,48,91,0.5274725274725275,38,53,0.7169811320754716,5,79,84,31,14,7,23,45,176,2013_Richard Jefferson
2013,Shawn Marion,PF,34,355,690,0.5144927536231884,23,73,0.3150684931506849,332,617,0.5380875202593193,79,101,0.7821782178217822,146,379,525,163,75,47,103,111,812,2013_Shawn Marion
2013,Terrence Ross,SG,21,186,457,0.40700218818380746,65,196,0.33163265306122447,121,261,0.46360153256704983,30,42,0.7142857142857143,35,109,144,53,43,14,48,122,467,2013_Terrence Ross
2013,Thabo Sefolosha,SG,28,224,466,0.48068669527896996,108,258,0.4186046511627907,116,208,0.5576923076923077,57,69,0.8260869565217391,58,259,317,125,103,44,64,177,613,2013_Thabo Sefolosha
2013,Tyreke Evans,SG,23,366,765,0.47843137254901963,45,133,0.3383458646616541,321,632,0.5079113924050633,210,271,0.7749077490774908,56,231,287,229,90,27,128,133,987,2013_Tyreke Evans
2013,Victor Claver,SF,24,74,189,0.3915343915343915,25,87,0.28735632183908044,49,102,0.4803921568627451,14,30,0.4666666666666667,31,88,119,43,26,12,43,75,187,2013_Victor Claver
2014,Alexis Ajinca,C,25,136,249,0.5461847389558233,0,1,0.0,136,248,0.5483870967741935,56,67,0.835820895522388,94,183,277,40,23,46,63,187,328,2014_Alexis Ajinca
2014,Brandon Knight,PG,22,461,1092,0.42216117216117216,110,338,0.3254437869822485,351,754,0.46551724137931033,259,323,0.8018575851393189,46,209,255,352,69,17,188,146,1291,2014_Brandon Knight
2014,Carmelo Anthony,PF,29,743,1643,0.4522215459525259,167,415,0.40240963855421685,576,1228,0.46905537459283386,459,541,0.8484288354898336,145,477,622,242,95,51,198,224,2112,2014_Carmelo Anthony
2014,Chris Babb,SG,23,8,30,0.26666666666666666,6,27,0.2222222222222222,2,3,0.6666666666666666,0,0,NaN,4,13,17,3,6,0,3,13,22,2014_Chris Babb
2014,DeMarcus Cousins,C,23,591,1191,0.49622166246851385,0,7,0.0,591,1184,0.49915540540540543,432,595,0.7260504201680672,218,613,831,207,109,91,251,270,1614,2014_DeMarcus Cousins
2014,Dorell Wright,SF,28,111,297,0.37373737373737376,69,202,0.3415841584158416,42,95,0.4421052631578947,52,69,0.7536231884057971,29,162,191,64,23,16,39,62,343,2014_Dorell Wright
2014,Eric Maynor,PG,26,64,202,0.31683168316831684,24,74,0.32432432432432434,40,128,0.3125,12,22,0.5454545454545454,18,60,78,104,18,6,58,34,164,2014_Eric Maynor
2014,Jarvis Varnado,PF,25,72,120,0.6,0,0,NaN,72,120,0.6,54,104,0.5192307692307693,38,88,126,26,20,58,20,124,198,2014_Jarvis Varnado
2014,Joel Anthony,C,31,24,64,0.375,0,0,NaN,24,64,0.375,8,16,0.5,30,46,76,4,6,24,6,34,56,2014_Joel Anthony
2014,Julyan Stone,SG,25,7,17,0.4117647058823529,2,8,0.25,5,9,0.5555555555555556,2,3,0.6666666666666666,2,18,20,12,3,0,5,13,18,2014_Julyan Stone
2014,Luis Scola,PF,33,263,560,0.46964285714285714,1,7,0.14285714285714285,262,553,0.47377938517179025,99,136,0.7279411764705882,86,305,391,81,26,16,108,164,626,2014_Luis Scola
2014,Markieff Morris,PF,24,411,845,0.4863905325443787,34,108,0.3148148148148148,377,737,0.5115332428765265,259,327,0.7920489296636085,139,346,485,144,68,51,147,232,1115,2014_Markieff Morris
2014,Nicolas Batum,SF,25,381,819,0.4652014652014652,145,402,0.36069651741293535,236,417,0.565947242206235,163,203,0.8029556650246306,116,495,611,420,75,57,208,156,1070,2014_Nicolas Batum
2014,Richard Jefferson,SF,33,294,654,0.44954128440366975,123,301,0.40863787375415284,171,353,0.48441926345609065,120,162,0.7407407407407407,18,201,219,130,56,14,94,168,831,2014_Richard Jefferson
2014,Terrence Ross,SG,22,318,751,0.4234354194407457,161,408,0.3946078431372549,157,343,0.4577259475218659,82,98,0.8367346938775511,43,209,252,79,64,27,88,183,879,2014_Terrence Ross
2014,Thabo Sefolosha,SG,29,141,340,0.4147058823529412,48,152,0.3157894736842105,93,188,0.4946808510638298,53,69,0.7681159420289855,50,170,220,94,79,17,55,90,383,2014_Thabo Sefolosha
2014,Victor Claver,SF,25,17,42,0.40476190476190477,3,18,0.16666666666666666,14,24,0.5833333333333334,10,11,0.9090909090909091,9,30,39,12,3,3,11,16,47,2014_Victor Claver
2015,Alexis Ajinca,C,26,181,329,0.5501519756838906,0,0,NaN,181,329,0.5501519756838906,81,99,0.8181818181818182,104,211,315,47,21,51,69,151,443,2015_Alexis Ajinca
2015,C.J. Miles,SG,27,329,827,0.3978234582829504,154,446,0.3452914798206278,175,381,0.45931758530183725,130,161,0.8074534161490683,18,196,214,75,60,26,73,132,942,2015_C.J. Miles
2015,Cartier Martin,SF,30,15,53,0.2830188679245283,6,33,0.18181818181818182,9,20,0.45,0,0,NaN,0,20,20,11,3,1,5,20,36,2015_Cartier Martin
2015,David Stockton,PG,23,2,6,0.3333333333333333,1,2,0.5,1,4,0.25,3,6,0.5,0,2,2,9,2,0,4,1,8,2015_David Stockton
2015,Dorell Wright,SF,29,72,190,0.37894736842105264,41,108,0.37962962962962965,31,82,0.3780487804878049,34,42,0.8095238095238095,14,97,111,41,20,11,18,55,219,2015_Dorell Wright
2015,Festus Ezeli,C,25,76,139,0.5467625899280576,0,0,NaN,76,139,0.5467625899280576,49,78,0.6282051282051282,60,95,155,9,7,42,32,77,201,2015_Festus Ezeli
2015,Jerrelle Benimon,PF,23,0,0,NaN,0,0,NaN,0,0,NaN,0,0,NaN,1,2,3,0,0,0,1,0,0,2015_Jerrelle Benimon
2015,Markieff Morris,PF,25,512,1100,0.46545454545454545,57,179,0.31843575418994413,455,921,0.494028230184582,177,232,0.7629310344827587,110,396,506,192,101,39,170,245,1258,2015_Markieff Morris
2015,Nicolas Batum,SF,26,240,600,0.4,100,309,0.32362459546925565,140,291,0.48109965635738833,84,98,0.8571428571428571,62,354,416,341,78,40,132,106,664,2015_Nicolas Batum
2015,Nikola Mirotic,PF,23,253,624,0.40544871794871795,99,313,0.31629392971246006,154,311,0.49517684887459806,228,284,0.8028169014084507,63,341,404,97,54,54,89,172,833,2015_Nikola Mirotic
2015,P.J. Hairston,SG,22,87,269,0.32342007434944237,49,163,0.3006134969325153,38,106,0.3584905660377358,31,36,0.8611111111111112,22,70,92,21,21,13,22,61,254,2015_P.J. Hairston
2015,Richard Jefferson,SF,34,144,324,0.4444444444444444,66,155,0.4258064516129032,78,169,0.46153846153846156,78,114,0.6842105263157895,25,158,183,61,32,11,52,115,432,2015_Richard Jefferson
2015,Terrence Ross,SF,23,309,753,0.4103585657370518,145,390,0.3717948717948718,164,363,0.45179063360881544,44,56,0.7857142857142857,32,194,226,86,53,25,69,136,807,2015_Terrence Ross
2015,Toure' Murry,SG-PG_SG_PG,25,4,10,0.4,0,0,NaN,4,10,0.4,4,4,1.0,2,0,2,2,2,0,8,4,12,2015_Toure' Murry
2015,Travis Wear,SF,24,84,209,0.4019138755980861,11,30,0.36666666666666664,73,179,0.40782122905027934,20,26,0.7692307692307693,31,75,106,40,15,11,35,55,199,2015_Travis Wear
2015,Victor Claver,SF,26,9,20,0.45,6,11,0.5454545454545454,3,9,0.3333333333333333,0,0,NaN,3,17,20,1,1,1,4,12,24,2015_Victor Claver
2016,Aaron Brooks,PG,31,188,469,0.40085287846481876,66,185,0.3567567567567568,122,284,0.4295774647887324,49,64,0.765625,21,80,101,180,30,10,82,132,491,2016_Aaron Brooks
2016,Alexis Ajinca,C,27,150,315,0.47619047619047616,0,1,0.0,150,314,0.47770700636942676,52,62,0.8387096774193549,75,194,269,31,19,36,54,134,352,2016_Alexis Ajinca
2016,Jarell Eddie,SF,24,20,65,0.3076923076923077,15,47,0.3191489361702128,5,18,0.2777777777777778,8,8,1.0,2,21,23,5,5,1,1,5,63,2016_Jarell Eddie
2016,Jeremy Evans,SF,28,26,48,0.5416666666666666,4,16,0.25,22,32,0.6875,15,21,0.7142857142857143,11,43,54,2,6,9,7,19,71,2016_Jeremy Evans
2016,Jordan Adams,SG,21,2,6,0.3333333333333333,0,1,0.0,2,5,0.4,3,5,0.6,0,2,2,3,3,0,2,2,7,2016_Jordan Adams
2016,Luke Babbitt,SF,26,122,289,0.42214532871972316,44,109,0.4036697247706422,78,180,0.43333333333333335,39,50,0.78,25,123,148,53,11,7,23,90,327,2016_Luke Babbitt
2016,Markieff Morris,PF,26,610,1436,0.42479108635097496,94,310,0.3032258064516129,516,1126,0.458259325044405,216,294,0.7346938775510204,146,558,704,248,116,68,270,368,1530,2016_Markieff Morris
2016,Nicolas Batum,SF,27,372,873,0.4261168384879725,139,399,0.3483709273182957,233,474,0.49156118143459915,163,192,0.8489583333333334,55,373,428,403,65,43,205,114,1046,2016_Nicolas Batum
2016,P.J. Hairston,SF,23,290,816,0.3553921568627451,140,482,0.29045643153526973,150,334,0.4491017964071856,100,128,0.78125,50,298,348,76,64,22,82,274,820,2016_P.J. Hairston
2016,Richard Jefferson,SF,35,143,312,0.4583333333333333,66,173,0.3815028901734104,77,139,0.5539568345323741,58,87,0.6666666666666666,15,113,128,59,33,14,43,129,410,2016_Richard Jefferson
2016,Terrence Ross,SF,24,270,626,0.43130990415335463,131,339,0.3864306784660767,139,287,0.4843205574912892,49,62,0.7903225806451613,21,164,185,56,54,25,46,120,720,2016_Terrence Ross
2016,Thaddeus Young,PF,27,495,963,0.514018691588785,7,30,0.23333333333333334,488,933,0.5230439442658092,105,163,0.6441717791411042,176,484,660,135,112,37,136,182,1102,2016_Thaddeus Young
2016,Xavier Munford,SG,23,32,77,0.4155844155844156,9,23,0.391304347826087,23,54,0.42592592592592593,7,14,0.5,3,28,31,22,13,3,15,25,80,2016_Xavier Munford
2017,A.J. Hammons,C,24,17,42,0.40476190476190477,5,10,0.5,12,32,0.375,9,20,0.45,8,28,36,4,1,13,10,21,48,2017_A.J. Hammons
2017,Alexis Ajinca,C,28,89,178,0.5,0,4,0.0,89,174,0.5114942528735632,29,40,0.725,46,131,177,12,20,22,31,77,207,2017_Alexis Ajinca
2017,Andrew Wiggins,SF,21,709,1570,0.4515923566878981,103,289,0.356401384083045,606,1281,0.47306791569086654,412,542,0.7601476014760148,103,226,329,189,82,30,187,183,1933,2017_Andrew Wiggins
2017,Brandan Wright,PF,29,83,135,0.6148148148148148,0,1,0.0,83,134,0.6194029850746269,23,35,0.6571428571428571,31,47,78,15,11,20,10,42,189,2017_Brandan Wright
2017,Dante Exum,PG,21,155,363,0.42699724517906334,44,149,0.2953020134228188,111,214,0.5186915887850467,58,73,0.7945205479452054,30,102,132,112,21,12,80,146,412,2017_Dante Exum
2017,Danuel House,SG,23,0,0,NaN,0,0,NaN,0,0,NaN,0,0,NaN,0,1,1,0,0,0,0,0,0,2017_Danuel House
2017,Gerald Green,SF,31,95,232,0.40948275862068967,39,111,0.35135135135135137,56,121,0.4628099173553719,33,41,0.8048780487804879,17,68,85,33,9,7,25,48,262,2017_Gerald Green
2017,Joel Embiid,C,22,200,429,0.4662004662004662,36,98,0.3673469387755102,164,331,0.4954682779456193,191,244,0.7827868852459017,61,182,243,66,27,76,117,112,627,2017_Joel Embiid
2017,Malcolm Brogdon,SG,24,290,635,0.4566929133858268,78,193,0.40414507772020725,212,442,0.4796380090497738,109,126,0.8650793650793651,47,166,213,317,84,12,113,140,767,2017_Malcolm Brogdon
2017,Markieff Morris,PF,27,406,889,0.4566929133858268,71,196,0.3622448979591837,335,693,0.4834054834054834,180,215,0.8372093023255814,107,385,492,126,82,42,129,254,1063,2017_Markieff Morris
2017,Nicolas Batum,SG,28,393,975,0.40307692307692305,135,405,0.3333333333333333,258,570,0.45263157894736844,243,284,0.8556338028169014,46,435,481,455,86,29,194,109,1164,2017_Nicolas Batum
2017,Rashad Vaughn,SG,20,57,156,0.36538461538461536,26,81,0.32098765432098764,31,75,0.41333333333333333,2,5,0.4,4,45,49,23,19,10,14,32,142,2017_Rashad Vaughn
2017,Richard Jefferson,SF,36,153,343,0.446064139941691,62,186,0.3333333333333333,91,157,0.5796178343949044,80,108,0.7407407407407407,28,174,202,78,26,10,52,153,448,2017_Richard Jefferson
2017,Terrence Ross,SF,25,652,1492,0.43699731903485256,284,782,0.3631713554987212,368,710,0.5183098591549296,128,154,0.8311688311688312,36,378,414,176,176,66,136,286,1716,2017_Terrence Ross
2003,Antonio Harvey,PF,32,2,5,0.4,0,0,NaN,2,5,0.4,0,0,NaN,1,5,6,0,1,4,3,7,4,2003_Antonio Harvey
2003,Bimbo Coles,PG,34,112,336,0.3333333333333333,14,64,0.21875,98,272,0.3602941176470588,70,84,0.8333333333333334,22,96,118,144,34,8,56,120,308,2003_Bimbo Coles
2003,Brian Skinner,PF,26,182,331,0.5498489425981873,0,0,NaN,182,331,0.5498489425981873,97,161,0.6024844720496895,136,230,366,19,47,53,62,176,461,2003_Brian Skinner
2003,George Lynch,SG,32,147,359,0.40947075208913647,28,79,0.35443037974683544,119,280,0.425,41,74,0.5540540540540541,139,214,353,104,66,19,52,136,363,2003_George Lynch
2003,Jason Terry,PG,25,488,1141,0.42769500438212094,160,431,0.37122969837587005,328,710,0.4619718309859155,259,292,0.886986301369863,37,242,279,600,126,14,249,175,1395,2003_Jason Terry
2003,Kedrick Brown,SF,21,61,171,0.3567251461988304,3,39,0.07692307692307693,58,132,0.4393939393939394,20,32,0.625,45,95,140,20,34,13,23,68,145,2003_Kedrick Brown
2003,Lucious Harris,SG,32,298,721,0.4133148404993065,47,136,0.34558823529411764,251,585,0.42905982905982903,152,189,0.8042328042328042,63,169,232,155,53,8,71,95,795,2003_Lucious Harris
2003,Mike Bibby,PG,24,329,700,0.47,56,137,0.40875912408759124,273,563,0.4849023090586146,161,187,0.8609625668449198,34,113,147,285,72,8,127,93,875,2003_Mike Bibby
2003,Sean Lampley,SF,23,56,129,0.43410852713178294,0,4,0.0,56,125,0.448,57,82,0.6951219512195121,26,57,83,31,7,3,25,43,169,2003_Sean Lampley
2003,Shandon Anderson,SF,29,248,537,0.4618249534450652,52,140,0.37142857142857144,196,397,0.49370277078085645,139,190,0.7315789473684211,64,190,254,87,73,20,114,177,687,2003_Shandon Anderson
2003,Vladimir Radmanovic,PF,22,274,668,0.4101796407185629,104,293,0.35494880546075086,170,375,0.4533333333333333,72,102,0.7058823529411765,76,247,323,97,64,22,100,136,724,2003_Vladimir Radmanovic
2004,Antonio McDyess,PF,29,252,536,0.4701492537313433,0,0,NaN,252,536,0.4701492537313433,76,138,0.5507246376811594,140,374,514,72,74,48,114,234,580,2004_Antonio McDyess
2004,Bimbo Coles,PG,35,12,34,0.35294117647058826,0,0,NaN,12,34,0.35294117647058826,4,6,0.6666666666666666,2,8,10,15,3,0,9,27,28,2004_Bimbo Coles
2004,Brian Skinner,C,27,255,513,0.49707602339181284,0,0,NaN,255,513,0.49707602339181284,79,138,0.572463768115942,119,292,411,49,30,61,78,165,589,2004_Brian Skinner
2004,Charles Oakley,PF,40,2,6,0.3333333333333333,0,0,NaN,2,6,0.3333333333333333,5,6,0.8333333333333334,0,5,5,2,0,0,1,8,9,2004_Charles Oakley
2004,Chris Webber,PF,30,174,421,0.41330166270783847,1,5,0.2,173,416,0.41586538461538464,81,114,0.7105263157894737,48,152,200,105,31,20,60,76,430,2004_Chris Webber
2004,Dahntay Jones,SG,23,15,53,0.2830188679245283,1,4,0.25,14,49,0.2857142857142857,5,11,0.45454545454545453,7,16,23,12,5,6,12,23,36,2004_Dahntay Jones
2004,Damon Stoudamire,PG,30,408,1018,0.40078585461689586,156,427,0.36533957845433257,252,591,0.4263959390862944,127,145,0.8758620689655172,52,256,308,500,99,9,180,173,1099,2004_Damon Stoudamire
2004,David Wesley,SG,33,311,800,0.38875,92,285,0.32280701754385965,219,515,0.42524271844660194,137,182,0.7527472527472527,28,106,134,175,71,14,100,147,851,2004_David Wesley
2004,Derek Fisher,SG,29,203,576,0.3524305555555556,52,179,0.2905027932960894,151,397,0.380352644836272,122,153,0.7973856209150327,30,122,152,187,103,4,79,115,580,2004_Derek Fisher
2004,Eric Snow,PG,30,295,715,0.4125874125874126,2,18,0.1111111111111111,293,697,0.42037302725968434,252,316,0.7974683544303798,62,219,281,563,97,6,187,213,844,2004_Eric Snow
2004,Fred Hoiberg,SG,31,178,383,0.46475195822454307,76,172,0.4418604651162791,102,211,0.4834123222748815,98,116,0.8448275862068966,21,247,268,109,66,10,44,136,530,2004_Fred Hoiberg
2004,Gary Trent,C,29,155,328,0.4725609756097561,0,6,0.0,155,322,0.4813664596273292,69,91,0.7582417582417582,83,133,216,49,12,17,54,129,379,2004_Gary Trent
2004,Jason Terry,PG,26,499,1196,0.41722408026755853,146,421,0.34679334916864607,353,775,0.45548387096774196,215,260,0.8269230769230769,49,287,336,437,124,16,229,192,1359,2004_Jason Terry
2004,Juan Dixon,SG,25,247,637,0.3877551020408163,59,198,0.29797979797979796,188,439,0.428246013667426,111,139,0.7985611510791367,30,118,148,137,82,4,104,111,664,2004_Juan Dixon
2004,Kedrick Brown,SF,22,234,508,0.46062992125984253,76,198,0.3838383838383838,158,310,0.5096774193548387,34,54,0.6296296296296297,82,210,292,128,60,14,58,160,578,2004_Kedrick Brown
2004,Kendrick Perkins,C,19,8,15,0.5333333333333333,0,0,NaN,8,15,0.5333333333333333,6,9,0.6666666666666666,5,9,14,3,0,2,5,6,22,2004_Kendrick Perkins
2004,Marquis Daniels,SG,23,203,411,0.49391727493917276,11,36,0.3055555555555556,192,375,0.512,60,78,0.7692307692307693,66,80,146,116,53,12,44,51,477,2004_Marquis Daniels
2004,Nick Van,PG,32,187,479,0.3903966597077244,46,150,0.30666666666666664,141,329,0.42857142857142855,70,99,0.7070707070707071,16,88,104,206,20,2,78,57,490,2004_Nick Van
2004,Paul Grant,C,30,11,23,0.4782608695652174,0,0,NaN,11,23,0.4782608695652174,3,8,0.375,7,10,17,3,1,1,7,17,25,2004_Paul Grant
2004,Raul Lopez,PG,23,223,517,0.43133462282398455,25,85,0.29411764705882354,198,432,0.4583333333333333,101,117,0.8632478632478633,24,131,155,305,62,2,174,200,572,2004_Raul Lopez
2004,T.J. Ford,PG,20,153,398,0.3844221105527638,5,21,0.23809523809523808,148,377,0.3925729442970822,80,98,0.8163265306122449,37,140,177,356,60,3,139,123,391,2004_T.J. Ford
2004,Vladimir Radmanovic,PF,23,345,812,0.4248768472906404,140,377,0.3713527851458886,205,435,0.47126436781609193,95,127,0.7480314960629921,104,302,406,142,80,42,109,187,925,2004_Vladimir Radmanovic
2005,Anderson Varejao,PF,22,99,193,0.5129533678756477,0,2,0.0,99,191,0.518324607329843,68,127,0.5354330708661418,109,148,257,27,41,38,26,122,266,2005_Anderson Varejao
2005,Brian Skinner,C_PF_C-PF,28,208,410,0.5073170731707317,0,2,0.0,208,408,0.5098039215686274,50,140,0.35714285714285715,214,346,560,86,62,98,80,204,466,2005_Brian Skinner
2005,Dahntay Jones,SG,24,83,190,0.4368421052631579,23,60,0.38333333333333336,60,130,0.46153846153846156,44,64,0.6875,11,58,69,21,13,11,29,81,233,2005_Dahntay Jones
2005,Dwight Howard,PF,19,352,677,0.5199409158050221,0,2,0.0,352,675,0.5214814814814814,277,413,0.6707021791767555,287,536,823,75,77,136,165,232,981,2005_Dwight Howard
2005,Eric Snow,SG,31,125,327,0.382262996941896,13,45,0.28888888888888886,112,282,0.3971631205673759,59,80,0.7375,37,118,155,317,67,16,89,189,322,2005_Eric Snow
2005,Jason Terry,PG,27,372,743,0.5006729475100942,103,245,0.4204081632653061,269,498,0.5401606425702812,146,173,0.8439306358381503,38,150,188,429,109,15,147,177,993,2005_Jason Terry
2005,Kedrick Brown,SF,23,2,6,0.3333333333333333,0,3,0.0,2,3,0.6666666666666666,8,10,0.8,1,10,11,4,3,1,5,4,12,2005_Kedrick Brown
2005,Kerry Kittles,SG,30,28,73,0.3835616438356164,7,21,0.3333333333333333,21,52,0.40384615384615385,6,10,0.6,1,31,32,20,8,3,7,12,69,2005_Kerry Kittles
2005,Marquis Daniels,SG,24,220,504,0.4365079365079365,7,35,0.2,213,469,0.4541577825159915,98,133,0.7368421052631579,87,129,216,128,83,14,86,124,545,2005_Marquis Daniels
2005,Mateen Cleaves,PG,27,5,14,0.35714285714285715,0,2,0.0,5,12,0.4166666666666667,3,4,0.75,2,4,6,7,2,0,2,2,13,2005_Mateen Cleaves
2005,Tierre Brown,PG,25,124,348,0.3563218390804598,26,72,0.3611111111111111,98,276,0.35507246376811596,59,75,0.7866666666666666,21,72,93,155,32,1,74,59,333,2005_Tierre Brown
2005,Toni Kukoc,SF,36,105,256,0.41015625,42,116,0.3620689655172414,63,140,0.45,44,61,0.7213114754098361,31,129,160,160,39,13,64,70,296,2005_Toni Kukoc
2005,Vladimir Radmanovic,PF,24,266,650,0.40923076923076923,128,329,0.3890577507598784,138,321,0.42990654205607476,81,103,0.7864077669902912,52,237,289,86,57,31,80,172,741,2005_Vladimir Radmanovic
2005,Wally Szczerbiak,SF,27,465,919,0.5059847660500544,63,169,0.3727810650887574,402,750,0.536,260,304,0.8552631578947368,82,221,303,191,40,16,132,178,1253,2005_Wally Szczerbiak
2006,Antawn Jamison,SF,29,660,1494,0.44176706827309237,147,373,0.3941018766756032,513,1121,0.4576271186440678,217,297,0.7306397306397306,167,598,765,158,90,12,137,189,1684,2006_Antawn Jamison
2006,Brian Skinner,C_PF_PF-C,29,164,320,0.5125,0,0,NaN,164,320,0.5125,54,112,0.48214285714285715,152,304,456,60,50,86,90,238,382,2006_Brian Skinner
2006,Dahntay Jones,SF,25,109,263,0.4144486692015209,3,21,0.14285714285714285,106,242,0.4380165289256198,60,93,0.6451612903225806,20,84,104,39,38,15,50,108,281,2006_Dahntay Jones
2006,Devin Harris,PG,22,190,405,0.4691358024691358,5,21,0.23809523809523808,185,384,0.4817708333333333,169,236,0.7161016949152542,26,99,125,177,53,16,84,121,554,2006_Devin Harris
2006,Eric Snow,PG,32,163,399,0.40852130325814534,1,10,0.1,162,389,0.41645244215938304,64,93,0.6881720430107527,38,160,198,346,76,19,116,218,391,2006_Eric Snow
2006,Erick Dampier,C,30,171,347,0.49279538904899134,0,0,NaN,171,347,0.49279538904899134,127,215,0.5906976744186047,273,367,640,51,27,106,115,263,469,2006_Erick Dampier
2006,Jason Terry,PG,28,516,1099,0.4695177434030937,171,416,0.4110576923076923,345,683,0.5051244509516838,168,210,0.8,31,127,158,306,100,27,135,196,1371,2006_Jason Terry
2006,Josh Childress,SF,22,278,504,0.5515873015873016,32,65,0.49230769230769234,246,439,0.5603644646924829,154,201,0.7661691542288557,134,253,387,131,86,39,101,184,742,2006_Josh Childress
2006,Lorenzen Wright,C,30,194,406,0.47783251231527096,0,2,0.0,194,404,0.4801980198019802,66,117,0.5641025641025641,142,253,395,48,52,46,67,201,454,2006_Lorenzen Wright
2006,Marquis Daniels,SG,25,246,512,0.48046875,4,19,0.21052631578947367,242,493,0.4908722109533469,138,183,0.7540983606557377,81,143,224,172,67,13,100,143,634,2006_Marquis Daniels
2006,Pat Burke,C,32,63,127,0.49606299212598426,2,7,0.2857142857142857,61,120,0.5083333333333333,13,21,0.6190476190476191,21,52,73,16,6,13,33,62,141,2006_Pat Burke
2006,Stanislav Medvedenko,PF,26,1,2,0.5,0,0,NaN,1,2,0.5,0,0,NaN,0,0,0,1,0,0,0,1,2,2006_Stanislav Medvedenko
2006,T.J. Ford,PG,22,328,789,0.4157160963244613,35,104,0.33653846153846156,293,685,0.42773722627737226,187,248,0.7540322580645161,63,248,311,473,104,7,219,196,878,2006_T.J. Ford
2006,Travis Diener,PG,23,29,69,0.42028985507246375,25,57,0.43859649122807015,4,12,0.3333333333333333,5,6,0.8333333333333334,4,17,21,16,7,0,10,22,88,2006_Travis Diener
2006,Vince Carter,SG,29,653,1518,0.43017127799736493,125,367,0.3405994550408719,528,1151,0.4587315377932233,480,601,0.7986688851913477,135,327,462,338,94,53,213,235,1911,2006_Vince Carter
2006,Vladimir Radmanovic,PF,25,524,1286,0.40746500777604977,276,708,0.3898305084745763,248,578,0.4290657439446367,186,228,0.8157894736842105,128,588,716,272,122,58,186,420,1510,2006_Vladimir Radmanovic
2006,Zeljko Rebraca,C,33,52,96,0.5416666666666666,0,0,NaN,52,96,0.5416666666666666,31,41,0.7560975609756098,13,51,64,9,5,19,24,59,135,2006_Zeljko Rebraca
2007,Adam Morrison,PF,22,355,944,0.3760593220338983,87,258,0.3372093023255814,268,686,0.39067055393586003,120,169,0.7100591715976331,54,176,230,163,28,6,130,179,917,2007_Adam Morrison
2007,Boris Diaw,PF,24,306,569,0.5377855887521968,15,45,0.3333333333333333,291,524,0.5553435114503816,82,120,0.6833333333333333,91,226,317,352,28,38,154,177,709,2007_Boris Diaw
2007,Cuttino Mobley,SG,31,388,882,0.4399092970521542,101,246,0.4105691056910569,287,636,0.45125786163522014,200,239,0.8368200836820083,52,215,267,198,92,24,145,186,1077,2007_Cuttino Mobley
2007,Dahntay Jones,SG,26,220,461,0.4772234273318872,5,12,0.4166666666666667,215,449,0.47884187082405344,138,174,0.7931034482758621,47,106,153,68,39,22,92,192,583,2007_Dahntay Jones
2007,Dan Dickau,PG,28,54,151,0.3576158940397351,16,61,0.26229508196721313,38,90,0.4222222222222222,42,53,0.7924528301886793,7,36,43,70,14,1,27,55,166,2007_Dan Dickau
2007,Eric Snow,PG,33,135,324,0.4166666666666667,0,4,0.0,135,320,0.421875,72,113,0.6371681415929203,35,153,188,330,55,16,111,185,342,2007_Eric Snow
2007,Erick Dampier,C,31,209,334,0.625748502994012,0,0,NaN,209,334,0.625748502994012,119,191,0.6230366492146597,217,349,566,44,24,82,107,239,537,2007_Erick Dampier
2007,Hassan Adams,SG,22,75,135,0.5555555555555556,0,1,0.0,75,134,0.5597014925373134,24,36,0.6666666666666666,35,42,77,13,17,4,22,47,174,2007_Hassan Adams
2007,Jason Terry,SG,29,514,1063,0.4835371589840075,162,370,0.43783783783783786,352,693,0.5079365079365079,160,199,0.8040201005025126,41,190,231,422,81,17,152,170,1350,2007_Jason Terry
2007,Juwan Howard,PF,33,309,665,0.46466165413533833,0,0,NaN,309,665,0.46466165413533833,155,188,0.824468085106383,138,332,470,131,29,8,112,205,773,2007_Juwan Howard
2007,Lawrence Roberts,PF,24,94,208,0.4519230769230769,0,2,0.0,94,206,0.4563106796116505,95,131,0.7251908396946565,101,160,261,30,36,13,36,133,283,2007_Lawrence Roberts
2007,Lorenzen Wright,C,31,82,183,0.44808743169398907,0,0,NaN,82,183,0.44808743169398907,9,32,0.28125,85,131,216,40,28,28,39,204,173,2007_Lorenzen Wright
2007,Marcus Camby,C,32,312,659,0.47344461305007585,0,2,0.0,312,657,0.4748858447488584,161,221,0.7285067873303167,164,652,816,223,87,231,122,183,785,2007_Marcus Camby
2007,Marquis Daniels,SG,26,129,281,0.45907473309608543,6,26,0.23076923076923078,123,255,0.4823529411764706,56,80,0.7,26,56,82,57,27,7,55,56,320,2007_Marquis Daniels
2007,Pat Burke,C,33,23,65,0.35384615384615387,6,22,0.2727272727272727,17,43,0.3953488372093023,8,13,0.6153846153846154,12,35,47,5,3,2,7,19,60,2007_Pat Burke
2007,Rafer Alston,PG,30,383,1020,0.37549019607843137,192,529,0.3629489603024575,191,491,0.3890020366598778,130,177,0.7344632768361582,29,253,282,444,129,10,170,195,1088,2007_Rafer Alston
2007,T.J. Ford,PG,23,393,902,0.4356984478935698,21,69,0.30434782608695654,372,833,0.44657863145258103,240,293,0.8191126279863481,53,183,236,595,101,8,231,186,1047,2007_T.J. Ford
2007,Travis Diener,PG,24,34,80,0.425,18,50,0.36,16,30,0.5333333333333333,12,15,0.8,3,15,18,35,4,0,13,27,98,2007_Travis Diener
2007,Vladimir Radmanovic,PF,26,134,316,0.4240506329113924,40,118,0.3389830508474576,94,198,0.47474747474747475,53,73,0.726027397260274,53,127,180,66,25,18,69,125,361,2007_Vladimir Radmanovic
2007,Yao Ming,C,26,423,819,0.5164835164835165,0,2,0.0,423,817,0.5177478580171359,356,413,0.8619854721549637,101,351,452,94,17,94,167,159,1202,2007_Yao Ming
2008,Charlie Bell,SG,28,185,486,0.38065843621399176,74,217,0.34101382488479265,111,269,0.41263940520446096,70,87,0.8045977011494253,31,136,167,210,52,2,76,121,514,2008_Charlie Bell
2008,Dahntay Jones,SG,27,23,53,0.4339622641509434,1,6,0.16666666666666666,22,47,0.46808510638297873,34,51,0.6666666666666666,7,28,35,12,8,6,10,28,81,2008_Dahntay Jones
2008,David Harrison,C,25,90,170,0.5294117647058824,0,0,NaN,90,170,0.5294117647058824,49,96,0.5104166666666666,43,75,118,14,20,59,58,164,229,2008_David Harrison
2008,Eric Snow,PG,34,6,38,0.15789473684210525,0,2,0.0,6,36,0.16666666666666666,10,22,0.45454545454545453,4,16,20,42,10,4,10,30,22,2008_Eric Snow
2008,Erick Dampier,C,32,178,277,0.6425992779783394,0,0,NaN,178,277,0.6425992779783394,84,146,0.5753424657534246,207,332,539,63,24,106,80,226,440,2008_Erick Dampier
2008,LeBron James,SF,23,794,1642,0.4835566382460414,113,359,0.3147632311977716,681,1283,0.5307872174590803,549,771,0.7120622568093385,133,459,592,539,138,81,255,165,2250,2008_LeBron James
2008,Lorenzen Wright,C,32,12,42,0.2857142857142857,0,0,NaN,12,42,0.2857142857142857,6,12,0.5,16,60,76,8,6,6,8,62,30,2008_Lorenzen Wright
2008,Marquis Daniels,SG,27,241,561,0.4295900178253119,27,102,0.2647058823529412,214,459,0.4662309368191721,97,139,0.697841726618705,66,146,212,137,79,18,112,121,606,2008_Marquis Daniels
2008,T.J. Ford,PG,24,246,524,0.46946564885496184,15,51,0.29411764705882354,231,473,0.4883720930232558,110,125,0.88,23,77,100,313,54,0,102,93,617,2008_T.J. Ford
2008,Travis Diener,PG,25,159,430,0.3697674418604651,74,233,0.31759656652360513,85,197,0.43147208121827413,64,71,0.9014084507042254,26,89,115,251,35,4,55,107,456,2008_Travis Diener
2008,Vladimir Radmanovic,SF,27,198,437,0.45308924485125857,95,234,0.405982905982906,103,203,0.5073891625615764,52,65,0.8,56,159,215,123,46,12,73,147,543,2008_Vladimir Radmanovic
2009,Adam Morrison,SF,24,160,446,0.35874439461883406,64,192,0.3333333333333333,96,254,0.3779527559055118,34,46,0.7391304347826086,36,124,160,82,18,8,64,154,418,2009_Adam Morrison
2009,Blake Ahearn,PG,24,2,6,0.3333333333333333,2,4,0.5,0,2,0.0,2,2,1.0,0,1,1,2,1,0,1,3,8,2009_Blake Ahearn
2009,Dahntay Jones,SG,28,154,336,0.4583333333333333,11,17,0.6470588235294118,143,319,0.4482758620689655,110,151,0.7284768211920529,58,110,168,78,49,19,68,199,429,2009_Dahntay Jones
2009,Eduardo Najera,PF,32,33,74,0.44594594594594594,5,25,0.2,28,49,0.5714285714285714,8,22,0.36363636363636365,17,50,67,19,10,4,18,50,79,2009_Eduardo Najera
2009,Erick Dampier,C,33,182,280,0.65,0,0,NaN,182,280,0.65,90,141,0.6382978723404256,216,349,565,77,24,95,74,191,454,2009_Erick Dampier
2009,Kobe Bryant,SG,30,800,1712,0.4672897196261682,118,336,0.35119047619047616,682,1376,0.4956395348837209,483,564,0.8563829787234043,90,339,429,399,120,37,210,189,2201,2009_Kobe Bryant
2009,Lorenzen Wright,C,33,10,27,0.37037037037037035,0,0,NaN,10,27,0.37037037037037035,3,8,0.375,7,18,25,3,4,5,9,17,23,2009_Lorenzen Wright
2009,Marko Jaric,SG,30,48,145,0.3310344827586207,11,28,0.39285714285714285,37,117,0.3162393162393162,29,41,0.7073170731707317,23,42,65,74,29,11,49,62,136,2009_Marko Jaric
2009,Marquis Daniels,SF,28,311,689,0.4513788098693759,18,90,0.2,293,599,0.48914858096828046,93,129,0.7209302325581395,80,168,248,114,62,26,94,120,733,2009_Marquis Daniels
2009,Michael Finley,SF,35,301,689,0.43686502177068215,131,319,0.4106583072100313,170,370,0.4594594594594595,51,62,0.8225806451612904,26,244,270,114,37,17,61,82,784,2009_Michael Finley
2009,Nene Hilario,C,26,428,709,0.6036671368124118,1,5,0.2,427,704,0.6065340909090909,266,368,0.7228260869565217,183,415,598,108,95,101,147,278,1123,2009_Nene Hilario
2009,Rob Kurz,SF,23,51,131,0.3893129770992366,15,38,0.39473684210526316,36,93,0.3870967741935484,40,50,0.8,33,48,81,20,14,19,16,78,157,2009_Rob Kurz
2009,Sonny Weems,SG,22,8,25,0.32,0,3,0.0,8,22,0.36363636363636365,3,8,0.375,0,4,4,3,1,0,6,8,19,2009_Sonny Weems
2009,T.J. Ford,PG,25,413,913,0.452354874041621,35,104,0.33653846153846156,378,809,0.4672435105067985,245,281,0.8718861209964412,59,200,259,392,89,16,180,180,1106,2009_T.J. Ford
2009,Travis Diener,PG,26,74,179,0.4134078212290503,46,118,0.3898305084745763,28,61,0.45901639344262296,12,15,0.8,6,80,86,122,26,5,21,42,206,2009_Travis Diener
2009,Vladimir Radmanovic,SF,28,392,932,0.4206008583690987,210,524,0.40076335877862596,182,408,0.44607843137254904,86,116,0.7413793103448276,90,354,444,162,92,30,196,222,1080,2009_Vladimir Radmanovic
2009,Willie Green,SG,27,286,658,0.43465045592705165,51,161,0.3167701863354037,235,497,0.47283702213279677,62,85,0.7294117647058823,29,97,126,158,53,13,64,154,685,2009_Willie Green
2010,Antonio McDyess,PF,35,205,428,0.47897196261682246,0,2,0.0,205,426,0.4812206572769953,36,57,0.631578947368421,149,306,455,83,43,32,79,147,446,2010_Antonio McDyess
2010,Brian Skinner,PF,33,10,25,0.4,0,0,NaN,10,25,0.4,6,8,0.75,9,18,27,0,3,4,7,20,26,2010_Brian Skinner
2010,Cartier Martin,SF,25,100,272,0.36764705882352944,34,98,0.3469387755102041,66,174,0.3793103448275862,48,60,0.8,50,86,136,32,22,2,38,96,282,2010_Cartier Martin
2010,Damien Wilkins,SF,30,165,381,0.4330708661417323,18,61,0.29508196721311475,147,320,0.459375,103,129,0.7984496124031008,72,177,249,135,66,25,76,144,451,2010_Damien Wilkins
2010,Dante Cunningham,PF,22,106,214,0.4953271028037383,0,2,0.0,106,212,0.5,31,48,0.6458333333333334,54,106,160,14,24,22,15,97,243,2010_Dante Cunningham
2010,DeSagana Diop,C,28,15,29,0.5172413793103449,0,0,NaN,15,29,0.5172413793103449,2,9,0.2222222222222222,24,41,65,5,5,14,12,31,32,2010_DeSagana Diop
2010,Dwight Howard,C,24,510,834,0.6115107913669064,0,7,0.0,510,827,0.6166868198307134,483,816,0.5919117647058824,284,798,1082,144,75,228,274,287,1503,2010_Dwight Howard
2010,Jason Hart,PG,31,2,4,0.5,0,0,NaN,2,4,0.5,0,0,NaN,0,4,4,12,4,2,6,8,4,2010_Jason Hart
2010,Jason Terry,SG,32,456,1041,0.43804034582132567,136,373,0.3646112600536193,320,668,0.47904191616766467,232,268,0.8656716417910447,19,121,140,292,94,17,109,142,1280,2010_Jason Terry
2010,Keith Bogans,SF,29,120,298,0.40268456375838924,70,196,0.35714285714285715,50,102,0.49019607843137253,37,50,0.74,25,151,176,95,45,12,53,156,347,2010_Keith Bogans
2010,Kelenna Azubuike,SF,26,48,88,0.5454545454545454,10,27,0.37037037037037035,38,61,0.6229508196721312,19,28,0.6785714285714286,12,29,41,10,5,9,7,16,125,2010_Kelenna Azubuike
2010,Leandro Barbosa,PG,27,155,365,0.4246575342465753,44,136,0.3235294117647059,111,229,0.4847161572052402,64,73,0.8767123287671232,11,58,69,64,23,12,46,71,418,2010_Leandro Barbosa
2010,Ryan Gomes,SF,27,327,732,0.44672131147540983,74,199,0.37185929648241206,253,533,0.474671669793621,104,126,0.8253968253968254,76,272,348,124,62,16,95,155,832,2010_Ryan Gomes
2010,Shaun Livingston,PG,24,208,402,0.5174129353233831,0,12,0.0,208,390,0.5333333333333333,84,96,0.875,32,124,156,260,34,22,116,122,500,2010_Shaun Livingston
2011,Aaron Brooks,PG,26,440,1174,0.3747870528109029,140,472,0.2966101694915254,300,702,0.42735042735042733,248,280,0.8857142857142857,40,116,156,466,68,6,198,230,1268,2011_Aaron Brooks
2011,Antonio McDyess,PF,36,169,344,0.49127906976744184,0,1,0.0,169,343,0.49271137026239065,52,77,0.6753246753246753,122,273,395,84,36,39,72,163,390,2011_Antonio McDyess
2011,Armon Johnson,PG,21,46,101,0.45544554455445546,5,12,0.4166666666666667,41,89,0.4606741573033708,13,22,0.5909090909090909,11,25,36,45,5,1,38,31,110,2011_Armon Johnson
2011,Brian Skinner,C,34,0,0,NaN,0,0,NaN,0,0,NaN,0,0,NaN,0,0,0,0,0,0,0,0,0,2011_Brian Skinner
2011,Dahntay Jones,SG,30,100,214,0.4672897196261682,14,39,0.358974358974359,86,175,0.49142857142857144,69,90,0.7666666666666667,4,61,65,33,20,7,31,70,283,2011_Dahntay Jones
2011,DeSagana Diop,C,29,8,24,0.3333333333333333,0,0,NaN,8,24,0.3333333333333333,4,11,0.36363636363636365,12,28,40,7,4,15,11,26,20,2011_DeSagana Diop
2011,Dwight Howard,C,25,619,1044,0.592911877394636,0,7,0.0,619,1037,0.5969141755062681,546,916,0.5960698689956332,309,789,1098,107,107,186,279,258,1784,2011_Dwight Howard
2011,Ed Davis,PF,21,215,373,0.5764075067024129,0,0,NaN,215,373,0.5764075067024129,71,128,0.5546875,168,294,462,40,39,67,48,183,501,2011_Ed Davis
2011,Gary Forbes,SF,25,124,273,0.4542124542124542,19,58,0.3275862068965517,105,215,0.4883720930232558,59,87,0.6781609195402298,28,88,116,49,23,6,46,77,326,2011_Gary Forbes
2011,Jason Richardson,SG,30,944,2112,0.44696969696969696,378,958,0.3945720250521921,566,1154,0.4904679376083189,232,318,0.7295597484276729,134,528,662,294,186,26,190,324,2498,2011_Jason Richardson
2011,Jason Terry,SG,33,492,1091,0.4509624197983501,127,351,0.36182336182336183,365,740,0.49324324324324326,182,214,0.8504672897196262,24,129,153,334,93,13,167,140,1293,2011_Jason Terry
2011,Kirk Hinrich,SG-PG_SG_PG,30,556,1246,0.4462279293739968,150,376,0.39893617021276595,406,870,0.4666666666666667,212,252,0.8412698412698413,42,322,364,576,150,34,242,370,1474,2011_Kirk Hinrich
2011,Leandro Barbosa,SG,28,294,653,0.450229709035222,72,213,0.3380281690140845,222,440,0.5045454545454545,109,137,0.7956204379562044,14,85,99,119,50,6,84,112,769,2011_Leandro Barbosa
2011,Mario Chalmers,PG,24,155,388,0.39948453608247425,83,231,0.3593073593073593,72,157,0.4585987261146497,54,62,0.8709677419354839,12,134,146,177,76,7,91,158,447,2011_Mario Chalmers
2011,Marquis Daniels,SF,30,114,232,0.49137931034482757,4,21,0.19047619047619047,110,211,0.5213270142180095,39,57,0.6842105263157895,24,89,113,64,39,22,38,63,271,2011_Marquis Daniels
2011,Nenad Krstic,C,27,462,904,0.5110619469026548,0,0,NaN,462,904,0.5110619469026548,226,292,0.773972602739726,248,422,670,54,52,50,112,368,1150,2011_Nenad Krstic
2011,Sean Marks,C,35,19,44,0.4318181818181818,2,2,1.0,17,42,0.40476190476190477,5,8,0.625,16,24,40,4,3,5,11,44,45,2011_Sean Marks
2011,Trevor Booker,PF,23,139,253,0.549407114624506,0,1,0.0,139,252,0.5515873015873016,68,101,0.6732673267326733,98,153,251,35,29,42,38,115,346,2011_Trevor Booker
2011,Vladimir Radmanovic,PF,30,137,318,0.4308176100628931,70,173,0.4046242774566474,67,145,0.46206896551724136,30,34,0.8823529411764706,64,148,212,79,44,44,57,157,374,2011_Vladimir Radmanovic
2012,Alonzo Gee,SG,24,227,551,0.41197822141560797,44,137,0.32116788321167883,183,414,0.4420289855072464,167,212,0.7877358490566038,101,221,322,113,83,17,114,149,665,2012_Alonzo Gee
2012,Armon Johnson,PG,22,40,86,0.46511627906976744,2,6,0.3333333333333333,38,80,0.475,12,12,1.0,2,24,26,22,10,0,12,18,94,2012_Armon Johnson
2012,Brian Cook,PF,31,62,196,0.3163265306122449,20,100,0.2,42,96,0.4375,18,20,0.9,20,106,126,20,12,10,22,96,162,2012_Brian Cook
2012,Brian Scalabrine,PF,33,14,30,0.4666666666666667,1,7,0.14285714285714285,13,23,0.5652173913043478,3,6,0.5,8,13,21,15,5,6,9,9,32,2012_Brian Scalabrine
2012,Brian Skinner,C,35,0,1,0.0,0,0,NaN,0,1,0.0,0,0,NaN,0,0,0,0,0,0,0,1,0,2012_Brian Skinner
2012,Carlos Delfino,SF,29,182,453,0.40176600441501104,86,239,0.3598326359832636,96,214,0.4485981308411215,38,48,0.7916666666666666,20,188,208,123,79,10,66,99,488,2012_Carlos Delfino
2012,Charlie Villanueva,PF,27,35,91,0.38461538461538464,15,45,0.3333333333333333,20,46,0.43478260869565216,6,7,0.8571428571428571,9,39,48,6,7,5,7,25,91,2012_Charlie Villanueva
2012,Chris Singleton,SF,22,116,312,0.3717948717948718,44,127,0.3464566929133858,72,185,0.3891891891891892,30,44,0.6818181818181818,43,190,233,49,70,30,38,176,306,2012_Chris Singleton
2012,Dahntay Jones,SF,31,115,281,0.4092526690391459,33,77,0.42857142857142855,82,204,0.4019607843137255,83,99,0.8383838383838383,23,94,117,63,23,11,46,119,346,2012_Dahntay Jones
2012,Dwight Howard,C,26,416,726,0.5730027548209367,0,7,0.0,416,719,0.5785813630041725,281,572,0.49125874125874125,200,585,785,104,81,116,175,159,1113,2012_Dwight Howard
2012,Gary Forbes,SG,26,112,271,0.4132841328413284,29,83,0.3493975903614458,83,188,0.44148936170212766,66,91,0.7252747252747253,27,75,102,54,24,4,54,56,319,2012_Gary Forbes
2012,Gerald Green,SF,26,154,320,0.48125,43,110,0.39090909090909093,111,210,0.5285714285714286,49,65,0.7538461538461538,15,93,108,34,28,17,55,80,400,2012_Gerald Green
2012,Jason Terry,SG,34,357,830,0.43012048192771085,138,365,0.3780821917808219,219,465,0.47096774193548385,98,111,0.8828828828828829,16,133,149,226,73,11,127,69,950,2012_Jason Terry
2012,Kevin Durant,SF,23,643,1297,0.49575944487278334,133,344,0.3866279069767442,510,953,0.5351521511017838,431,501,0.8602794411177644,40,487,527,231,88,77,248,133,1850,2012_Kevin Durant
2012,Leandro Barbosa,SG,29,542,1274,0.42543171114599687,130,340,0.38235294117647056,412,934,0.4411134903640257,202,248,0.8145161290322581,66,190,256,192,112,14,188,270,1416,2012_Leandro Barbosa
2012,Linas Kleiza,SF,27,165,410,0.4024390243902439,62,179,0.3463687150837989,103,231,0.4458874458874459,81,100,0.81,42,157,199,46,23,4,64,119,473,2012_Linas Kleiza
2012,Luke Harangody,PF,24,23,65,0.35384615384615387,5,21,0.23809523809523808,18,44,0.4090909090909091,9,12,0.75,20,33,53,6,6,3,4,17,60,2012_Luke Harangody
2012,Marquis Daniels,SG,31,52,143,0.36363636363636365,0,10,0.0,52,133,0.39097744360902253,17,23,0.7391304347826086,16,50,66,47,21,9,28,36,121,2012_Marquis Daniels
2012,Nikola Vucevic,C,21,131,291,0.45017182130584193,3,8,0.375,128,283,0.45229681978798586,18,34,0.5294117647058824,88,158,246,31,20,34,33,111,283,2012_Nikola Vucevic
2012,Sasha Pavlovic,SF,28,50,128,0.390625,17,58,0.29310344827586204,33,70,0.4714285714285714,3,8,0.375,4,68,72,18,20,15,20,54,120,2012_Sasha Pavlovic
2012,Trevor Booker,PF,24,181,341,0.530791788856305,1,2,0.5,180,339,0.5309734513274337,56,93,0.6021505376344086,119,206,325,40,48,43,58,138,419,2012_Trevor Booker
2012,Tyler Honeycutt,SF,21,8,24,0.3333333333333333,1,3,0.3333333333333333,7,21,0.3333333333333333,3,5,0.6,3,11,14,7,4,3,2,3,20,2012_Tyler Honeycutt
2012,Vladimir Radmanovic,SF,31,74,197,0.3756345177664975,50,135,0.37037037037037035,24,62,0.3870967741935484,22,29,0.7586206896551724,34,109,143,54,21,15,35,62,220,2012_Vladimir Radmanovic
2013,Andrei Kirilenko,SF,31,284,560,0.5071428571428571,35,120,0.2916666666666667,249,440,0.5659090909090909,188,250,0.752,102,260,362,177,96,62,119,82,791,2013_Andrei Kirilenko
2013,Brandon Jennings,PG,23,497,1247,0.39855653568564553,173,461,0.3752711496746204,324,786,0.4122137404580153,230,281,0.8185053380782918,59,187,246,521,125,10,203,155,1397,2013_Brandon Jennings
2013,Chris Bosh,C,28,485,907,0.5347298787210585,21,74,0.28378378378378377,464,833,0.5570228091236494,241,302,0.7980132450331126,131,370,501,123,66,101,128,168,1232,2013_Chris Bosh
2013,Chris Singleton,PF,23,92,241,0.3817427385892116,7,36,0.19444444444444445,85,205,0.4146341463414634,40,70,0.5714285714285714,51,133,184,37,38,24,45,124,231,2013_Chris Singleton
2013,Dahntay Jones,SF,32,164,444,0.36936936936936937,22,98,0.22448979591836735,142,346,0.41040462427745666,174,226,0.7699115044247787,48,154,202,96,44,12,76,238,524,2013_Dahntay Jones
2013,Doron Lamb,SG,21,120,326,0.36809815950920244,28,74,0.3783783783783784,92,252,0.36507936507936506,40,68,0.5882352941176471,16,76,92,64,26,0,52,104,308,2013_Doron Lamb
2013,Dwight Howard,C,27,470,813,0.5781057810578106,1,6,0.16666666666666666,469,807,0.5811648079306072,355,721,0.492371705963939,251,694,945,108,84,186,225,291,1296,2013_Dwight Howard
2013,Francisco Garcia,SF_SG_SG-SF,31,236,600,0.3933333333333333,134,358,0.3743016759776536,102,242,0.4214876033057851,36,42,0.8571428571428571,16,166,182,126,92,76,64,176,642,2013_Francisco Garcia
2013,Jason Terry,SG,35,281,648,0.43364197530864196,123,331,0.3716012084592145,158,317,0.49842271293375395,114,131,0.8702290076335878,19,140,159,198,66,11,102,110,799,2013_Jason Terry
2013,Joel Przybilla,C,33,1,4,0.25,0,0,NaN,1,4,0.25,0,2,0.0,5,16,21,4,1,2,4,10,2,2013_Joel Przybilla
2013,Marquis Daniels,SF,32,132,351,0.37606837606837606,20,72,0.2777777777777778,112,279,0.4014336917562724,40,54,0.7407407407407407,48,102,150,65,51,10,45,77,324,2013_Marquis Daniels
2013,Reggie Evans,PF,32,125,261,0.4789272030651341,0,0,NaN,125,261,0.4789272030651341,113,222,0.509009009009009,260,628,888,43,74,13,111,199,363,2013_Reggie Evans
2013,Trevor Booker,PF,25,108,220,0.4909090909090909,0,5,0.0,108,215,0.5023255813953489,40,72,0.5555555555555556,98,141,239,40,32,16,31,95,256,2013_Trevor Booker
2013,Tyler Honeycutt,SF,22,3,11,0.2727272727272727,0,2,0.0,3,9,0.3333333333333333,2,2,1.0,3,7,10,2,0,1,5,2,8,2013_Tyler Honeycutt
2013,Tyshawn Taylor,PG,22,32,87,0.367816091954023,6,13,0.46153846153846156,26,74,0.35135135135135137,15,27,0.5555555555555556,2,16,18,21,13,0,25,25,85,2013_Tyshawn Taylor
2013,Vladimir Radmanovic,PF,32,13,43,0.3023255813953488,5,27,0.18518518518518517,8,16,0.5,2,3,0.6666666666666666,10,18,28,8,8,4,7,29,33,2013_Vladimir Radmanovic
2014,Chandler Parsons,SF,25,466,987,0.47213779128672745,130,351,0.37037037037037035,336,636,0.5283018867924528,164,221,0.7420814479638009,69,340,409,298,88,29,144,168,1226,2014_Chandler Parsons
2014,Chris Singleton,SF,24,25,67,0.373134328358209,7,19,0.3684210526315789,18,48,0.375,18,25,0.72,18,37,55,6,9,3,17,25,75,2014_Chris Singleton
2014,Dwight Howard,C,28,473,800,0.59125,2,7,0.2857142857142857,471,793,0.5939470365699874,349,638,0.5470219435736677,231,635,866,131,60,128,229,240,1297,2014_Dwight Howard
2014,Gustavo Ayon,C,28,52,102,0.5098039215686274,0,0,NaN,52,102,0.5098039215686274,8,20,0.4,42,83,125,28,25,10,29,47,112,2014_Gustavo Ayon
2014,Jason Terry,PG,36,55,152,0.3618421052631579,39,103,0.3786407766990291,16,49,0.32653061224489793,10,15,0.6666666666666666,4,33,37,56,13,0,27,48,159,2014_Jason Terry
2014,Lance Thomas,SF,25,2,9,0.2222222222222222,0,0,NaN,2,9,0.2222222222222222,2,4,0.5,2,5,7,3,0,0,2,4,6,2014_Lance Thomas
2014,Rodney Stuckey,SG,27,372,853,0.4361078546307151,24,88,0.2727272727272727,348,765,0.4549019607843137,244,292,0.8356164383561644,39,130,169,152,54,10,125,131,1012,2014_Rodney Stuckey
2014,Tony Mitchell,SF,24,3,5,0.6,0,1,0.0,3,4,0.75,0,0,NaN,1,0,1,1,1,0,0,0,6,2014_Tony Mitchell
2014,Trevor Booker,PF,26,222,403,0.5508684863523573,0,2,0.0,222,401,0.5536159600997507,47,76,0.618421052631579,149,230,379,64,41,45,58,131,491,2014_Trevor Booker
2015,Beno Udrih,PG,32,246,505,0.4871287128712871,26,97,0.26804123711340205,220,408,0.5392156862745098,87,102,0.8529411764705882,20,123,143,220,46,8,89,88,605,2015_Beno Udrih
2015,Dahntay Jones,SF,34,6,21,0.2857142857142857,0,4,0.0,6,17,0.35294117647058826,9,11,0.8181818181818182,1,10,11,2,3,0,1,23,21,2015_Dahntay Jones
2015,Dwight Howard,C,29,251,423,0.5933806146572104,1,2,0.5,250,421,0.5938242280285035,143,271,0.5276752767527675,110,321,431,50,28,53,115,137,646,2015_Dwight Howard
2015,Elfrid Payton,PG,20,301,708,0.4251412429378531,11,42,0.2619047619047619,290,666,0.43543543543543545,118,214,0.5514018691588785,107,242,349,533,142,20,203,193,731,2015_Elfrid Payton
2015,Gorgui Dieng,C,25,259,512,0.505859375,1,6,0.16666666666666666,258,506,0.5098814229249012,191,244,0.7827868852459017,223,386,609,146,71,126,126,188,710,2015_Gorgui Dieng
2015,JaVale McGee,C,27,84,158,0.5316455696202531,0,0,NaN,84,158,0.5316455696202531,44,66,0.6666666666666666,36,86,122,6,4,40,36,60,212,2015_JaVale McGee
2015,Jason Terry,SG,37,188,446,0.42152466367713004,126,323,0.39009287925696595,62,123,0.5040650406504065,39,48,0.8125,15,106,121,147,66,19,74,116,541,2015_Jason Terry
2015,Jeremy Lin,PG,26,277,654,0.4235474006116208,65,176,0.3693181818181818,212,478,0.4435146443514644,213,268,0.7947761194029851,26,170,196,339,82,32,166,189,832,2015_Jeremy Lin
2015,Kris Humphries,PF,29,211,446,0.4730941704035874,0,7,0.0,211,439,0.4806378132118451,87,117,0.7435897435897436,118,298,416,57,34,25,46,130,509,2015_Kris Humphries
2015,Paul Millsap,PF,29,443,930,0.47634408602150535,77,216,0.35648148148148145,366,714,0.5126050420168067,255,337,0.7566765578635015,139,431,570,223,130,69,166,201,1218,2015_Paul Millsap
2015,Raymond Felton,PG,30,43,106,0.4056603773584906,10,34,0.29411764705882354,33,72,0.4583333333333333,12,15,0.8,2,24,26,41,11,4,18,17,108,2015_Raymond Felton
2015,Robert Sacre,C,25,126,306,0.4117647058823529,0,1,0.0,126,305,0.4131147540983607,55,82,0.6707317073170732,89,144,233,55,28,43,36,121,307,2015_Robert Sacre
2015,Trevor Booker,PF,27,226,464,0.4870689655172414,29,84,0.34523809523809523,197,380,0.5184210526315789,86,148,0.581081081081081,139,258,397,83,43,41,88,144,567,2015_Trevor Booker
2016,Allen Crabbe,SG,23,311,678,0.45870206489675514,112,285,0.3929824561403509,199,393,0.5063613231552163,98,113,0.8672566371681416,27,189,216,99,63,16,64,192,832,2016_Allen Crabbe
2016,Anderson Varejao,C,33,106,248,0.4274193548387097,0,2,0.0,106,246,0.43089430894308944,64,100,0.64,74,208,282,70,32,20,44,140,276,2016_Anderson Varejao
2016,Andrew Bogut,C,31,175,279,0.6272401433691757,1,1,1.0,174,278,0.6258992805755396,24,50,0.48,121,371,492,162,33,114,83,221,375,2016_Andrew Bogut
2016,Branden Dawson,PF,22,2,5,0.4,0,0,NaN,2,5,0.4,1,1,1.0,2,2,4,0,0,1,0,2,5,2016_Branden Dawson
2016,Dahntay Jones,SF,35,6,14,0.42857142857142855,1,2,0.5,5,12,0.4166666666666667,0,0,NaN,1,4,5,2,1,2,0,6,13,2016_Dahntay Jones
2016,Elfrid Payton,PG,21,318,730,0.43561643835616437,30,92,0.32608695652173914,288,638,0.45141065830721006,112,190,0.5894736842105263,77,184,261,468,89,20,177,159,778,2016_Elfrid Payton
2016,Glenn Robinson,SF,22,65,151,0.4304635761589404,14,37,0.3783783783783784,51,114,0.4473684210526316,27,39,0.6923076923076923,12,56,68,26,17,9,18,21,171,2016_Glenn Robinson
2016,James Young,SG,20,11,36,0.3055555555555556,6,26,0.23076923076923078,5,10,0.5,1,4,0.25,4,22,26,9,6,1,5,17,29,2016_James Young
2016,Jared Cunningham,SG,24,72,210,0.34285714285714286,24,78,0.3076923076923077,48,132,0.36363636363636365,72,110,0.6545454545454545,6,70,76,40,28,4,42,82,240,2016_Jared Cunningham
2016,Jason Terry,SG,38,151,376,0.4015957446808511,93,261,0.3563218390804598,58,115,0.5043478260869565,27,33,0.8181818181818182,14,65,79,103,47,9,49,91,422,2016_Jason Terry
2016,Kristaps Porzingis,PF,20,373,886,0.42099322799097066,81,243,0.3333333333333333,292,643,0.45412130637636083,201,240,0.8375,132,394,526,94,53,134,121,205,1028,2016_Kristaps Porzingis
2016,Markel Brown,SG,24,127,322,0.3944099378881988,38,121,0.3140495867768595,89,201,0.4427860696517413,71,94,0.7553191489361702,23,99,122,91,38,15,54,94,363,2016_Markel Brown
2016,Pablo Prigioni,PG,38,55,147,0.3741496598639456,28,95,0.29473684210526313,27,52,0.5192307692307693,7,8,0.875,38,76,114,130,53,1,49,82,145,2016_Pablo Prigioni
2016,Trevor Booker,PF,28,190,388,0.4896907216494845,12,41,0.2926829268292683,178,347,0.5129682997118156,71,106,0.6698113207547169,166,286,452,84,59,41,81,169,463,2016_Trevor Booker
2017,Aaron Gordon,SF,21,393,865,0.45433526011560693,77,267,0.2883895131086142,316,598,0.5284280936454849,156,217,0.7188940092165899,116,289,405,150,64,40,89,172,1019,2017_Aaron Gordon
2017,Bojan Bogdanovic,SF,27,752,1690,0.44497041420118344,288,784,0.3673469387755102,464,906,0.5121412803532008,434,486,0.8930041152263375,74,480,554,222,68,14,260,292,2226,2017_Bojan Bogdanovic
2017,Dahntay Jones,SF,36,3,8,0.375,0,2,0.0,3,6,0.5,3,4,0.75,1,1,2,1,0,0,1,1,9,2017_Dahntay Jones
2017,Denzel Valentine,SG,23,102,288,0.3541666666666667,73,208,0.35096153846153844,29,80,0.3625,14,18,0.7777777777777778,11,140,151,63,30,7,49,86,291,2017_Denzel Valentine
2017,Devin Harris,PG,33,136,341,0.39882697947214074,58,177,0.327683615819209,78,164,0.47560975609756095,107,129,0.8294573643410853,11,116,127,136,43,7,57,101,437,2017_Devin Harris
2017,Dorian Finney-Smith,PF,23,124,333,0.37237237237237236,56,191,0.2931937172774869,68,142,0.4788732394366197,46,61,0.7540983606557377,55,166,221,67,52,25,45,125,350,2017_Dorian Finney-Smith
2017,Dragan Bender,PF,19,57,161,0.35403726708074534,28,101,0.27722772277227725,29,60,0.48333333333333334,4,11,0.36363636363636365,23,80,103,23,10,22,32,74,146,2017_Dragan Bender
2017,Elfrid Payton,PG,22,430,912,0.47149122807017546,40,146,0.273972602739726,390,766,0.5091383812010444,146,211,0.6919431279620853,89,298,387,529,88,40,178,177,1046,2017_Elfrid Payton
2017,Emmanuel Mudiay,PG,20,208,551,0.37749546279491836,56,178,0.3146067415730337,152,373,0.4075067024128686,131,167,0.7844311377245509,29,149,178,217,41,13,123,95,603,2017_Emmanuel Mudiay
2017,James Young,SG,21,25,58,0.43103448275862066,12,35,0.34285714285714286,13,23,0.5652173913043478,6,9,0.6666666666666666,6,20,26,4,10,2,4,15,68,2017_James Young
2017,Jason Terry,SG,39,105,243,0.43209876543209874,73,171,0.4269005847953216,32,72,0.4444444444444444,24,29,0.8275862068965517,15,91,106,98,45,20,36,95,307,2017_Jason Terry
2017,Pierre Jackson,PG,25,13,39,0.3333333333333333,3,11,0.2727272727272727,10,28,0.35714285714285715,6,7,0.8571428571428571,1,8,9,19,2,0,3,5,35,2017_Pierre Jackson
2017,Seth Curry,PG,26,338,703,0.48079658605974396,137,322,0.4254658385093168,201,381,0.5275590551181102,85,100,0.85,25,153,178,188,79,7,92,126,898,2017_Seth Curry
2017,Trevor Booker,PF,29,305,591,0.5160744500846024,25,78,0.32051282051282054,280,513,0.5458089668615984,74,110,0.6727272727272727,142,428,570,138,76,28,127,152,709,2017_Trevor Booker
2017,Trey Burke,PG,24,116,255,0.4549019607843137,31,70,0.44285714285714284,85,185,0.4594594594594595,22,29,0.7586206896551724,7,40,47,100,11,5,48,54,285,2017_Trey Burke
2003,Al Harrington,SF,22,389,896,0.4341517857142857,13,46,0.2826086956521739,376,850,0.4423529411764706,211,274,0.7700729927007299,159,352,511,125,71,33,163,280,1002,2003_Al Harrington
2003,Brandon Williams,SF,27,1,7,0.14285714285714285,0,1,0.0,1,6,0.16666666666666666,0,0,NaN,2,0,2,0,2,0,3,4,2,2003_Brandon Williams
2003,Caron Butler,SF,22,429,1032,0.41569767441860467,34,107,0.3177570093457944,395,925,0.42702702702702705,309,375,0.824,135,262,397,213,137,31,192,230,1201,2003_Caron Butler
2003,Chris Whitney,PG,31,248,698,0.3553008595988539,100,328,0.3048780487804878,148,370,0.4,114,138,0.8260869565217391,6,128,134,290,58,4,142,184,710,2003_Chris Whitney
2003,Corliss Williamson,SF,29,374,826,0.45278450363196127,2,11,0.18181818181818182,372,815,0.456441717791411,237,300,0.79,147,211,358,104,44,27,126,238,987,2003_Corliss Williamson
2003,Danny Fortson,PF,26,20,54,0.37037037037037035,0,1,0.0,20,53,0.37735849056603776,19,29,0.6551724137931034,28,45,73,12,9,0,15,43,59,2003_Danny Fortson
2003,Devean George,SF,25,180,461,0.39045553145336226,49,132,0.3712121212121212,131,329,0.3981762917933131,83,105,0.7904761904761904,91,195,286,92,56,38,65,180,492,2003_Devean George
2003,Eddie House,SG,24,172,444,0.38738738738738737,36,120,0.3,136,324,0.41975308641975306,31,36,0.8611111111111112,17,84,101,87,44,1,46,73,411,2003_Eddie House
2003,Efthimi Rentzias,C,27,20,59,0.3389830508474576,4,8,0.5,16,51,0.3137254901960784,8,9,0.8888888888888888,10,16,26,7,6,2,4,21,52,2003_Efthimi Rentzias
2003,Kenny Satterfield,PG,21,110,366,0.3005464480874317,10,56,0.17857142857142858,100,310,0.3225806451612903,34,50,0.68,32,54,86,136,40,4,86,72,264,2003_Kenny Satterfield
2003,Keon Clark,C,27,226,451,0.5011086474501109,0,4,0.0,226,447,0.5055928411633109,84,128,0.65625,138,313,451,80,38,150,94,227,536,2003_Keon Clark
2003,Marcus Fizer,PF,24,178,383,0.46475195822454307,1,6,0.16666666666666666,177,377,0.46949602122015915,88,134,0.6567164179104478,80,136,216,48,14,17,57,89,445,2003_Marcus Fizer
2003,Mark Strickland,SF,32,2,5,0.4,0,0,NaN,2,5,0.4,0,0,NaN,5,2,7,0,0,0,1,1,4,2003_Mark Strickland
2003,Maurice Taylor,PF,26,231,535,0.43177570093457945,0,2,0.0,231,533,0.4333958724202627,100,138,0.7246376811594203,95,143,238,66,22,22,100,151,562,2003_Maurice Taylor
2003,Milt Palacio,PG,24,162,388,0.4175257731958763,8,37,0.21621621621621623,154,351,0.43874643874643876,65,87,0.7471264367816092,48,187,235,259,68,16,131,168,397,2003_Milt Palacio
2003,Shawn Marion,SF,24,662,1466,0.451568894952251,141,364,0.3873626373626374,521,1102,0.4727767695099819,251,295,0.8508474576271187,199,574,773,198,185,95,157,208,1716,2003_Shawn Marion
2003,Stromile Swift,PF,23,235,489,0.48057259713701433,0,2,0.0,235,487,0.48254620123203285,177,245,0.7224489795918367,114,270,384,45,55,104,99,152,647,2003_Stromile Swift
2003,Walt Williams,SF,32,134,341,0.39296187683284456,64,171,0.3742690058479532,70,170,0.4117647058823529,31,50,0.62,53,154,207,59,42,26,35,141,363,2003_Walt Williams
2004,Al Harrington,PF,23,421,909,0.46314631463146316,21,77,0.2727272727272727,400,832,0.4807692307692308,185,252,0.7341269841269841,163,345,508,131,80,22,163,250,1048,2004_Al Harrington
2004,Chris Whitney,PG,32,17,45,0.37777777777777777,8,18,0.4444444444444444,9,27,0.3333333333333333,5,5,1.0,3,12,15,14,6,2,6,6,47,2004_Chris Whitney
2004,Danny Fortson,C,27,71,139,0.5107913669064749,0,0,NaN,71,139,0.5107913669064749,75,92,0.8152173913043478,114,136,250,9,12,11,37,148,217,2004_Danny Fortson
2004,Devean George,SF,26,233,571,0.4080560420315236,65,186,0.34946236559139787,168,385,0.43636363636363634,73,96,0.7604166666666666,87,245,332,112,81,38,88,189,604,2004_Devean George
2004,Eddie House,SG,25,161,449,0.3585746102449889,51,136,0.375,110,313,0.3514376996805112,36,45,0.8,28,110,138,148,65,4,63,92,409,2004_Eddie House
2004,Eduardo Najera,SF,27,72,162,0.4444444444444444,2,4,0.5,70,158,0.4430379746835443,30,46,0.6521739130434783,67,89,156,25,35,19,29,90,176,2004_Eduardo Najera
2004,Jared Jeffries,PF,22,177,469,0.3773987206823028,5,30,0.16666666666666666,172,439,0.3917995444191344,105,171,0.6140350877192983,180,244,424,93,48,28,107,212,464,2004_Jared Jeffries
2004,Jason Kidd,PG,30,368,959,0.38373305526590196,94,293,0.32081911262798635,274,666,0.4114114114114114,206,249,0.8273092369477911,85,343,428,618,122,14,214,110,1036,2004_Jason Kidd
2004,Michael Olowokandi,C,28,121,285,0.4245614035087719,0,0,NaN,121,285,0.4245614035087719,36,61,0.5901639344262295,78,167,245,24,16,68,54,137,278,2004_Michael Olowokandi
2004,Paul Shirley,PF,26,10,23,0.43478260869565216,0,1,0.0,10,22,0.45454545454545453,1,3,0.3333333333333333,8,8,16,4,1,1,9,9,21,2004_Paul Shirley
2005,Al Harrington,SF,24,453,986,0.4594320486815416,16,74,0.21621621621621623,437,912,0.4791666666666667,236,351,0.6723646723646723,145,316,461,208,85,16,204,249,1158,2005_Al Harrington
2005,Chris Mihm,C,25,280,552,0.5072463768115942,0,2,0.0,280,550,0.509090909090909,175,258,0.6782945736434108,197,305,502,50,14,108,110,237,735,2005_Chris Mihm
2005,Curtis Borchardt,C,24,74,172,0.43023255813953487,0,0,NaN,74,172,0.43023255813953487,52,71,0.7323943661971831,86,138,224,49,10,32,52,160,200,2005_Curtis Borchardt
2005,Danny Fortson,C,28,118,226,0.5221238938053098,0,0,NaN,118,226,0.5221238938053098,227,258,0.8798449612403101,157,191,348,8,15,7,91,265,463,2005_Danny Fortson
2005,Darrick Martin,PG,33,16,50,0.32,5,18,0.2777777777777778,11,32,0.34375,5,8,0.625,3,7,10,28,6,0,6,19,42,2005_Darrick Martin
2005,Devean George,SF,27,37,104,0.3557692307692308,21,58,0.3620689655172414,16,46,0.34782608695652173,15,20,0.75,13,40,53,14,8,2,12,32,110,2005_Devean George
2005,Eddie House,PG-SG_SG_PG,26,330,732,0.45081967213114754,88,194,0.4536082474226804,242,538,0.44981412639405205,46,54,0.8518518518518519,32,134,166,192,88,12,70,130,794,2005_Eddie House
2005,Greg Buckner,SG,28,160,303,0.528052805280528,49,121,0.4049586776859504,111,182,0.6098901098901099,63,81,0.7777777777777778,66,142,208,133,75,6,49,169,432,2005_Greg Buckner
2005,Keith Bogans,SG,24,262,688,0.3808139534883721,57,173,0.32947976878612717,205,515,0.39805825242718446,133,183,0.726775956284153,76,150,226,135,68,8,122,167,714,2005_Keith Bogans
2005,Kirk Snyder,SG,21,122,328,0.3719512195121951,30,85,0.35294117647058826,92,243,0.3786008230452675,64,96,0.6666666666666666,50,71,121,36,26,19,58,116,338,2005_Kirk Snyder
2005,Lamar Odom,PF,25,366,774,0.4728682170542636,36,117,0.3076923076923077,330,657,0.502283105022831,207,298,0.6946308724832215,134,519,653,238,42,65,161,211,975,2005_Lamar Odom
2005,Linton Johnson,SF,24,0,2,0.0,0,1,0.0,0,1,0.0,0,0,NaN,0,3,3,0,1,0,1,1,0,2005_Linton Johnson
2005,Tim Thomas,SF,27,315,718,0.4387186629526462,85,208,0.40865384615384615,230,510,0.45098039215686275,136,173,0.7861271676300579,45,192,237,110,41,17,113,222,851,2005_Tim Thomas
2006,Al Harrington,PF,25,551,1220,0.4516393442622951,66,191,0.34554973821989526,485,1029,0.4713313896987366,243,350,0.6942857142857143,132,391,523,238,85,14,195,301,1411,2006_Al Harrington
2006,Andres Nocioni,PF,26,383,831,0.4608904933814681,93,238,0.3907563025210084,290,593,0.48903878583473864,204,242,0.8429752066115702,89,411,500,117,40,52,120,252,1063,2006_Andres Nocioni
2006,Danny Fortson,C,29,27,51,0.5294117647058824,0,0,NaN,27,51,0.5294117647058824,33,43,0.7674418604651163,31,47,78,2,4,2,26,76,87,2006_Danny Fortson
2006,Deng Gai,C,23,0,0,NaN,0,0,NaN,0,0,NaN,0,0,NaN,0,0,0,0,0,0,0,0,0,2006_Deng Gai
2006,Devean George,SF,28,170,425,0.4,50,160,0.3125,120,265,0.4528301886792453,58,86,0.6744186046511628,82,192,274,68,66,34,54,159,448,2006_Devean George
2006,Devin Green,SG,23,6,28,0.21428571428571427,0,2,0.0,6,26,0.23076923076923078,13,21,0.6190476190476191,10,14,24,7,3,0,5,13,25,2006_Devin Green
2006,Eddie House,PG,27,320,759,0.42160737812911725,123,316,0.38924050632911394,197,443,0.44469525959367945,33,41,0.8048780487804879,15,117,132,148,42,12,76,96,796,2006_Eddie House
2006,Esteban Batista,PF,22,34,80,0.425,0,1,0.0,34,79,0.43037974683544306,33,53,0.6226415094339622,61,83,144,7,15,11,38,111,101,2006_Esteban Batista
2006,Hakim Warrick,PF,23,101,228,0.44298245614035087,0,0,NaN,101,228,0.44298245614035087,76,115,0.6608695652173913,43,101,144,30,14,21,56,113,278,2006_Hakim Warrick
2006,John Thomas,C,30,12,30,0.4,0,0,NaN,12,30,0.4,6,8,0.75,20,20,40,4,6,4,16,34,30,2006_John Thomas
2006,Kirk Snyder,SG,22,205,453,0.45253863134657835,46,129,0.35658914728682173,159,324,0.49074074074074076,86,117,0.7350427350427351,55,106,161,102,29,23,70,106,542,2006_Kirk Snyder
2006,Michael Redd,SG,26,682,1516,0.449868073878628,163,413,0.3946731234866828,519,1103,0.47053490480507704,501,571,0.8774080560420315,78,264,342,229,95,5,170,157,2028,2006_Michael Redd
2006,Nenad Krstic,PF,22,447,881,0.5073779795686719,1,4,0.25,446,877,0.508551881413911,185,265,0.6981132075471698,182,331,513,88,32,63,133,297,1080,2006_Nenad Krstic
2006,Rick Brunson,PG,33,42,108,0.3888888888888889,10,26,0.38461538461538464,32,82,0.3902439024390244,14,24,0.5833333333333334,2,42,44,70,16,2,44,44,108,2006_Rick Brunson
2006,Sarunas Jasikevicius,PG,29,170,429,0.3962703962703963,86,236,0.3644067796610169,84,193,0.43523316062176165,121,133,0.9097744360902256,19,134,153,227,40,4,116,108,547,2006_Sarunas Jasikevicius
2006,Sean Marks,PF,30,37,71,0.5211267605633803,0,3,0.0,37,68,0.5441176470588235,7,12,0.5833333333333334,12,31,43,7,5,7,7,21,81,2006_Sean Marks
2006,Yaroslav Korolev,SF,18,9,30,0.3,2,7,0.2857142857142857,7,23,0.30434782608695654,7,10,0.7,5,8,13,9,3,0,6,11,27,2006_Yaroslav Korolev
2007,Al Harrington,PF,26,990,2166,0.45706371191135736,254,586,0.4334470989761092,736,1580,0.46582278481012657,336,484,0.6942148760330579,302,690,992,298,130,48,338,538,2570,2007_Al Harrington
2007,Alan Henderson,PF,34,43,67,0.6417910447761194,0,0,NaN,43,67,0.6417910447761194,33,47,0.7021276595744681,48,59,107,10,9,12,12,62,119,2007_Alan Henderson
2007,Carlos Delfino,SG,24,156,376,0.4148936170212766,46,138,0.3333333333333333,110,238,0.46218487394957986,70,89,0.7865168539325843,67,199,266,88,46,8,61,97,428,2007_Carlos Delfino
2007,Cedric Simmons,PF,21,55,132,0.4166666666666667,0,0,NaN,55,132,0.4166666666666667,16,33,0.48484848484848486,44,63,107,12,8,23,22,75,126,2007_Cedric Simmons
2007,Charlie Villanueva,PF,22,180,383,0.4699738903394256,29,86,0.3372093023255814,151,297,0.5084175084175084,73,89,0.8202247191011236,62,166,228,36,24,12,54,108,462,2007_Charlie Villanueva
2007,Chris Quinn,PG,23,48,131,0.366412213740458,20,57,0.3508771929824561,28,74,0.3783783783783784,25,37,0.6756756756756757,6,24,30,65,15,0,21,32,141,2007_Chris Quinn
2007,Devean George,SF,29,146,370,0.3945945945945946,53,150,0.35333333333333333,93,220,0.42272727272727273,36,48,0.75,57,156,213,33,46,23,51,143,381,2007_Devean George
2007,Eddie House,SG,28,180,421,0.42755344418052255,75,175,0.42857142857142855,105,246,0.4268292682926829,33,36,0.9166666666666666,14,78,92,67,27,3,27,69,468,2007_Eddie House
2007,Esteban Batista,PF,23,8,16,0.5,0,0,NaN,8,16,0.5,4,7,0.5714285714285714,7,23,30,4,3,0,4,13,20,2007_Esteban Batista
2007,Gerald Green,SF,21,310,739,0.41948579161028415,95,258,0.3682170542635659,215,481,0.446985446985447,128,159,0.8050314465408805,68,140,208,83,41,24,120,198,843,2007_Gerald Green
2007,Hakim Warrick,PF,24,373,712,0.523876404494382,0,8,0.0,373,704,0.5298295454545454,299,388,0.770618556701031,130,290,420,75,43,30,161,232,1045,2007_Hakim Warrick
2007,James Lang,C,23,4,9,0.4444444444444444,0,0,NaN,4,9,0.4444444444444444,3,5,0.6,5,6,11,2,0,3,2,14,11,2007_James Lang
2007,Jared Reiner,C,24,15,43,0.3488372093023256,0,0,NaN,15,43,0.3488372093023256,3,10,0.3,21,50,71,13,5,6,14,45,33,2007_Jared Reiner
2007,Kirk Snyder,SF,23,66,146,0.4520547945205479,11,44,0.25,55,102,0.5392156862745098,49,75,0.6533333333333333,17,66,83,39,11,12,26,51,192,2007_Kirk Snyder
2007,LaMarcus Aldridge,C,21,241,479,0.5031315240083507,0,2,0.0,241,477,0.5052410901467506,83,115,0.7217391304347827,144,168,312,24,22,73,43,186,565,2007_LaMarcus Aldridge
2007,Linas Kleiza,PF,22,200,474,0.4219409282700422,83,221,0.3755656108597285,117,253,0.4624505928853755,115,135,0.8518518518518519,77,189,266,45,28,14,79,200,598,2007_Linas Kleiza
2007,Lindsey Hunter,PG,36,94,244,0.38524590163934425,38,119,0.31932773109243695,56,125,0.448,30,33,0.9090909090909091,9,38,47,93,34,7,35,56,256,2007_Lindsey Hunter
2007,Sasha Pavlovic,SG,23,222,490,0.4530612244897959,60,148,0.40540540540540543,162,342,0.47368421052631576,100,126,0.7936507936507936,23,135,158,105,55,17,102,145,604,2007_Sasha Pavlovic
2008,Adrian Griffin,SF_SG_SG-SF,33,60,152,0.39473684210526316,0,0,NaN,60,152,0.39473684210526316,10,18,0.5555555555555556,56,62,118,54,34,4,42,54,130,2008_Adrian Griffin
2008,Al Harrington,C,27,401,923,0.4344528710725894,153,408,0.375,248,515,0.4815533980582524,147,190,0.7736842105263158,107,332,439,132,74,16,90,266,1102,2008_Al Harrington
2008,Chris Bosh,C,23,507,1027,0.4936708860759494,10,25,0.4,497,1002,0.49600798403193613,472,559,0.8443649373881932,174,409,583,171,63,67,153,157,1496,2008_Chris Bosh
2008,Chris Quinn,PG,24,158,373,0.42359249329758714,64,159,0.4025157232704403,94,214,0.4392523364485981,85,98,0.8673469387755102,11,107,118,178,46,4,55,90,465,2008_Chris Quinn
2008,Eddie House,PG,29,217,531,0.4086629001883239,117,298,0.3926174496644295,100,233,0.4291845493562232,33,36,0.9166666666666666,19,148,167,152,59,10,76,114,584,2008_Eddie House
2008,Gabe Pruitt,PG,21,14,39,0.358974358974359,3,12,0.25,11,27,0.4074074074074074,1,2,0.5,1,7,8,13,5,0,5,10,32,2008_Gabe Pruitt
2008,Hakim Warrick,PF,25,328,653,0.5022970903522205,13,48,0.2708333333333333,315,605,0.5206611570247934,183,260,0.7038461538461539,123,233,356,53,36,28,85,156,852,2008_Hakim Warrick
2008,Ime Udoka,PF,30,159,375,0.424,61,165,0.3696969696969697,98,210,0.4666666666666667,44,58,0.7586206896551724,36,192,228,63,56,17,58,127,423,2008_Ime Udoka
2008,John Salmons,SG,28,381,799,0.47684605757196497,39,120,0.325,342,679,0.5036818851251841,214,260,0.823076923076923,76,273,349,208,93,31,170,171,1015,2008_John Salmons
2008,Kenyon Martin,PF,30,376,699,0.5379113018597997,2,11,0.18181818181818182,374,688,0.5436046511627907,123,212,0.5801886792452831,105,356,461,90,88,85,91,235,877,2008_Kenyon Martin
2008,Kirk Snyder,SF-PF_SF_PF,24,192,378,0.5079365079365079,10,46,0.21739130434782608,182,332,0.5481927710843374,128,176,0.7272727272727273,60,192,252,128,40,30,104,110,522,2008_Kirk Snyder
2008,Kosta Perovic,C,22,3,10,0.3,0,0,NaN,3,10,0.3,4,6,0.6666666666666666,6,7,13,1,0,2,1,6,10,2008_Kosta Perovic
2008,LaMarcus Aldridge,PF,22,561,1160,0.4836206896551724,1,7,0.14285714285714285,560,1153,0.4856895056374675,227,298,0.761744966442953,220,358,578,122,55,94,126,240,1350,2008_LaMarcus Aldridge
2008,Luke Ridnour,PG,26,147,368,0.39945652173913043,21,71,0.29577464788732394,126,297,0.42424242424242425,78,91,0.8571428571428571,13,81,94,241,37,14,80,120,393,2008_Luke Ridnour
2008,Mario West,SG,23,21,49,0.42857142857142855,0,4,0.0,21,45,0.4666666666666667,17,26,0.6538461538461539,26,22,48,13,12,4,9,61,59,2008_Mario West
2008,Othella Harrington,C,34,18,42,0.42857142857142855,0,0,NaN,18,42,0.42857142857142855,10,16,0.625,11,31,42,4,1,4,11,34,46,2008_Othella Harrington
2008,Paul Davis,PF,23,24,65,0.36923076923076925,0,0,NaN,24,65,0.36923076923076925,6,10,0.6,25,22,47,10,6,6,9,33,54,2008_Paul Davis
2008,Quentin Richardson,SF,27,199,555,0.35855855855855856,69,214,0.32242990654205606,130,341,0.3812316715542522,60,88,0.6818181818181818,56,259,315,116,44,15,69,153,527,2008_Quentin Richardson
2008,Scot Pollard,C,32,12,23,0.5217391304347826,0,0,NaN,12,23,0.5217391304347826,15,22,0.6818181818181818,14,23,37,3,3,6,5,43,39,2008_Scot Pollard
2008,Viktor Khryapa,PF,25,12,31,0.3870967741935484,0,1,0.0,12,30,0.4,8,14,0.5714285714285714,6,14,20,8,6,0,6,11,32,2008_Viktor Khryapa
2009,Al Harrington,PF,28,1064,2424,0.4389438943894389,342,940,0.3638297872340426,722,1484,0.4865229110512129,468,590,0.7932203389830509,198,712,910,204,176,44,322,454,2938,2009_Al Harrington
2009,Antoine Wright,SF,24,179,431,0.41531322505800466,45,149,0.30201342281879195,134,282,0.475177304964539,71,95,0.7473684210526316,31,105,136,77,46,27,54,172,474,2009_Antoine Wright
2009,Ben Gordon,SG,25,598,1315,0.45475285171102664,173,422,0.4099526066350711,425,893,0.47592385218365063,330,382,0.8638743455497382,52,231,283,279,71,22,200,184,1699,2009_Ben Gordon
2009,Chris Quinn,PG,25,118,289,0.4083044982698962,56,137,0.40875912408759124,62,152,0.40789473684210525,47,58,0.8103448275862069,8,67,75,132,24,2,33,79,339,2009_Chris Quinn
2009,Darius Miles,SF,27,48,99,0.48484848484848486,1,6,0.16666666666666666,47,93,0.5053763440860215,23,31,0.7419354838709677,19,38,57,17,11,20,21,32,120,2009_Darius Miles
2009,Gabe Pruitt,SG,22,31,101,0.3069306930693069,14,48,0.2916666666666667,17,53,0.32075471698113206,17,21,0.8095238095238095,9,34,43,39,15,3,19,34,93,2009_Gabe Pruitt
2009,Hakim Warrick,PF,26,340,693,0.4906204906204906,5,23,0.21739130434782608,335,670,0.5,266,374,0.7112299465240641,129,277,406,66,48,39,98,170,951,2009_Hakim Warrick
2009,Ime Udoka,SF,31,110,287,0.3832752613240418,41,125,0.328,69,162,0.42592592592592593,28,46,0.6086956521739131,28,159,187,54,36,12,38,86,289,2009_Ime Udoka
2009,Kenyon Martin,PF,31,318,648,0.49074074074074076,14,38,0.3684210526315789,304,610,0.49836065573770494,119,197,0.6040609137055838,81,314,395,132,96,74,104,201,769,2009_Kenyon Martin
2009,LaMarcus Aldridge,PF,23,601,1243,0.4835076427996782,7,28,0.25,594,1215,0.4888888888888889,261,334,0.781437125748503,234,371,605,157,77,77,121,207,1470,2009_LaMarcus Aldridge
2009,Mike Bibby,PG,30,437,1005,0.43482587064676614,167,428,0.3901869158878505,270,577,0.4679376083188908,135,171,0.7894736842105263,38,240,278,392,98,11,128,145,1176,2009_Mike Bibby
2009,Rodney Stuckey,PG,22,401,913,0.43921139101861995,23,78,0.2948717948717949,378,835,0.45269461077844314,233,290,0.803448275862069,69,206,275,387,78,11,173,217,1058,2009_Rodney Stuckey
2009,Shaquille O'Neal,C,36,512,841,0.6087990487514863,0,1,0.0,512,840,0.6095238095238096,309,519,0.5953757225433526,187,446,633,126,49,108,168,253,1333,2009_Shaquille O'Neal
2009,Tony Allen,SG,27,137,284,0.4823943661971831,6,27,0.2222222222222222,131,257,0.5097276264591439,79,109,0.7247706422018348,22,82,104,66,54,23,77,98,359,2009_Tony Allen
2010,Beno Udrih,PG,27,415,841,0.4934601664684899,75,199,0.3768844221105528,340,642,0.5295950155763239,118,141,0.8368794326241135,38,181,219,372,89,10,136,166,1023,2010_Beno Udrih
2010,Bobby Simmons,PF,29,42,117,0.358974358974359,20,63,0.31746031746031744,22,54,0.4074074074074074,18,20,0.9,11,52,63,15,15,3,19,52,122,2010_Bobby Simmons
2010,Carlos Boozer,PF,28,617,1098,0.5619307832422586,0,0,NaN,617,1098,0.5619307832422586,285,384,0.7421875,181,693,874,247,84,36,212,270,1519,2010_Carlos Boozer
2010,Courtney Lee,SG,24,338,775,0.43612903225806454,76,225,0.3377777777777778,262,550,0.4763636363636364,133,153,0.869281045751634,60,192,252,121,93,20,76,130,885,2010_Courtney Lee
2010,Devean George,SF,32,89,206,0.4320388349514563,48,123,0.3902439024390244,41,83,0.4939759036144578,16,23,0.6956521739130435,21,93,114,32,41,10,15,89,242,2010_Devean George
2010,Eddie House,PG-SG_SG_PG,31,346,910,0.3802197802197802,158,454,0.34801762114537443,188,456,0.41228070175438597,96,104,0.9230769230769231,26,192,218,170,80,14,94,162,946,2010_Eddie House
2010,Garrett Temple,SG,23,88,202,0.43564356435643564,26,74,0.35135135135135137,62,128,0.484375,70,100,0.7,12,50,62,42,26,12,54,84,272,2010_Garrett Temple
2010,Grant Hill,SF,37,336,703,0.4779516358463727,35,80,0.4375,301,623,0.48314606741573035,205,251,0.8167330677290837,74,371,445,193,60,36,108,165,912,2010_Grant Hill
2010,J.R. Smith,SG,24,428,1033,0.4143272023233301,158,467,0.33832976445396146,270,566,0.47703180212014135,142,201,0.7064676616915423,28,206,234,183,99,20,139,174,1156,2010_J.R. Smith
2010,Joey Dorsey,PF,26,18,40,0.45,0,0,NaN,18,40,0.45,10,24,0.4166666666666667,32,54,86,4,6,4,12,42,46,2010_Joey Dorsey
2010,Kyle Lowry,PG,23,184,464,0.39655172413793105,37,136,0.27205882352941174,147,328,0.4481707317073171,215,260,0.8269230769230769,91,156,247,305,60,9,116,173,620,2010_Kyle Lowry
2010,Luc Mbah,PF,23,177,369,0.4796747967479675,6,17,0.35294117647058826,171,352,0.48579545454545453,93,133,0.6992481203007519,171,229,400,81,60,39,70,181,453,2010_Luc Mbah
2010,Omri Casspi,SF,21,300,672,0.44642857142857145,75,203,0.3694581280788177,225,469,0.47974413646055436,117,174,0.6724137931034483,75,274,349,95,54,17,98,125,792,2010_Omri Casspi
2010,Raymond Felton,PG,25,388,846,0.458628841607565,60,156,0.38461538461538464,328,690,0.4753623188405797,132,173,0.7630057803468208,53,235,288,446,123,22,168,172,968,2010_Raymond Felton
2010,Sean May,C,25,51,111,0.4594594594594595,0,4,0.0,51,107,0.4766355140186916,21,32,0.65625,20,50,70,17,12,7,19,46,123,2010_Sean May
2010,Will Conroy,PG,27,3,10,0.3,0,3,0.0,3,7,0.42857142857142855,0,2,0.0,0,3,3,7,0,0,4,5,6,2010_Will Conroy
2011,Al Harrington,PF,30,281,675,0.4162962962962963,117,328,0.3567073170731707,164,347,0.47262247838616717,86,117,0.7350427350427351,76,256,332,101,39,10,106,202,765,2011_Al Harrington
2011,Anderson Varejao,C,28,114,216,0.5277777777777778,0,2,0.0,114,214,0.5327102803738317,54,81,0.6666666666666666,98,203,301,45,27,38,40,87,282,2011_Anderson Varejao
2011,Andrew Bogut,C,26,367,742,0.4946091644204852,0,4,0.0,367,738,0.497289972899729,96,217,0.4423963133640553,199,521,720,131,47,168,125,217,830,2011_Andrew Bogut
2011,Anthony Randolph,C_PF_C-PF,21,246,528,0.4659090909090909,2,8,0.25,244,520,0.46923076923076923,116,172,0.6744186046511628,86,234,320,66,44,48,106,124,610,2011_Anthony Randolph
2011,Carlos Boozer,C,29,431,845,0.5100591715976331,0,0,NaN,431,845,0.5100591715976331,171,244,0.7008196721311475,130,435,565,145,45,18,149,186,1033,2011_Carlos Boozer
2011,Chris Andersen,C,32,82,137,0.5985401459854015,0,1,0.0,82,136,0.6029411764705882,86,135,0.6370370370370371,75,144,219,20,23,58,25,79,250,2011_Chris Andersen
2011,Eddie House,SG,32,128,321,0.3987538940809969,68,175,0.38857142857142857,60,146,0.410958904109589,38,40,0.95,9,83,92,62,32,3,29,68,362,2011_Eddie House
2011,Gani Lawal,PF,22,0,0,NaN,0,0,NaN,0,0,NaN,0,0,NaN,0,0,0,0,0,0,0,1,0,2011_Gani Lawal
2011,Jamal Crawford,SG,30,368,874,0.42105263157894735,119,349,0.34097421203438394,249,525,0.4742857142857143,222,260,0.8538461538461538,22,108,130,241,57,14,145,97,1077,2011_Jamal Crawford
2011,Joey Dorsey,C,27,52,99,0.5252525252525253,0,0,NaN,52,99,0.5252525252525253,31,65,0.47692307692307695,79,111,190,27,24,17,39,78,135,2011_Joey Dorsey
2011,Omri Casspi,SF,22,225,546,0.41208791208791207,92,247,0.3724696356275304,133,299,0.44481605351170567,68,101,0.6732673267326733,74,233,307,74,54,13,68,115,610,2011_Omri Casspi
2012,Al Harrington,PF,31,345,773,0.4463130659767141,101,303,0.3333333333333333,244,470,0.5191489361702127,119,176,0.6761363636363636,72,318,390,88,58,12,112,181,910,2012_Al Harrington
2012,Craig Brackins,PF,24,9,33,0.2727272727272727,3,9,0.3333333333333333,6,24,0.25,1,2,0.5,5,10,15,8,0,1,4,6,22,2012_Craig Brackins
2012,Devin Harris,PG,28,241,542,0.4446494464944649,77,213,0.3615023474178404,164,329,0.49848024316109424,156,209,0.7464114832535885,12,100,112,316,64,13,122,136,715,2012_Devin Harris
2012,Earl Boykins,PG,35,12,36,0.3333333333333333,2,9,0.2222222222222222,10,27,0.37037037037037035,13,15,0.8666666666666667,0,11,11,17,1,0,7,5,39,2012_Earl Boykins
2012,Josh Childress,SF,28,48,99,0.48484848484848486,4,24,0.16666666666666666,44,75,0.5866666666666667,0,2,0.0,31,64,95,34,14,6,9,38,100,2012_Josh Childress
2012,Keith Benson,C,23,0,1,0.0,0,0,NaN,0,1,0.0,0,0,NaN,2,1,3,0,0,0,0,0,0,2012_Keith Benson
2012,Omri Casspi,SF,23,166,412,0.4029126213592233,53,168,0.31547619047619047,113,244,0.46311475409836067,74,108,0.6851851851851852,63,165,228,66,37,21,64,115,459,2012_Omri Casspi
2012,Reggie Jackson,PG,21,51,159,0.32075471698113206,13,62,0.20967741935483872,38,97,0.3917525773195876,25,29,0.8620689655172413,14,39,53,71,25,1,36,31,140,2012_Reggie Jackson
2012,Xavier Henry,SG,20,90,228,0.39473684210526316,7,17,0.4117647058823529,83,211,0.3933649289099526,52,85,0.611764705882353,24,82,106,35,26,8,35,59,239,2012_Xavier Henry
2013,Al Harrington,C,32,20,57,0.3508771929824561,8,30,0.26666666666666666,12,27,0.4444444444444444,3,4,0.75,6,21,27,10,4,1,7,18,51,2013_Al Harrington
2013,Andrew Goudelock,SG,24,0,2,0.0,0,0,NaN,0,2,0.0,0,0,NaN,1,0,1,0,0,0,0,0,0,2013_Andrew Goudelock
2013,Earl Clark,PF,25,170,386,0.44041450777202074,35,104,0.33653846153846156,135,282,0.4787234042553192,53,76,0.6973684210526315,82,243,325,65,36,44,62,102,428,2013_Earl Clark
2013,Hakim Warrick,PF,30,134,330,0.40606060606060607,0,6,0.0,134,324,0.41358024691358025,120,176,0.6818181818181818,42,136,178,50,26,12,58,74,388,2013_Hakim Warrick
2013,Henry Sims,C,22,2,3,0.6666666666666666,0,0,NaN,2,3,0.6666666666666666,0,0,NaN,2,0,2,0,0,0,1,1,4,2013_Henry Sims
2013,Juwan Howard,PF,39,10,19,0.5263157894736842,0,0,NaN,10,19,0.5263157894736842,1,1,1.0,0,8,8,6,0,0,4,9,21,2013_Juwan Howard
2013,Kemba Walker,PG,22,526,1244,0.4228295819935691,107,332,0.32228915662650603,419,912,0.4594298245614035,296,371,0.7978436657681941,60,223,283,471,160,31,200,153,1455,2013_Kemba Walker
2013,Lou Amundson,PF,30,64,162,0.3950617283950617,0,0,NaN,64,162,0.3950617283950617,24,72,0.3333333333333333,96,116,212,22,32,24,38,106,152,2013_Lou Amundson
2013,MarShon Brooks,SG,24,155,335,0.4626865671641791,15,55,0.2727272727272727,140,280,0.5,69,94,0.7340425531914894,32,72,104,76,34,16,69,93,394,2013_MarShon Brooks
2013,Marcus Camby,PF,38,17,53,0.32075471698113206,0,0,NaN,17,53,0.32075471698113206,8,19,0.42105263157894735,24,56,80,14,7,14,15,28,42,2013_Marcus Camby
2013,Omri Casspi,SF,24,63,160,0.39375,25,76,0.32894736842105265,38,84,0.4523809523809524,22,41,0.5365853658536586,20,94,114,28,25,12,22,45,173,2013_Omri Casspi
2013,Richard Hamilton,SG,34,204,475,0.42947368421052634,16,52,0.3076923076923077,188,423,0.4444444444444444,66,77,0.8571428571428571,16,67,83,119,24,5,84,93,490,2013_Richard Hamilton
2013,Ronny Turiaf,C,30,49,97,0.5051546391752577,0,0,NaN,49,97,0.5051546391752577,23,63,0.36507936507936506,45,107,152,35,19,35,29,80,121,2013_Ronny Turiaf
2013,Will Bynum,PG,30,253,540,0.4685185185185185,24,76,0.3157894736842105,229,464,0.49353448275862066,106,131,0.8091603053435115,28,69,97,231,45,5,125,128,636,2013_Will Bynum
2014,Al Harrington,PF,33,82,207,0.3961352657004831,34,100,0.34,48,107,0.4485981308411215,27,35,0.7714285714285715,15,65,80,28,14,0,34,72,225,2014_Al Harrington
2014,Caron Butler,SF,33,426,1080,0.39444444444444443,196,498,0.39357429718875503,230,582,0.3951890034364261,126,150,0.84,42,416,458,164,94,34,120,240,1174,2014_Caron Butler
2014,D.J. Stephens,SG,23,3,7,0.42857142857142855,0,0,NaN,3,7,0.42857142857142855,1,1,1.0,1,4,5,0,0,0,0,0,7,2014_D.J. Stephens
2014,Derrick Favors,PF,22,390,747,0.5220883534136547,0,1,0.0,390,746,0.5227882037533512,190,284,0.6690140845070423,199,438,637,91,75,108,129,236,970,2014_Derrick Favors
2014,Eric Bledsoe,PG,24,265,556,0.4766187050359712,50,140,0.35714285714285715,215,416,0.5168269230769231,183,237,0.7721518987341772,27,175,202,235,69,14,143,99,763,2014_Eric Bledsoe
2014,Jorge Gutierrez,PG,25,25,54,0.46296296296296297,3,12,0.25,22,42,0.5238095238095238,9,12,0.75,3,19,22,30,10,1,14,37,62,2014_Jorge Gutierrez
2014,Kelly Olynyk,C,22,234,502,0.46613545816733065,40,114,0.3508771929824561,194,388,0.5,99,122,0.8114754098360656,140,225,365,109,35,27,106,227,607,2014_Kelly Olynyk
2014,LeBron James,PF,29,767,1353,0.5668883961566888,116,306,0.3790849673202614,651,1047,0.6217765042979942,439,585,0.7504273504273504,81,452,533,488,121,26,270,126,2089,2014_LeBron James
2014,Nikola Pekovic,C,28,379,701,0.5406562054208274,0,0,NaN,379,701,0.5406562054208274,186,249,0.7469879518072289,206,262,468,50,30,23,84,129,944,2014_Nikola Pekovic
2014,Omri Casspi,PF,25,173,410,0.4219512195121951,61,176,0.3465909090909091,112,234,0.47863247863247865,83,122,0.680327868852459,55,205,260,88,44,14,72,100,490,2014_Omri Casspi
2014,Ronnie Price,SG,30,28,92,0.30434782608695654,9,43,0.20930232558139536,19,49,0.3877551020408163,9,13,0.6923076923076923,8,35,43,66,25,2,26,50,74,2014_Ronnie Price
2014,Shawn Marion,SF,35,341,708,0.481638418079096,58,162,0.35802469135802467,283,546,0.5183150183150184,51,65,0.7846153846153846,132,365,497,124,90,37,95,125,791,2014_Shawn Marion
2014,Tyreke Evans,SF,24,391,897,0.4358974358974359,21,95,0.22105263157894736,370,802,0.4613466334164589,239,310,0.7709677419354839,76,265,341,363,84,21,175,155,1042,2014_Tyreke Evans
2015,Adreian Payne,PF,23,182,440,0.41363636363636364,2,18,0.1111111111111111,180,422,0.4265402843601896,60,92,0.6521739130434783,96,228,324,60,38,18,88,176,426,2015_Adreian Payne
2015,Brandon Knight,PG-SG_SG_PG,23,750,1776,0.4222972972972973,250,642,0.3894080996884735,500,1134,0.4409171075837742,390,446,0.874439461883408,56,432,488,660,180,20,378,228,2140,2015_Brandon Knight
2015,DeMarcus Cousins,C,24,498,1066,0.46716697936210133,2,8,0.25,496,1058,0.46880907372400754,423,541,0.7818853974121996,185,562,747,210,90,103,254,241,1421,2015_DeMarcus Cousins
2015,Joel Anthony,C,32,36,62,0.5806451612903226,0,0,NaN,36,62,0.5806451612903226,15,22,0.6818181818181818,32,61,93,5,12,49,12,55,87,2015_Joel Anthony
2015,Jorge Gutierrez,PG,26,44,82,0.5365853658536586,0,6,0.0,44,76,0.5789473684210527,18,26,0.6923076923076923,10,40,50,44,12,0,24,50,106,2015_Jorge Gutierrez
2015,Justin Holiday,SG,25,91,235,0.3872340425531915,35,109,0.3211009174311927,56,126,0.4444444444444444,37,45,0.8222222222222222,12,61,73,48,40,12,29,54,254,2015_Justin Holiday
2015,K.J. McDaniels,SG,21,344,868,0.39631336405529954,86,300,0.2866666666666667,258,568,0.45422535211267606,200,266,0.7518796992481203,130,270,400,144,88,140,210,252,974,2015_K.J. McDaniels
2015,Luis Scola,PF,34,300,642,0.4672897196261682,5,20,0.25,295,622,0.4742765273311897,158,226,0.6991150442477876,138,388,526,105,47,18,94,192,763,2015_Luis Scola
2015,Omri Casspi,SF,26,209,427,0.4894613583138173,35,87,0.40229885057471265,174,340,0.5117647058823529,140,191,0.7329842931937173,54,206,260,102,31,9,88,107,593,2015_Omri Casspi
2016,Adreian Payne,PF,24,53,145,0.36551724137931035,9,32,0.28125,44,113,0.3893805309734513,17,26,0.6538461538461539,20,91,111,29,16,11,36,77,132,2016_Adreian Payne
2016,Bryce Dejean-Jones,SG,23,28,69,0.4057971014492754,12,32,0.375,16,37,0.43243243243243246,11,21,0.5238095238095238,8,40,48,15,10,2,11,17,79,2016_Bryce Dejean-Jones
2016,C.J. Miles,SF,28,259,634,0.4085173501577287,142,387,0.3669250645994832,117,247,0.47368421052631576,93,124,0.75,25,150,175,63,53,29,70,142,753,2016_C.J. Miles
2016,Festus Ezeli,C,26,125,228,0.5482456140350878,0,0,NaN,125,228,0.5482456140350878,70,132,0.5303030303030303,91,166,257,32,18,50,38,94,320,2016_Festus Ezeli
2016,Jorge Gutierrez,PG,27,6,11,0.5454545454545454,0,2,0.0,6,9,0.6666666666666666,10,11,0.9090909090909091,0,7,7,17,3,0,6,3,22,2016_Jorge Gutierrez
2016,Justin Anderson,SF,22,71,175,0.4057142857142857,22,83,0.26506024096385544,49,92,0.532608695652174,44,55,0.8,18,114,132,29,19,25,24,45,208,2016_Justin Anderson
2016,LaMarcus Aldridge,PF,30,536,1045,0.5129186602870813,0,16,0.0,536,1029,0.5208940719144801,259,302,0.8576158940397351,176,456,632,110,38,81,99,151,1331,2016_LaMarcus Aldridge
2016,Nikola Mirotic,PF,24,248,609,0.4072249589490969,135,346,0.3901734104046243,113,263,0.4296577946768061,146,181,0.8066298342541437,58,304,362,100,58,46,102,151,777,2016_Nikola Mirotic
2016,Omri Casspi,SF,27,299,622,0.4807073954983923,112,274,0.40875912408759124,187,348,0.5373563218390804,103,159,0.6477987421383647,58,352,410,95,56,17,94,154,813,2016_Omri Casspi
2016,Shaun Livingston,PG,30,203,379,0.5356200527704486,2,12,0.16666666666666666,201,367,0.547683923705722,80,93,0.8602150537634409,42,127,169,237,57,27,78,140,488,2016_Shaun Livingston
2017,Aaron Brooks,PG,32,121,300,0.4033333333333333,48,128,0.375,73,172,0.42441860465116277,32,40,0.8,18,51,69,125,25,9,66,93,322,2017_Aaron Brooks
2017,Adreian Payne,PF,25,23,54,0.42592592592592593,3,15,0.2,20,39,0.5128205128205128,14,19,0.7368421052631579,9,24,33,7,8,7,8,32,63,2017_Adreian Payne
2017,Jarell Eddie,SF,25,6,19,0.3157894736842105,4,16,0.25,2,3,0.6666666666666666,8,9,0.8888888888888888,1,6,7,0,1,0,1,1,24,2017_Jarell Eddie
2017,Justin Anderson,SF,23,372,878,0.42369020501138954,116,388,0.29896907216494845,256,490,0.5224489795918368,204,258,0.7906976744186046,138,352,490,132,82,46,132,218,1064,2017_Justin Anderson
2017,LaMarcus Aldridge,PF,31,500,1049,0.47664442326024786,23,56,0.4107142857142857,477,993,0.48036253776435045,220,271,0.8118081180811808,174,350,524,139,46,89,98,158,1243,2017_LaMarcus Aldridge
2017,Luke Babbitt,SF,27,113,281,0.40213523131672596,87,210,0.4142857142857143,26,71,0.36619718309859156,11,15,0.7333333333333333,13,129,142,36,21,11,25,118,324,2017_Luke Babbitt
2017,Omri Casspi,SF,28,154,330,0.4666666666666667,30,86,0.3488372093023256,124,244,0.5081967213114754,34,58,0.5862068965517241,54,170,224,74,46,6,58,100,372,2017_Omri Casspi
2017,Thaddeus Young,PF,28,362,687,0.5269286754002911,45,118,0.3813559322033898,317,569,0.5571177504393673,45,86,0.5232558139534884,131,318,449,122,114,30,96,135,814,2017_Thaddeus Young
2017,Treveon Graham,SG,23,19,40,0.475,9,15,0.6,10,25,0.4,10,15,0.6666666666666666,5,17,22,6,6,1,3,18,57,2017_Treveon Graham
2003,Adrian Griffin,SG,28,146,337,0.4332344213649852,6,24,0.25,140,313,0.4472843450479233,27,32,0.84375,88,176,264,105,77,6,47,157,325,2003_Adrian Griffin
2003,Allan Houston,SG,31,652,1465,0.44505119453924913,178,450,0.39555555555555555,474,1015,0.4669950738916256,363,395,0.9189873417721519,26,205,231,220,54,7,178,191,1845,2003_Allan Houston
2003,Amar'e Stoudemire,PF,20,392,830,0.472289156626506,2,10,0.2,390,820,0.47560975609756095,320,484,0.6611570247933884,250,471,721,78,62,87,189,269,1106,2003_Amar'e Stoudemire
2003,Andrei Kirilenko,SF,21,315,642,0.49065420560747663,37,114,0.32456140350877194,278,528,0.5265151515151515,296,370,0.8,147,273,420,138,118,175,136,185,963,2003_Andrei Kirilenko
2003,Ansu Sesay,SF,26,41,107,0.38317757009345793,0,0,NaN,41,107,0.38317757009345793,12,21,0.5714285714285714,34,39,73,23,14,5,25,62,94,2003_Ansu Sesay
2003,Ben Wallace,C,28,210,437,0.4805491990846682,1,6,0.16666666666666666,209,431,0.48491879350348027,85,189,0.4497354497354497,293,833,1126,120,104,230,88,179,506,2003_Ben Wallace
2003,Chris Crawford,PF,27,8,13,0.6153846153846154,1,3,0.3333333333333333,7,10,0.7,7,8,0.875,3,4,7,1,2,3,2,7,24,2003_Chris Crawford
2003,Dalibor Bagaric,C,22,8,26,0.3076923076923077,0,0,NaN,8,26,0.3076923076923077,3,4,0.75,7,13,20,4,3,3,5,11,19,2003_Dalibor Bagaric
2003,Don Reid,PF,29,0,3,0.0,0,0,NaN,0,3,0.0,1,2,0.5,0,0,0,0,0,0,0,4,1,2003_Don Reid
2003,Jermaine Jackson,SG,26,80,220,0.36363636363636365,2,20,0.1,78,200,0.39,80,110,0.7272727272727273,38,76,114,148,38,12,68,102,242,2003_Jermaine Jackson
2003,Joe Smith,SF,27,151,328,0.4603658536585366,0,2,0.0,151,326,0.46319018404907975,102,131,0.7786259541984732,111,159,270,38,14,55,43,171,404,2003_Joe Smith
2003,Joel Przybilla,C,23,18,46,0.391304347826087,0,0,NaN,18,46,0.391304347826087,12,24,0.5,48,97,145,12,10,45,19,85,48,2003_Joel Przybilla
2003,Lee Nailon,SF,27,84,190,0.4421052631578947,0,1,0.0,84,189,0.4444444444444444,42,51,0.8235294117647058,32,38,70,26,6,3,32,46,210,2003_Lee Nailon
2003,Othella Harrington,PF,29,225,443,0.5079006772009029,0,0,NaN,225,443,0.5079006772009029,123,150,0.82,165,311,476,62,12,23,90,231,573,2003_Othella Harrington
2003,Reggie Evans,PF,22,66,140,0.4714285714285714,0,0,NaN,66,140,0.4714285714285714,80,154,0.5194805194805194,167,278,445,34,38,11,52,173,212,2003_Reggie Evans
2003,Rodney White,SG,22,260,638,0.40752351097178685,32,134,0.23880597014925373,228,504,0.4523809523809524,98,125,0.784,43,170,213,121,45,32,156,134,650,2003_Rodney White
2003,Scot Pollard,C,27,40,87,0.45977011494252873,0,0,NaN,40,87,0.45977011494252873,23,38,0.6052631578947368,46,60,106,6,13,15,15,50,103,2003_Scot Pollard
2003,Vlade Divac,C,34,305,655,0.46564885496183206,6,25,0.24,299,630,0.4746031746031746,179,251,0.7131474103585658,157,417,574,274,83,105,152,239,795,2003_Vlade Divac
2004,Allan Houston,SG,32,340,781,0.4353393085787452,87,202,0.4306930693069307,253,579,0.4369602763385147,157,172,0.9127906976744186,20,101,121,99,38,2,102,105,924,2004_Allan Houston
2004,Amar'e Stoudemire,PF,21,411,865,0.4751445086705202,1,5,0.2,410,860,0.47674418604651164,310,435,0.7126436781609196,157,339,496,78,64,89,177,188,1133,2004_Amar'e Stoudemire
2004,Ben Wallace,C,29,315,748,0.42112299465240643,1,8,0.125,314,740,0.4243243243243243,142,290,0.4896551724137931,324,682,1006,138,143,246,123,162,773,2004_Ben Wallace
2004,Darius Songaila,PF,25,133,273,0.48717948717948717,0,0,NaN,133,273,0.48717948717948717,71,88,0.8068181818181818,91,134,225,48,42,12,43,126,337,2004_Darius Songaila
2004,George Lynch,SF,33,149,375,0.3973333333333333,43,139,0.30935251798561153,106,236,0.4491525423728814,34,51,0.6666666666666666,96,216,312,117,48,18,64,159,375,2004_George Lynch
2004,Joe Smith,PF,28,311,708,0.4392655367231638,1,5,0.2,310,703,0.44096728307254623,207,241,0.8589211618257261,230,413,643,78,47,94,82,209,830,2004_Joe Smith
2004,Lucious Harris,PG,33,187,463,0.4038876889848812,38,101,0.37623762376237624,149,362,0.4116022099447514,66,78,0.8461538461538461,39,101,140,135,41,2,53,74,478,2004_Lucious Harris
2004,Maciej Lampe,C,18,43,88,0.48863636363636365,0,4,0.0,43,84,0.5119047619047619,10,13,0.7692307692307693,9,35,44,9,3,3,15,28,96,2004_Maciej Lampe
2004,Mike Bibby,PG,25,527,1170,0.45042735042735044,148,378,0.3915343915343915,379,792,0.47853535353535354,304,373,0.8150134048257373,67,210,277,444,112,18,175,146,1506,2004_Mike Bibby
2004,Mike Sweetney,PF,21,69,140,0.4928571428571429,0,1,0.0,69,139,0.49640287769784175,42,58,0.7241379310344828,68,89,157,14,18,12,32,57,180,2004_Mike Sweetney
2004,Sean Lampley,SF,24,13,20,0.65,0,0,NaN,13,20,0.65,8,12,0.6666666666666666,2,9,11,2,0,1,3,2,34,2004_Sean Lampley
2004,Shane Heal,PG,33,7,24,0.2916666666666667,4,18,0.2222222222222222,3,6,0.5,4,5,0.8,1,3,4,5,1,0,5,2,22,2004_Shane Heal
2004,Tony Delk,SG,30,70,184,0.3804347826086957,20,66,0.30303030303030304,50,118,0.423728813559322,37,44,0.8409090909090909,16,43,59,28,27,7,17,46,197,2004_Tony Delk
2004,Vlade Divac,C,35,314,668,0.47005988023952094,2,13,0.15384615384615385,312,655,0.4763358778625954,170,260,0.6538461538461539,136,327,463,432,57,77,173,222,800,2004_Vlade Divac
2005,Allan Houston,SG,33,85,205,0.4146341463414634,31,80,0.3875,54,125,0.432,36,43,0.8372093023255814,4,19,23,42,8,2,21,40,237,2005_Allan Houston
2005,Amar'e Stoudemire,C,22,747,1336,0.5591317365269461,3,16,0.1875,744,1320,0.5636363636363636,583,795,0.7333333333333333,219,494,713,131,77,130,189,278,2080,2005_Amar'e Stoudemire
2005,Beno Udrih,PG,22,173,390,0.44358974358974357,58,142,0.4084507042253521,115,248,0.4637096774193548,67,89,0.7528089887640449,16,67,83,150,41,10,77,96,471,2005_Beno Udrih
2005,Chris Webber,PF,31,1110,2566,0.4325798908807482,30,88,0.3409090909090909,1080,2478,0.4358353510895884,362,456,0.793859649122807,260,964,1224,636,188,106,364,428,2612,2005_Chris Webber
2005,Damon Stoudamire,PG,31,457,1165,0.392274678111588,181,490,0.3693877551020408,276,675,0.4088888888888889,182,199,0.914572864321608,56,254,310,458,86,2,164,158,1277,2005_Damon Stoudamire
2005,Darius Songaila,PF,26,257,488,0.5266393442622951,0,3,0.0,257,485,0.5298969072164949,94,111,0.8468468468468469,125,219,344,114,51,18,70,206,608,2005_Darius Songaila
2005,David Wesley,SG,34,668,1680,0.3976190476190476,236,630,0.3746031746031746,432,1050,0.4114285714285714,324,378,0.8571428571428571,76,380,456,530,192,18,226,430,1896,2005_David Wesley
2005,Fred Hoiberg,SG,32,139,284,0.4894366197183099,70,145,0.4827586206896552,69,139,0.49640287769784175,89,102,0.8725490196078431,32,149,181,85,50,15,20,105,437,2005_Fred Hoiberg
2005,Grant Hill,SF,32,517,1015,0.50935960591133,3,13,0.23076923076923078,514,1002,0.5129740518962076,280,341,0.8211143695014663,77,241,318,220,97,28,161,144,1317,2005_Grant Hill
2005,Ira Newble,SG,30,182,424,0.42924528301886794,19,53,0.3584905660377358,163,371,0.4393530997304582,55,69,0.7971014492753623,78,142,220,91,50,18,61,144,438,2005_Ira Newble
2005,Joe Smith,PF,29,319,621,0.5136876006441223,0,1,0.0,319,620,0.5145161290322581,175,228,0.7675438596491229,179,362,541,67,43,38,79,222,813,2005_Joe Smith
2005,Juan Dixon,SG,26,186,447,0.4161073825503356,48,147,0.32653061224489793,138,300,0.46,87,97,0.8969072164948454,32,87,119,111,43,4,68,98,507,2005_Juan Dixon
2005,Kris Humphries,PF,19,116,287,0.40418118466898956,2,6,0.3333333333333333,114,281,0.40569395017793597,44,101,0.43564356435643564,73,124,197,43,25,18,52,96,278,2005_Kris Humphries
2005,Mike Sweetney,C,22,237,446,0.531390134529148,0,1,0.0,237,445,0.5325842696629214,176,235,0.7489361702127659,169,249,418,44,27,28,108,224,650,2005_Mike Sweetney
2005,Nick Van,SG,33,214,561,0.38146167557932265,100,257,0.38910505836575876,114,304,0.375,58,74,0.7837837837837838,20,141,161,227,44,0,92,70,586,2005_Nick Van
2005,Rasheed Wallace,PF,30,467,1062,0.4397363465160075,75,236,0.3177966101694915,392,826,0.4745762711864407,136,195,0.6974358974358974,174,470,644,142,65,115,127,236,1145,2005_Rasheed Wallace
2005,Raul Lopez,PG,24,57,135,0.4222222222222222,20,45,0.4444444444444444,37,90,0.4111111111111111,27,33,0.8181818181818182,7,32,39,123,22,3,47,78,161,2005_Raul Lopez
2005,Smush Parker,PG,23,36,86,0.4186046511627907,6,26,0.23076923076923078,30,60,0.5,18,26,0.6923076923076923,8,16,24,30,10,0,38,32,96,2005_Smush Parker
2005,Tony Delk,SG,31,246,591,0.41624365482233505,72,202,0.3564356435643564,174,389,0.4473007712082262,103,136,0.7573529411764706,28,102,130,104,47,3,54,123,667,2005_Tony Delk
2005,Vlade Divac,C,36,13,31,0.41935483870967744,0,0,NaN,13,31,0.41935483870967744,8,12,0.6666666666666666,18,14,32,19,4,1,14,25,34,2005_Vlade Divac
2006,Amar'e Stoudemire,C,23,9,27,0.3333333333333333,0,1,0.0,9,26,0.34615384615384615,8,9,0.8888888888888888,6,10,16,2,1,3,1,4,26,2006_Amar'e Stoudemire
2006,Anderson Varejao,C,23,79,150,0.5266666666666666,0,1,0.0,79,149,0.5302013422818792,61,119,0.5126050420168067,77,158,235,19,31,19,27,118,219,2006_Anderson Varejao
2006,Andrew Bogut,PF,21,323,606,0.533003300330033,0,3,0.0,323,603,0.5356550580431177,122,194,0.6288659793814433,189,384,573,192,49,68,125,259,768,2006_Andrew Bogut
2006,Anthony Roberson,PG,22,14,31,0.45161290322580644,5,10,0.5,9,21,0.42857142857142855,2,2,1.0,0,6,6,5,1,0,3,6,35,2006_Anthony Roberson
2006,Darius Songaila,PF,27,236,491,0.48065173116089616,2,5,0.4,234,486,0.48148148148148145,94,115,0.8173913043478261,76,170,246,88,35,16,85,157,568,2006_Darius Songaila
2006,Ike Diogu,PF,22,175,334,0.5239520958083832,0,0,NaN,175,334,0.5239520958083832,136,168,0.8095238095238095,95,134,229,29,15,30,78,164,486,2006_Ike Diogu
2006,Jason Maxiell,PF,22,23,54,0.42592592592592593,0,0,NaN,23,54,0.42592592592592593,14,42,0.3333333333333333,12,16,28,3,4,5,11,14,60,2006_Jason Maxiell
2006,Mateen Cleaves,PG,28,25,71,0.352112676056338,4,16,0.25,21,55,0.38181818181818183,19,24,0.7916666666666666,2,12,14,42,3,2,14,30,73,2006_Mateen Cleaves
2006,Mike Sweetney,C,23,200,444,0.45045045045045046,0,0,NaN,200,444,0.45045045045045046,133,204,0.6519607843137255,118,232,350,59,19,56,95,209,533,2006_Mike Sweetney
2006,Rasheed Wallace,PF,31,459,1067,0.4301780693533271,155,434,0.35714285714285715,304,633,0.4802527646129542,136,183,0.7431693989071039,90,457,547,182,82,130,85,232,1209,2006_Rasheed Wallace
2006,Toni Kukoc,PF,37,116,298,0.38926174496644295,45,147,0.30612244897959184,71,151,0.47019867549668876,40,56,0.7142857142857143,26,124,150,139,33,17,66,87,317,2006_Toni Kukoc
2006,Tony Delk,PG-SG_SG_PG,32,142,322,0.4409937888198758,40,94,0.425531914893617,102,228,0.4473684210526316,40,54,0.7407407407407407,28,78,106,66,26,2,38,56,364,2006_Tony Delk
2006,Wally Szczerbiak,SF,28,986,2024,0.4871541501976285,204,510,0.4,782,1514,0.5165125495376486,556,620,0.896774193548387,154,472,626,426,80,38,272,300,2732,2006_Wally Szczerbiak
2007,Amar'e Stoudemire,C,24,607,1055,0.5753554502369668,0,3,0.0,607,1052,0.5769961977186312,457,585,0.7811965811965812,222,564,786,84,78,110,232,295,1671,2007_Amar'e Stoudemire
2007,Darius Songaila,PF,28,118,225,0.5244444444444445,0,2,0.0,118,223,0.5291479820627802,46,54,0.8518518518518519,44,90,134,38,17,10,43,105,282,2007_Darius Songaila
2007,Dee Brown,PG,22,32,98,0.32653061224489793,6,28,0.21428571428571427,26,70,0.37142857142857144,24,37,0.6486486486486487,8,32,40,83,22,7,31,51,94,2007_Dee Brown
2007,Devin Harris,PG,23,292,593,0.4924114671163575,14,50,0.28,278,543,0.5119705340699816,215,261,0.8237547892720306,45,151,196,296,96,21,146,242,813,2007_Devin Harris
2007,Earl Boykins,PG,30,646,1538,0.42002600780234073,190,478,0.39748953974895396,456,1060,0.43018867924528303,440,490,0.8979591836734694,98,180,278,582,112,4,240,184,1922,2007_Earl Boykins
2007,Ike Diogu,PF,23,254,532,0.4774436090225564,0,0,NaN,254,532,0.4774436090225564,224,280,0.8,150,256,406,50,16,52,134,244,732,2007_Ike Diogu
2007,Jason Maxiell,C,23,131,262,0.5,0,0,NaN,131,262,0.5,72,137,0.5255474452554745,88,98,186,14,30,60,53,110,334,2007_Jason Maxiell
2007,Josh Childress,SG,23,261,518,0.5038610038610039,26,77,0.33766233766233766,235,441,0.5328798185941043,167,210,0.7952380952380952,123,217,340,127,58,36,80,118,715,2007_Josh Childress
2007,Maceo Baston,PF,31,49,76,0.6447368421052632,3,7,0.42857142857142855,46,69,0.6666666666666666,37,47,0.7872340425531915,21,53,74,16,12,18,32,65,138,2007_Maceo Baston
2007,Mike Sweetney,C,24,58,134,0.43283582089552236,0,0,NaN,58,134,0.43283582089552236,37,66,0.5606060606060606,45,75,120,28,9,11,42,79,153,2007_Mike Sweetney
2007,Pat Garrity,PF,30,22,70,0.3142857142857143,11,32,0.34375,11,38,0.2894736842105263,16,18,0.8888888888888888,12,30,42,14,7,0,14,37,71,2007_Pat Garrity
2007,Rasheed Wallace,C,32,357,843,0.4234875444839858,104,296,0.35135135135135137,253,547,0.4625228519195612,108,137,0.7883211678832117,90,453,543,127,75,118,94,225,926,2007_Rasheed Wallace
2007,Stanislav Medvedenko,C,27,12,29,0.41379310344827586,1,2,0.5,11,27,0.4074074074074074,17,20,0.85,4,10,14,2,0,2,5,16,42,2007_Stanislav Medvedenko
2008,Amar'e Stoudemire,C,25,714,1211,0.5895953757225434,5,31,0.16129032258064516,709,1180,0.6008474576271187,556,691,0.804630969609262,178,541,719,118,64,163,174,294,1989,2008_Amar'e Stoudemire
2008,Arron Afflalo,SG,22,99,241,0.4107883817427386,10,48,0.20833333333333334,89,193,0.46113989637305697,68,87,0.7816091954022989,36,101,137,52,31,8,34,83,276,2008_Arron Afflalo
2008,Boris Diaw,PF,25,308,646,0.47678018575851394,13,41,0.3170731707317073,295,605,0.48760330578512395,96,129,0.7441860465116279,97,281,378,317,61,39,155,166,725,2008_Boris Diaw
2008,Cuttino Mobley,SG,32,377,870,0.43333333333333335,67,192,0.3489583333333333,310,678,0.45722713864306785,163,199,0.8190954773869347,50,225,275,202,78,34,123,152,984,2008_Cuttino Mobley
2008,Dan Dickau,PG,29,124,296,0.4189189189189189,36,108,0.3333333333333333,88,188,0.46808510638297873,68,82,0.8292682926829268,13,84,97,172,32,3,55,108,352,2008_Dan Dickau
2008,Darius Songaila,C,29,214,467,0.4582441113490364,0,2,0.0,214,465,0.46021505376344085,67,73,0.9178082191780822,81,190,271,135,53,16,86,181,495,2008_Darius Songaila
2008,Dominic McGuire,SG,22,39,103,0.3786407766990291,1,6,0.16666666666666666,38,97,0.3917525773195876,14,32,0.4375,53,86,139,40,20,26,40,76,93,2008_Dominic McGuire
2008,Ike Diogu,PF,24,64,134,0.47761194029850745,0,0,NaN,64,134,0.47761194029850745,40,47,0.851063829787234,38,47,85,10,7,3,20,43,168,2008_Ike Diogu
2008,Jason Maxiell,C,24,240,446,0.5381165919282511,0,1,0.0,240,445,0.5393258426966292,171,270,0.6333333333333333,177,256,433,46,21,94,71,183,651,2008_Jason Maxiell
2008,Juwan Howard,PF,34,23,64,0.359375,0,0,NaN,23,64,0.359375,11,14,0.7857142857142857,21,60,81,17,5,2,17,62,57,2008_Juwan Howard
2008,Marcus Camby,C,33,286,635,0.4503937007874016,6,20,0.3,280,615,0.45528455284552843,143,202,0.7079207920792079,230,807,1037,259,85,285,118,216,721,2008_Marcus Camby
2008,Pat Garrity,PF,31,27,80,0.3375,8,37,0.21621621621621623,19,43,0.4418604651162791,4,5,0.8,9,35,44,13,6,1,17,35,66,2008_Pat Garrity
2008,Rafer Alston,PG,31,364,924,0.3939393939393939,143,407,0.35135135135135137,221,517,0.4274661508704062,98,137,0.7153284671532847,28,232,260,392,98,18,160,139,969,2008_Rafer Alston
2008,Rasheed Wallace,C,33,376,870,0.432183908045977,112,315,0.35555555555555557,264,555,0.4756756756756757,115,150,0.7666666666666667,84,427,511,137,91,129,86,213,979,2008_Rasheed Wallace
2008,Yao Ming,C,27,432,852,0.5070422535211268,0,2,0.0,432,850,0.508235294117647,345,406,0.8497536945812808,172,422,594,129,25,111,183,171,1209,2008_Yao Ming
2009,Amar'e Stoudemire,PF,26,404,749,0.5393858477970628,3,7,0.42857142857142855,401,742,0.5404312668463612,323,387,0.834625322997416,116,314,430,104,49,57,150,163,1134,2009_Amar'e Stoudemire
2009,Arron Afflalo,SG,23,131,300,0.43666666666666665,43,107,0.40186915887850466,88,193,0.45595854922279794,58,71,0.8169014084507042,30,104,134,44,28,13,43,144,363,2009_Arron Afflalo
2009,Charlie Bell,SG,29,217,524,0.41412213740458015,87,240,0.3625,130,284,0.45774647887323944,66,80,0.825,32,102,134,151,50,7,76,138,587,2009_Charlie Bell
2009,DeMarcus Nelson,PG,23,24,54,0.4444444444444444,0,3,0.0,24,51,0.47058823529411764,5,14,0.35714285714285715,6,18,24,13,9,2,15,24,53,2009_DeMarcus Nelson
2009,Dee Brown,PG,24,36,98,0.3673469387755102,14,48,0.2916666666666667,22,50,0.44,6,10,0.6,14,44,58,72,20,0,34,56,92,2009_Dee Brown
2009,Dominic McGuire,SF,23,140,324,0.43209876543209874,2,4,0.5,138,320,0.43125,74,102,0.7254901960784313,113,315,428,198,62,74,92,153,356,2009_Dominic McGuire
2009,Ike Diogu,PF,25,78,148,0.527027027027027,2,4,0.5,76,144,0.5277777777777778,80,106,0.7547169811320755,52,60,112,6,6,6,24,46,238,2009_Ike Diogu
2009,Jason Maxiell,C,25,184,320,0.575,0,1,0.0,184,319,0.5768025078369906,84,158,0.5316455696202531,169,155,324,24,25,63,45,157,452,2009_Jason Maxiell
2009,Jawad Williams,SF,25,5,12,0.4166666666666667,2,6,0.3333333333333333,3,6,0.5,0,0,NaN,1,1,2,0,1,0,1,2,12,2009_Jawad Williams
2009,LeBron James,SF,24,789,1613,0.48915065096094235,132,384,0.34375,657,1229,0.5345809601301872,594,762,0.7795275590551181,106,507,613,587,137,93,241,139,2304,2009_LeBron James
2009,Rasheed Wallace,C,34,302,720,0.41944444444444445,113,319,0.3542319749216301,189,401,0.4713216957605985,78,101,0.7722772277227723,56,434,490,91,62,86,59,197,795,2009_Rasheed Wallace
2009,Shawn Marion,SF,30,764,1576,0.4847715736040609,20,106,0.18867924528301888,744,1470,0.5061224489795918,234,294,0.7959183673469388,360,818,1178,278,176,132,210,264,1782,2009_Shawn Marion
2009,Spencer Hawes,C,20,373,800,0.46625,40,115,0.34782608695652173,333,685,0.48613138686131385,90,136,0.6617647058823529,148,401,549,149,44,93,160,249,876,2009_Spencer Hawes
2010,Antonio Anderson,SF,24,1,3,0.3333333333333333,0,0,NaN,1,3,0.3333333333333333,0,0,NaN,1,0,1,0,0,0,1,1,2,2010_Antonio Anderson
2010,Ben Wallace,C,35,158,292,0.541095890410959,0,2,0.0,158,290,0.5448275862068965,65,160,0.40625,245,352,597,105,86,84,64,131,381,2010_Ben Wallace
2010,Chuck Hayes,C,26,161,329,0.48936170212765956,0,0,NaN,161,329,0.48936170212765956,36,66,0.5454545454545454,151,314,465,139,73,43,74,219,358,2010_Chuck Hayes
2010,Darius Songaila,C,31,241,488,0.49385245901639346,1,6,0.16666666666666666,240,482,0.4979253112033195,60,74,0.8108108108108109,59,173,232,70,62,14,81,206,543,2010_Darius Songaila
2010,Derrick Rose,PG,21,672,1373,0.48943918426802624,16,60,0.26666666666666666,656,1313,0.49961919268849964,259,338,0.7662721893491125,65,228,293,469,57,27,217,96,1619,2010_Derrick Rose
2010,Earl Barron,C,28,30,68,0.4411764705882353,0,0,NaN,30,68,0.4411764705882353,22,29,0.7586206896551724,31,46,77,8,4,4,11,24,82,2010_Earl Barron
2010,Jared Jeffries,SF_PF_PF-SF,28,276,628,0.4394904458598726,42,142,0.29577464788732394,234,486,0.48148148148148145,150,240,0.625,260,316,576,202,124,142,152,406,744,2010_Jared Jeffries
2010,Jason Kidd,PG,36,284,671,0.4232488822652757,176,414,0.4251207729468599,108,257,0.42023346303501946,80,99,0.8080808080808081,48,397,445,724,145,35,195,142,824,2010_Jason Kidd
2010,Joe Smith,PF,34,77,193,0.39896373056994816,1,7,0.14285714285714285,76,186,0.40860215053763443,39,48,0.8125,66,91,157,21,6,19,22,95,194,2010_Joe Smith
2010,Joel Anthony,C,27,76,159,0.4779874213836478,0,0,NaN,76,159,0.4779874213836478,66,92,0.717391304347826,123,126,249,12,20,109,45,158,218,2010_Joel Anthony
2010,Jordan Farmar,PG,23,224,515,0.4349514563106796,86,229,0.37554585152838427,138,286,0.4825174825174825,57,85,0.6705882352941176,14,117,131,127,52,11,72,109,591,2010_Jordan Farmar
2010,Josh Howard,SF,29,314,776,0.40463917525773196,46,172,0.26744186046511625,268,604,0.44370860927152317,218,278,0.7841726618705036,60,190,250,96,52,22,92,182,892,2010_Josh Howard
2010,Luis Scola,PF,29,560,1090,0.5137614678899083,1,5,0.2,559,1085,0.5152073732718894,208,267,0.7790262172284644,175,530,705,169,63,26,163,246,1329,2010_Luis Scola
2010,Sasha Vujacic,SG,25,66,164,0.4024390243902439,25,81,0.30864197530864196,41,83,0.4939759036144578,28,33,0.8484848484848485,25,54,79,41,20,4,17,67,185,2010_Sasha Vujacic
2011,Ben Wallace,C,36,67,149,0.44966442953020136,1,2,0.5,66,147,0.4489795918367347,19,57,0.3333333333333333,129,221,350,72,54,54,44,81,154,2011_Ben Wallace
2011,Cartier Martin,SF,26,71,182,0.3901098901098901,39,99,0.3939393939393939,32,83,0.3855421686746988,28,40,0.7,20,54,74,18,18,6,16,52,209,2011_Cartier Martin
2011,Chuck Hayes,C,27,244,463,0.5269978401727862,0,2,0.0,244,461,0.5292841648590022,94,142,0.6619718309859155,219,380,599,202,79,49,86,200,582,2011_Chuck Hayes
2011,Damien Wilkins,SF,31,69,137,0.5036496350364964,2,10,0.2,67,127,0.5275590551181102,40,56,0.7142857142857143,23,67,90,41,27,9,21,72,180,2011_Damien Wilkins
2011,Dante Cunningham,PF,23,436,944,0.461864406779661,2,26,0.07692307692307693,434,918,0.47276688453159044,90,124,0.7258064516129032,192,362,554,86,108,86,102,354,964,2011_Dante Cunningham
2011,Darius Songaila,C,32,7,15,0.4666666666666667,0,0,NaN,7,15,0.4666666666666667,2,4,0.5,2,8,10,2,0,0,4,16,16,2011_Darius Songaila
2011,Earl Barron,C,29,64,198,0.32323232323232326,0,0,NaN,64,198,0.32323232323232326,30,48,0.625,64,88,152,22,16,12,32,92,158,2011_Earl Barron
2011,Ish Smith,PG,22,86,230,0.3739130434782609,6,20,0.3,80,210,0.38095238095238093,24,42,0.5714285714285714,14,80,94,158,36,4,68,74,202,2011_Ish Smith
2011,Joe Smith,PF,35,6,32,0.1875,0,0,NaN,6,32,0.1875,4,4,1.0,6,36,42,8,0,8,10,26,16,2011_Joe Smith
2011,John Wall,PG,20,398,972,0.4094650205761317,34,115,0.2956521739130435,364,857,0.42473745624270715,301,393,0.7659033078880407,35,282,317,574,121,35,261,175,1131,2011_John Wall
2011,Jordan Farmar,PG,24,255,651,0.391705069124424,109,304,0.35855263157894735,146,347,0.4207492795389049,82,100,0.82,24,149,173,368,62,6,139,128,701,2011_Jordan Farmar
2011,Ryan Gomes,SF,28,207,505,0.4099009900990099,72,211,0.3412322274881517,135,294,0.45918367346938777,61,85,0.7176470588235294,61,193,254,118,62,12,55,159,547,2011_Ryan Gomes
2011,Sasha Vujacic,SG,26,478,1190,0.4016806722689076,194,524,0.3702290076335878,284,666,0.4264264264264264,162,192,0.84375,60,312,372,264,108,10,132,272,1312,2011_Sasha Vujacic
2011,Shaun Livingston,PG,25,185,397,0.4659949622166247,1,4,0.25,184,393,0.4681933842239186,108,125,0.864,29,120,149,164,47,29,88,109,479,2011_Shaun Livingston
2011,Wesley Johnson,SG,23,271,682,0.3973607038123167,103,289,0.356401384083045,168,393,0.42748091603053434,64,92,0.6956521739130435,51,189,240,148,58,54,95,163,709,2011_Wesley Johnson
2012,Ben Wallace,C,37,34,86,0.3953488372093023,1,4,0.25,33,82,0.4024390243902439,16,47,0.3404255319148936,81,188,269,43,47,51,34,60,85,2012_Ben Wallace
2012,Chuck Hayes,C,28,73,170,0.4294117647058823,0,2,0.0,73,168,0.43452380952380953,26,39,0.6666666666666666,72,162,234,77,36,17,50,111,172,2012_Chuck Hayes
2012,Derrick Williams,PF,20,205,498,0.41164658634538154,37,138,0.26811594202898553,168,360,0.4666666666666667,136,195,0.6974358974358974,77,234,311,38,30,31,77,95,583,2012_Derrick Williams
2012,Ed Davis,PF,22,172,335,0.5134328358208955,0,1,0.0,172,334,0.5149700598802395,71,106,0.6698113207547169,134,304,438,60,40,63,67,156,415,2012_Ed Davis
2012,Ish Smith,PG,23,62,162,0.38271604938271603,6,18,0.3333333333333333,56,144,0.3888888888888889,14,20,0.7,14,56,70,82,30,4,26,30,144,2012_Ish Smith
2012,Jason Richardson,SG,31,243,596,0.4077181208053691,102,277,0.36823104693140796,141,319,0.44200626959247646,41,69,0.5942028985507246,36,158,194,107,53,22,60,91,629,2012_Jason Richardson
2012,John Wall,PG,21,378,894,0.4228187919463087,3,42,0.07142857142857142,375,852,0.44014084507042256,317,402,0.7885572139303483,48,252,300,530,95,57,255,137,1076,2012_John Wall
2012,Jordan Farmar,PG,25,147,315,0.4666666666666667,55,125,0.44,92,190,0.4842105263157895,57,63,0.9047619047619048,7,54,61,129,24,2,68,49,406,2012_Jordan Farmar
2012,Kirk Hinrich,SG,31,122,295,0.4135593220338983,47,136,0.34558823529411764,75,159,0.4716981132075472,25,32,0.78125,11,90,101,132,38,11,58,100,316,2012_Kirk Hinrich
2012,Mario Chalmers,PG,25,223,498,0.44779116465863456,101,260,0.38846153846153847,122,238,0.5126050420168067,80,101,0.7920792079207921,16,155,171,222,97,11,142,166,627,2012_Mario Chalmers
2012,Ricky Rubio,PG,21,139,389,0.35732647814910024,32,94,0.3404255319148936,107,295,0.36271186440677966,126,157,0.802547770700637,21,150,171,336,91,8,131,97,436,2012_Ricky Rubio
2013,Alonzo Gee,SF,25,305,744,0.4099462365591398,69,219,0.3150684931506849,236,525,0.44952380952380955,163,205,0.7951219512195122,75,245,320,133,107,29,132,199,842,2013_Alonzo Gee
2013,Amar'e Stoudemire,PF,30,154,267,0.5767790262172284,0,0,NaN,154,267,0.5767790262172284,105,130,0.8076923076923077,60,85,145,13,10,21,50,89,413,2013_Amar'e Stoudemire
2013,Charlie Villanueva,PF,28,175,464,0.3771551724137931,90,259,0.3474903474903475,85,205,0.4146341463414634,27,49,0.5510204081632653,49,192,241,54,31,39,39,96,467,2013_Charlie Villanueva
2013,Chuck Hayes,C,29,84,190,0.4421052631578947,0,1,0.0,84,189,0.4444444444444444,30,48,0.625,113,186,299,112,31,18,44,114,198,2013_Chuck Hayes
2013,Gerald Green,SF,27,155,424,0.36556603773584906,59,188,0.31382978723404253,96,236,0.4067796610169492,52,65,0.8,31,110,141,50,19,23,53,64,421,2013_Gerald Green
2013,Ish Smith,PG,24,112,318,0.3522012578616352,16,54,0.2962962962962963,96,264,0.36363636363636365,6,14,0.42857142857142855,24,98,122,174,42,18,74,52,246,2013_Ish Smith
2013,John Wall,PG,22,324,735,0.44081632653061226,12,45,0.26666666666666666,312,690,0.45217391304347826,246,306,0.803921568627451,35,161,196,373,65,37,157,117,906,2013_John Wall
2013,Kevin Durant,SF,24,731,1433,0.5101186322400558,139,334,0.4161676646706587,592,1099,0.5386715195632393,679,750,0.9053333333333333,46,594,640,374,116,105,280,143,2280,2013_Kevin Durant
2013,Linas Kleiza,SF,28,48,144,0.3333333333333333,20,66,0.30303030303030304,28,78,0.358974358974359,32,38,0.8421052631578947,10,42,52,16,4,2,14,45,148,2013_Linas Kleiza
2013,Nikola Vucevic,C,22,461,889,0.5185601799775028,0,3,0.0,461,886,0.5203160270880361,86,126,0.6825396825396826,273,644,917,143,61,79,141,218,1008,2013_Nikola Vucevic
2013,Ricky Rubio,PG,22,185,514,0.35992217898832685,27,92,0.29347826086956524,158,422,0.3744075829383886,211,264,0.7992424242424242,44,185,229,418,137,5,172,143,608,2013_Ricky Rubio
2013,Sasha Pavlovic,SG,29,42,119,0.35294117647058826,18,60,0.3,24,59,0.4067796610169492,1,6,0.16666666666666666,7,49,56,32,24,5,14,59,103,2013_Sasha Pavlovic
2013,Tyler Zeller,C,23,245,559,0.43828264758497315,0,4,0.0,245,555,0.44144144144144143,120,157,0.7643312101910829,159,279,438,96,35,70,95,251,610,2013_Tyler Zeller
2013,Viacheslav Kravtsov,C,25,33,46,0.717391304347826,0,0,NaN,33,46,0.717391304347826,11,37,0.2972972972972973,24,21,45,9,5,9,14,32,77,2013_Viacheslav Kravtsov
2014,Amar'e Stoudemire,C,31,311,558,0.557347670250896,0,0,NaN,311,558,0.557347670250896,150,203,0.7389162561576355,112,208,320,34,23,37,91,159,772,2014_Amar'e Stoudemire
2014,Andrei Kirilenko,PF,32,82,160,0.5125,1,5,0.2,81,155,0.5225806451612903,61,119,0.5126050420168067,55,91,146,72,40,19,54,65,226,2014_Andrei Kirilenko
2014,Anthony Davis,PF,20,522,1005,0.5194029850746269,2,9,0.2222222222222222,520,996,0.5220883534136547,348,440,0.7909090909090909,207,466,673,105,89,189,109,200,1394,2014_Anthony Davis
2014,Brandon Jennings,PG,24,423,1135,0.3726872246696035,154,457,0.33698030634573306,269,678,0.3967551622418879,241,321,0.7507788161993769,59,185,244,609,101,8,215,157,1241,2014_Brandon Jennings
2014,Chris Bosh,C,29,492,953,0.5162644281217209,74,218,0.3394495412844037,418,735,0.5687074829931973,223,272,0.8198529411764706,98,424,522,87,80,78,125,192,1281,2014_Chris Bosh
2014,Doron Lamb,SG,22,63,160,0.39375,36,90,0.4,27,70,0.38571428571428573,29,36,0.8055555555555556,8,41,49,43,11,1,27,54,191,2014_Doron Lamb
2014,Francisco Garcia,SF,32,118,294,0.4013605442176871,69,193,0.35751295336787564,49,101,0.48514851485148514,10,19,0.5263157894736842,21,101,122,63,27,33,30,120,315,2014_Francisco Garcia
2014,Ish Smith,PG,25,119,281,0.4234875444839858,1,23,0.043478260869565216,118,258,0.4573643410852713,22,39,0.5641025641025641,31,98,129,179,49,13,65,66,261,2014_Ish Smith
2014,Jason Maxiell,PF,30,47,105,0.44761904761904764,0,0,NaN,47,105,0.44761904761904764,15,31,0.4838709677419355,28,58,86,9,8,20,14,47,109,2014_Jason Maxiell
2014,Jeff Withey,C,23,69,129,0.5348837209302325,0,1,0.0,69,128,0.5390625,52,73,0.7123287671232876,49,101,150,26,15,50,20,73,190,2014_Jeff Withey
2014,John Wall,PG,23,579,1337,0.4330590875093493,108,308,0.35064935064935066,471,1029,0.4577259475218659,317,394,0.8045685279187818,38,295,333,721,149,40,295,219,1583,2014_John Wall
2014,Jordan Farmar,PG,27,151,364,0.41483516483516486,70,160,0.4375,81,204,0.39705882352941174,44,59,0.7457627118644068,20,84,104,199,38,8,95,65,416,2014_Jordan Farmar
2014,Randy Foye,SG,30,361,875,0.4125714285714286,189,498,0.3795180722891566,172,377,0.4562334217506631,157,185,0.8486486486486486,36,196,232,287,67,39,145,205,1068,2014_Randy Foye
2014,Reggie Evans,PF,33,142,300,0.47333333333333333,0,0,NaN,142,300,0.47333333333333333,144,260,0.5538461538461539,230,438,668,42,74,6,116,238,428,2014_Reggie Evans
2014,Ricky Rubio,PG,23,255,670,0.3805970149253731,44,133,0.3308270676691729,211,537,0.3929236499068901,227,283,0.8021201413427562,61,281,342,704,191,11,221,218,781,2014_Ricky Rubio
2014,Sasha Vujacic,SG,29,2,5,0.4,1,2,0.5,1,3,0.3333333333333333,0,0,NaN,0,3,3,0,1,0,3,1,5,2014_Sasha Vujacic
2014,Tyshawn Taylor,PG,23,31,91,0.34065934065934067,3,12,0.25,28,79,0.35443037974683544,24,30,0.8,3,12,15,36,12,1,31,29,89,2014_Tyshawn Taylor
2014,Viacheslav Kravtsov,C,26,8,15,0.5333333333333333,0,0,NaN,8,15,0.5333333333333333,4,8,0.5,9,8,17,1,0,1,6,7,20,2014_Viacheslav Kravtsov
2015,Amar'e Stoudemire,PF,32,546,980,0.5571428571428572,0,8,0.0,546,972,0.5617283950617284,268,372,0.7204301075268817,220,438,658,90,58,76,156,322,1360,2015_Amar'e Stoudemire
2015,Anthony Davis,PF,21,642,1199,0.5354462051709759,1,12,0.08333333333333333,641,1187,0.540016849199663,371,461,0.8047722342733189,173,523,696,149,100,200,95,141,1656,2015_Anthony Davis
2015,Chandler Parsons,SF,26,383,829,0.4620024125452352,132,347,0.3804034582132565,251,482,0.520746887966805,139,193,0.7202072538860104,64,259,323,161,69,19,96,140,1037,2015_Chandler Parsons
2015,Ish Smith,PG,26,286,734,0.3896457765667575,36,120,0.3,250,614,0.40716612377850164,68,114,0.5964912280701754,30,170,200,360,72,12,156,100,676,2015_Ish Smith
2015,Jack Cooley,PF,23,9,22,0.4090909090909091,0,0,NaN,9,22,0.4090909090909091,9,21,0.42857142857142855,10,15,25,1,6,3,3,23,27,2015_Jack Cooley
2015,Jason Maxiell,PF,31,81,192,0.421875,0,0,NaN,81,192,0.421875,41,71,0.5774647887323944,86,117,203,19,18,44,29,96,203,2015_Jason Maxiell
2015,Jeff Withey,C,24,32,64,0.5,0,0,NaN,32,64,0.5,34,50,0.68,23,41,64,11,4,18,12,26,98,2015_Jeff Withey
2015,John Wall,PG,24,519,1166,0.4451114922813036,65,217,0.2995391705069124,454,949,0.47839831401475236,284,362,0.7845303867403315,36,330,366,792,138,45,304,180,1387,2015_John Wall
2015,Jordan Clarkson,PG,22,267,596,0.44798657718120805,38,121,0.3140495867768595,229,475,0.48210526315789476,131,158,0.8291139240506329,56,135,191,206,51,12,96,109,703,2015_Jordan Clarkson
2015,Jordan Farmar,PG,28,61,158,0.3860759493670886,35,97,0.36082474226804123,26,61,0.4262295081967213,10,11,0.9090909090909091,8,34,42,67,20,5,32,52,167,2015_Jordan Farmar
2015,Lance Thomas,SF_PF_PF-SF,26,364,884,0.4117647058823529,14,44,0.3181818181818182,350,840,0.4166666666666667,144,198,0.7272727272727273,130,260,390,138,74,16,148,202,886,2015_Lance Thomas
2015,Ricky Rubio,PG,24,78,219,0.3561643835616438,13,51,0.2549019607843137,65,168,0.3869047619047619,57,71,0.8028169014084507,19,106,125,193,38,1,64,59,226,2015_Ricky Rubio
2015,Rodney Stuckey,PG,28,332,754,0.4403183023872679,55,141,0.3900709219858156,277,613,0.45187601957585644,177,216,0.8194444444444444,36,212,248,219,56,10,118,131,896,2015_Rodney Stuckey
2015,Russ Smith,PG,23,16,50,0.32,4,22,0.18181818181818182,12,28,0.42857142857142855,24,26,0.9230769230769231,2,10,12,16,6,0,24,26,60,2015_Russ Smith
2016,Amar'e Stoudemire,C,33,125,221,0.5656108597285068,0,0,NaN,125,221,0.5656108597285068,50,67,0.746268656716418,65,157,222,27,18,41,47,92,300,2016_Amar'e Stoudemire
2016,Anthony Davis,C,22,560,1136,0.49295774647887325,35,108,0.32407407407407407,525,1028,0.5107003891050583,326,430,0.7581395348837209,130,497,627,116,78,125,121,148,1481,2016_Anthony Davis
2016,Arron Afflalo,SG,30,354,799,0.4430538172715895,91,238,0.38235294117647056,263,561,0.46880570409982175,110,131,0.8396946564885496,23,243,266,144,25,10,82,142,909,2016_Arron Afflalo
2016,Beno Udrih,PG,33,172,396,0.43434343434343436,30,88,0.3409090909090909,142,308,0.461038961038961,36,40,0.9,16,128,144,232,28,2,106,102,410,2016_Beno Udrih
2016,Courtney Lee,SG,30,580,1278,0.4538341158059468,164,434,0.3778801843317972,416,844,0.4928909952606635,198,236,0.8389830508474576,58,352,410,272,170,56,144,268,1522,2016_Courtney Lee
2016,Gorgui Dieng,C,26,308,579,0.531951640759931,6,20,0.3,302,559,0.5402504472271914,205,248,0.8266129032258065,157,428,585,143,94,96,140,219,827,2016_Gorgui Dieng
2016,Ish Smith,PG,27,794,1934,0.4105480868665977,112,340,0.32941176470588235,682,1594,0.42785445420326224,244,352,0.6931818181818182,86,524,610,1004,176,48,350,266,1944,2016_Ish Smith
2016,J.R. Smith,SG,30,353,850,0.4152941176470588,204,510,0.4,149,340,0.43823529411764706,45,71,0.6338028169014085,43,174,217,130,81,21,59,204,955,2016_J.R. Smith
2016,JaVale McGee,C,28,77,134,0.5746268656716418,0,1,0.0,77,133,0.5789473684210527,18,36,0.5,53,80,133,3,5,26,21,49,172,2016_JaVale McGee
2016,James Anderson,SG,26,67,178,0.37640449438202245,23,86,0.26744186046511625,44,92,0.4782608695652174,22,29,0.7586206896551724,13,73,86,41,21,14,42,54,179,2016_James Anderson
2016,Jeff Withey,C,25,87,162,0.5370370370370371,0,2,0.0,87,160,0.54375,43,59,0.7288135593220338,56,117,173,20,21,53,28,75,217,2016_Jeff Withey
2016,Jeremy Lin,SG,27,300,728,0.41208791208791207,76,226,0.336283185840708,224,502,0.44621513944223107,238,292,0.815068493150685,42,211,253,235,58,42,150,165,914,2016_Jeremy Lin
2016,John Wall,PG,25,572,1349,0.4240177909562639,115,328,0.35060975609756095,457,1021,0.4476003917727718,272,344,0.7906976744186046,42,337,379,789,145,59,318,159,1531,2016_John Wall
2016,Jordan Clarkson,SG,23,475,1098,0.4326047358834244,111,320,0.346875,364,778,0.46786632390745503,164,204,0.803921568627451,93,220,313,192,88,7,135,168,1225,2016_Jordan Clarkson
2016,Jordan Farmar,PG,29,42,100,0.42,16,45,0.35555555555555557,26,55,0.4727272727272727,10,10,1.0,4,21,25,37,15,2,18,22,110,2016_Jordan Farmar
2016,Raymond Felton,PG,31,277,682,0.40615835777126097,60,213,0.28169014084507044,217,469,0.4626865671641791,149,176,0.8465909090909091,36,222,258,284,68,15,121,141,763,2016_Raymond Felton
2016,Ricky Rubio,PG,25,219,586,0.37372013651877134,62,190,0.3263157894736842,157,396,0.39646464646464646,266,314,0.8471337579617835,40,286,326,658,162,10,193,201,766,2016_Ricky Rubio
2016,Robert Sacre,C,26,31,75,0.41333333333333333,0,0,NaN,31,75,0.41333333333333333,25,38,0.6578947368421053,32,40,72,14,4,10,12,43,87,2016_Robert Sacre
2016,Walter Tavares,C,23,11,19,0.5789473684210527,0,0,NaN,11,19,0.5789473684210527,3,8,0.375,7,14,21,3,1,6,5,8,25,2016_Walter Tavares
2017,Allen Crabbe,SG,24,303,647,0.46831530139103555,134,302,0.44370860927152317,169,345,0.48985507246376814,105,124,0.8467741935483871,19,206,225,93,54,20,62,171,845,2017_Allen Crabbe
2017,Anderson Varejao,C,34,5,14,0.35714285714285715,0,0,NaN,5,14,0.35714285714285715,8,11,0.7272727272727273,12,15,27,10,3,3,8,16,18,2017_Anderson Varejao
2017,Andrew Bogut,C,32,76,162,0.4691358024691358,0,2,0.0,76,160,0.475,6,22,0.2727272727272727,112,324,436,98,26,50,86,172,158,2017_Andrew Bogut
2017,Anthony Davis,C,23,770,1527,0.5042567125081859,40,134,0.29850746268656714,730,1393,0.5240488155061019,519,647,0.8021638330757341,174,712,886,157,94,167,181,168,2099,2017_Anthony Davis
2017,Arron Afflalo,SG,31,185,420,0.44047619047619047,62,151,0.4105960264900662,123,269,0.45724907063197023,83,93,0.8924731182795699,9,116,125,78,21,7,42,104,515,2017_Arron Afflalo
2017,Glenn Robinson,SF,23,158,338,0.46745562130177515,49,125,0.392,109,213,0.5117370892018779,54,76,0.7105263157894737,57,188,245,47,41,20,37,63,419,2017_Glenn Robinson
2017,Ish Smith,PG,28,329,749,0.4392523364485981,28,105,0.26666666666666666,301,644,0.4673913043478261,72,102,0.7058823529411765,21,214,235,418,61,33,112,127,758,2017_Ish Smith
2017,Ivica Zubac,C,19,126,238,0.5294117647058824,0,3,0.0,126,235,0.5361702127659574,32,49,0.6530612244897959,41,118,159,30,14,33,30,66,284,2017_Ivica Zubac
2017,Jeff Withey,C,26,55,103,0.5339805825242718,0,1,0.0,55,102,0.5392156862745098,36,48,0.75,52,69,121,7,16,32,14,52,146,2017_Jeff Withey
2017,John Wall,PG,26,647,1435,0.4508710801393728,89,272,0.3272058823529412,558,1163,0.47979363714531387,422,527,0.8007590132827325,58,268,326,831,157,49,323,151,1805,2017_John Wall
2017,Jordan Clarkson,SG,24,477,1071,0.44537815126050423,117,356,0.32865168539325845,360,715,0.5034965034965035,134,168,0.7976190476190477,49,197,246,213,88,8,164,150,1205,2017_Jordan Clarkson
2017,Kristaps Porzingis,PF,21,443,985,0.449746192893401,112,314,0.35668789808917195,331,671,0.4932935916542474,198,252,0.7857142857142857,111,364,475,97,47,130,118,244,1196,2017_Kristaps Porzingis
2017,Ricky Rubio,PG,26,261,650,0.4015384615384615,60,196,0.30612244897959184,201,454,0.44273127753303965,254,285,0.8912280701754386,68,237,305,682,128,10,195,202,836,2017_Ricky Rubio
2017,Stanley Johnson,SF,20,129,365,0.35342465753424657,45,154,0.2922077922077922,84,211,0.3981042654028436,36,53,0.6792452830188679,36,153,189,105,56,24,71,121,339,2017_Stanley Johnson
2017,Willy Hernangomez,C,22,246,465,0.5290322580645161,4,15,0.26666666666666666,242,450,0.5377777777777778,91,125,0.728,170,332,502,96,41,36,100,150,587,2017_Willy Hernangomez
2003,Allen Iverson,SG,27,804,1940,0.4144329896907217,84,303,0.27722772277227725,720,1637,0.4398289554062309,570,736,0.7744565217391305,68,276,344,454,225,13,286,149,2262,2003_Allen Iverson
2003,Cuttino Mobley,SG,27,463,1067,0.4339268978444236,112,318,0.3522012578616352,351,749,0.46862483311081443,242,282,0.8581560283687943,70,233,303,208,95,36,166,185,1280,2003_Cuttino Mobley
2003,Donny Marshall,SF,30,0,3,0.0,0,1,0.0,0,2,0.0,0,0,NaN,0,3,3,0,0,0,1,0,0,2003_Donny Marshall
2003,Doug Christie,SG,32,267,557,0.4793536804308797,73,185,0.3945945945945946,194,372,0.521505376344086,141,174,0.8103448275862069,61,281,342,376,180,37,144,186,748,2003_Doug Christie
2003,Eddie Robinson,SF,26,155,315,0.49206349206349204,3,14,0.21428571428571427,152,301,0.5049833887043189,51,63,0.8095238095238095,76,124,200,66,62,13,52,120,364,2003_Eddie Robinson
2003,Juwan Howard,PF,29,567,1261,0.44964314036478986,2,4,0.5,565,1257,0.4494828957836118,282,351,0.8034188034188035,181,404,585,234,77,27,189,239,1418,2003_Juwan Howard
2003,Lawrence Funderburke,PF,32,32,72,0.4444444444444444,0,0,NaN,32,72,0.4444444444444444,10,17,0.5882352941176471,17,38,55,8,1,11,6,25,74,2003_Lawrence Funderburke
2003,Marcus Camby,C,28,93,227,0.40969162995594716,2,5,0.4,91,222,0.4099099099099099,33,50,0.66,75,133,208,47,20,40,27,69,221,2003_Marcus Camby
2003,Mike Batiste,PF,25,197,467,0.42184154175588867,18,81,0.2222222222222222,179,386,0.4637305699481865,69,88,0.7840909090909091,82,175,257,52,42,16,69,120,481,2003_Mike Batiste
2003,Paul Pierce,SG,25,663,1592,0.4164572864321608,118,391,0.30179028132992325,545,1201,0.4537885095753539,604,753,0.8021248339973439,106,472,578,349,139,62,288,227,2048,2003_Paul Pierce
2003,Rafer Alston,PG,26,139,335,0.41492537313432837,51,130,0.3923076923076923,88,205,0.4292682926829268,37,54,0.6851851851851852,21,86,107,192,38,15,86,120,366,2003_Rafer Alston
2003,Richard Hamilton,SG,24,570,1286,0.4432348367029549,32,119,0.2689075630252101,538,1167,0.46101113967437873,440,528,0.8333333333333334,88,230,318,208,64,13,200,249,1612,2003_Richard Hamilton
2003,Scottie Pippen,SF,37,265,597,0.4438860971524288,38,133,0.2857142857142857,227,464,0.4892241379310345,121,148,0.8175675675675675,57,221,278,285,105,25,164,149,689,2003_Scottie Pippen
2003,Speedy Claxton,PG,24,67,145,0.46206896551724136,0,11,0.0,67,134,0.5,39,57,0.6842105263157895,22,34,56,75,22,7,35,43,173,2003_Speedy Claxton
2003,Steve Kerr,PG,37,110,256,0.4296875,49,124,0.3951612903225806,61,132,0.4621212121212121,30,34,0.8823529411764706,12,48,60,70,27,3,35,49,299,2003_Steve Kerr
2003,Tony Massenburg,C,35,104,232,0.4482758620689655,0,0,NaN,104,232,0.4482758620689655,65,84,0.7738095238095238,59,97,156,17,17,19,50,144,273,2003_Tony Massenburg
2004,Allen Iverson,SG,28,435,1125,0.38666666666666666,57,199,0.2864321608040201,378,926,0.408207343412527,339,455,0.7450549450549451,34,144,178,324,115,5,209,87,1266,2004_Allen Iverson
2004,Caron Butler,SF,23,240,631,0.3803486529318542,10,42,0.23809523809523808,230,589,0.3904923599320883,133,176,0.7556818181818182,92,234,326,126,75,13,91,162,623,2004_Caron Butler
2004,Chris Kaman,C,21,200,435,0.45977011494252873,0,2,0.0,200,433,0.4618937644341801,99,142,0.6971830985915493,126,335,461,85,23,73,155,211,499,2004_Chris Kaman
2004,Doug Christie,SG,33,317,688,0.46075581395348836,49,142,0.34507042253521125,268,546,0.4908424908424908,148,172,0.8604651162790697,69,260,329,347,151,41,155,186,831,2004_Doug Christie
2004,Keon Clark,PF,28,2,6,0.3333333333333333,0,0,NaN,2,6,0.3333333333333333,0,0,NaN,1,6,7,1,1,0,0,1,4,2004_Keon Clark
2004,LeBron James,SG,19,622,1492,0.4168900804289544,63,217,0.2903225806451613,559,1275,0.4384313725490196,347,460,0.7543478260869565,99,333,432,465,130,58,273,149,1654,2004_LeBron James
2004,Marcus Fizer,SF,25,134,350,0.38285714285714284,2,17,0.11764705882352941,132,333,0.3963963963963964,90,120,0.75,61,141,202,43,16,8,51,97,360,2004_Marcus Fizer
2004,Matt Carroll,SG,23,14,32,0.4375,2,6,0.3333333333333333,12,26,0.46153846153846156,8,12,0.6666666666666666,2,10,12,4,2,0,12,16,38,2004_Matt Carroll
2004,Maurice Taylor,PF,27,367,765,0.4797385620915033,0,2,0.0,367,763,0.48099606815203144,128,174,0.735632183908046,131,253,384,107,43,47,149,253,862,2004_Maurice Taylor
2004,Milt Palacio,PG,25,104,298,0.348993288590604,4,26,0.15384615384615385,100,272,0.36764705882352944,45,68,0.6617647058823529,15,87,102,184,41,11,87,90,257,2004_Milt Palacio
2004,Paul Pierce,SG,26,602,1497,0.4021376085504342,115,384,0.2994791666666667,487,1113,0.43755615453728663,517,631,0.8193343898573693,69,453,522,410,131,52,303,234,1836,2004_Paul Pierce
2004,Shawn Marion,SF,25,590,1341,0.4399701715137957,90,265,0.33962264150943394,500,1076,0.4646840148698885,228,268,0.8507462686567164,212,525,737,214,167,104,156,203,1498,2004_Shawn Marion
2004,Stromile Swift,PF,24,268,571,0.46935201401050786,1,4,0.25,267,567,0.4708994708994709,190,262,0.7251908396946565,141,237,378,38,56,118,88,188,727,2004_Stromile Swift
2004,Tony Massenburg,PF,36,104,219,0.4748858447488584,0,1,0.0,104,218,0.47706422018348627,43,63,0.6825396825396826,57,131,188,29,14,18,45,144,251,2004_Tony Massenburg
2005,Allen Iverson,PG,29,771,1818,0.4240924092409241,104,338,0.3076923076923077,667,1480,0.4506756756756757,656,786,0.8346055979643766,51,248,299,596,180,9,344,140,2302,2005_Allen Iverson
2005,Chris Kaman,C,22,246,495,0.49696969696969695,0,1,0.0,246,494,0.4979757085020243,80,121,0.6611570247933884,135,288,423,73,26,68,115,182,572,2005_Chris Kaman
2005,Doug Christie,SG,34,260,664,0.39156626506024095,30,124,0.24193548387096775,230,540,0.42592592592592593,140,156,0.8974358974358975,76,278,354,398,160,36,208,212,690,2005_Doug Christie
2005,Eduardo Najera,PF,28,290,644,0.4503105590062112,12,42,0.2857142857142857,278,602,0.46179401993355484,116,182,0.6373626373626373,204,282,486,130,82,48,122,296,708,2005_Eduardo Najera
2005,Jared Jeffries,SF,23,203,434,0.46774193548387094,16,51,0.3137254901960784,187,383,0.48825065274151436,101,173,0.5838150289017341,152,222,374,151,66,35,114,206,523,2005_Jared Jeffries
2005,Jason Kidd,PG,31,340,855,0.39766081871345027,129,358,0.36033519553072624,211,497,0.4245472837022133,142,192,0.7395833333333334,94,394,488,545,123,9,167,110,951,2005_Jason Kidd
2005,Michael Olowokandi,C,29,161,353,0.45609065155807366,0,0,NaN,161,353,0.45609065155807366,46,69,0.6666666666666666,106,218,324,29,15,56,68,193,368,2005_Michael Olowokandi
2005,Paul Pierce,SF,27,556,1223,0.45461978740801307,108,292,0.3698630136986301,448,931,0.48120300751879697,549,668,0.8218562874251497,78,461,539,348,133,39,230,255,1769,2005_Paul Pierce
2005,Paul Shirley,PF,27,5,11,0.45454545454545453,0,0,NaN,5,11,0.45454545454545453,2,4,0.5,1,1,2,3,0,0,1,3,12,2005_Paul Shirley
2005,Sebastian Telfair,PG,19,169,430,0.3930232558139535,17,69,0.2463768115942029,152,361,0.42105263157894735,105,133,0.7894736842105263,10,94,104,224,35,4,125,120,460,2005_Sebastian Telfair
2005,Tony Massenburg,PF,37,74,182,0.4065934065934066,0,0,NaN,74,182,0.4065934065934066,48,63,0.7619047619047619,54,109,163,14,18,20,40,122,196,2005_Tony Massenburg
2005,Walter McCarty,PF,30,190,470,0.40425531914893614,110,310,0.3548387096774194,80,160,0.5,30,58,0.5172413793103449,58,218,276,74,50,30,72,288,520,2005_Walter McCarty
2006,C.J. Miles,PG,18,28,76,0.3684210526315789,5,20,0.25,23,56,0.4107142857142857,18,24,0.75,18,20,38,16,7,2,9,20,79,2006_C.J. Miles
2006,Chris Kaman,C,23,369,706,0.5226628895184136,0,2,0.0,369,704,0.5241477272727273,194,252,0.7698412698412699,187,563,750,79,45,108,176,269,932,2006_Chris Kaman
2006,Chris Mihm,C,26,230,459,0.5010893246187363,0,0,NaN,230,459,0.5010893246187363,144,201,0.7164179104477612,137,236,373,61,16,73,83,214,604,2006_Chris Mihm
2006,Chris Taft,C,20,23,38,0.6052631578947368,0,0,NaN,23,38,0.6052631578947368,1,6,0.16666666666666666,19,17,36,2,2,7,2,25,47,2006_Chris Taft
2006,Darrick Martin,PG,34,34,97,0.35051546391752575,16,40,0.4,18,57,0.3157894736842105,18,24,0.75,2,18,20,57,17,0,15,42,102,2006_Darrick Martin
2006,Doug Christie,SG,35,9,26,0.34615384615384615,0,1,0.0,9,25,0.36,8,12,0.6666666666666666,2,11,13,14,9,1,6,10,26,2006_Doug Christie
2006,Greg Buckner,SG,29,181,417,0.434052757793765,86,243,0.35390946502057613,95,174,0.5459770114942529,43,55,0.7818181818181819,31,178,209,127,87,20,52,180,491,2006_Greg Buckner
2006,Keith Bogans,SF_SG_SG-SF,25,430,1088,0.3952205882352941,130,400,0.325,300,688,0.436046511627907,254,372,0.6827956989247311,110,400,510,256,142,18,180,334,1244,2006_Keith Bogans
2006,Lamar Odom,PF,26,445,925,0.4810810810810811,80,215,0.37209302325581395,365,710,0.5140845070422535,216,313,0.6900958466453674,181,557,738,443,75,64,213,256,1186,2006_Lamar Odom
2006,Linton Johnson,SF,25,122,298,0.40939597315436244,26,72,0.3611111111111111,96,226,0.4247787610619469,36,54,0.6666666666666666,80,164,244,28,24,24,56,122,306,2006_Linton Johnson
2006,Melvin Sanders,SG,25,16,33,0.48484848484848486,2,3,0.6666666666666666,14,30,0.4666666666666667,7,10,0.7,4,19,23,3,5,0,8,20,41,2006_Melvin Sanders
2006,Paul Pierce,SF,28,689,1462,0.47127222982216144,111,314,0.3535031847133758,578,1148,0.5034843205574913,627,812,0.7721674876847291,77,453,530,375,107,34,273,223,2116,2006_Paul Pierce
2006,Ryan Gomes,PF,23,173,355,0.48732394366197185,3,9,0.3333333333333333,170,346,0.4913294797687861,112,149,0.7516778523489933,102,196,298,58,35,5,55,83,461,2006_Ryan Gomes
2006,Shaun Livingston,PG,20,149,349,0.4269340974212034,1,8,0.125,148,341,0.4340175953079179,53,77,0.6883116883116883,41,142,183,273,46,32,111,160,352,2006_Shaun Livingston
2006,Tim Thomas,SF_PF_PF-SF,28,226,524,0.4312977099236641,92,222,0.4144144144144144,134,302,0.44370860927152317,56,84,0.6666666666666666,44,218,262,40,32,14,66,156,600,2006_Tim Thomas
2007,Andres Nocioni,PF,27,273,584,0.4674657534246575,80,209,0.3827751196172249,193,375,0.5146666666666667,123,145,0.8482758620689655,42,259,301,57,27,24,104,164,749,2007_Andres Nocioni
2007,Brad Miller,C,30,224,494,0.4534412955465587,5,33,0.15151515151515152,219,461,0.4750542299349241,115,149,0.7718120805369127,79,322,401,224,38,39,108,155,568,2007_Brad Miller
2007,Chris Kaman,C,24,294,652,0.450920245398773,0,1,0.0,294,651,0.45161290322580644,166,224,0.7410714285714286,160,428,588,79,41,116,147,251,754,2007_Chris Kaman
2007,Doug Christie,SG,36,5,17,0.29411764705882354,1,6,0.16666666666666666,4,11,0.36363636363636365,2,3,0.6666666666666666,3,8,11,8,3,1,5,11,13,2007_Doug Christie
2007,Michael Redd,SF,27,477,1025,0.4653658536585366,117,306,0.38235294117647056,360,719,0.5006954102920723,345,416,0.8293269230769231,42,154,196,124,63,9,122,78,1416,2007_Michael Redd
2007,Nenad Krstic,C,23,170,323,0.5263157894736842,0,1,0.0,170,322,0.5279503105590062,86,121,0.7107438016528925,51,125,176,46,10,24,52,88,426,2007_Nenad Krstic
2007,Paul Pierce,SG,29,373,850,0.4388235294117647,107,275,0.3890909090909091,266,575,0.46260869565217394,320,402,0.7960199004975125,39,238,277,194,48,13,152,122,1173,2007_Paul Pierce
2007,Sean Marks,PF,31,2,6,0.3333333333333333,0,1,0.0,2,5,0.4,2,2,1.0,0,3,3,0,0,1,0,4,6,2007_Sean Marks
2007,Shammond Williams,PG,31,35,86,0.4069767441860465,20,50,0.4,15,36,0.4166666666666667,4,6,0.6666666666666666,11,29,40,31,12,0,13,20,94,2007_Shammond Williams
2007,Tarence Kinsey,SG,22,139,304,0.45723684210526316,13,46,0.2826086956521739,126,258,0.4883720930232558,78,98,0.7959183673469388,29,68,97,41,53,1,46,57,369,2007_Tarence Kinsey
2007,Yaroslav Korolev,SF,19,4,16,0.25,1,5,0.2,3,11,0.2727272727272727,3,6,0.5,1,2,3,4,3,0,1,0,12,2007_Yaroslav Korolev
2008,Brad Miller,C,31,337,728,0.46291208791208793,28,90,0.3111111111111111,309,638,0.4843260188087774,262,309,0.8478964401294499,167,514,681,264,69,74,164,247,964,2008_Brad Miller
2008,C.J. Watson,PG,23,43,101,0.42574257425742573,9,26,0.34615384615384615,34,75,0.4533333333333333,23,29,0.7931034482758621,13,19,32,35,15,0,18,19,118,2008_C.J. Watson
2008,Carl Landry,PF,24,135,219,0.6164383561643836,0,1,0.0,135,218,0.6192660550458715,72,109,0.6605504587155964,96,111,207,21,17,7,26,98,342,2008_Carl Landry
2008,Carlos Delfino,SG,25,251,632,0.3971518987341772,120,314,0.3821656050955414,131,318,0.4119496855345912,116,156,0.7435897435897436,66,293,359,145,69,11,75,177,738,2008_Carlos Delfino
2008,Cedric Simmons,PF,22,8,28,0.2857142857142857,0,0,NaN,8,28,0.2857142857142857,0,20,0.0,12,24,36,0,4,10,12,16,16,2008_Cedric Simmons
2008,Charlie Villanueva,PF,23,354,814,0.4348894348894349,55,185,0.2972972972972973,299,629,0.4753577106518283,123,157,0.7834394904458599,145,321,466,78,30,35,107,174,886,2008_Charlie Villanueva
2008,Chris Kaman,C,25,338,700,0.4828571428571429,0,4,0.0,338,696,0.48563218390804597,202,265,0.7622641509433963,173,538,711,107,33,155,164,179,878,2008_Chris Kaman
2008,Gerald Green,SF,22,104,302,0.3443708609271523,30,78,0.38461538461538464,74,224,0.33035714285714285,68,82,0.8292682926829268,26,102,128,58,16,8,64,90,306,2008_Gerald Green
2008,Jorge Garbajosa,PF,30,8,25,0.32,6,16,0.375,2,9,0.2222222222222222,0,0,NaN,2,13,15,3,3,0,1,2,22,2008_Jorge Garbajosa
2008,Kenny Thomas,PF,30,16,38,0.42105263157894735,0,0,NaN,16,38,0.42105263157894735,0,5,0.0,18,43,61,13,6,1,21,38,32,2008_Kenny Thomas
2008,Linas Kleiza,SF,23,311,659,0.47192716236722304,94,277,0.33935018050541516,217,382,0.5680628272251309,164,213,0.7699530516431925,92,241,333,95,44,19,89,181,880,2008_Linas Kleiza
2008,Lindsey Hunter,PG,37,22,64,0.34375,7,26,0.2692307692307692,15,38,0.39473684210526316,7,9,0.7777777777777778,4,9,13,33,13,2,13,30,58,2008_Lindsey Hunter
2008,Ryan Bowen,SF,32,49,100,0.49,0,1,0.0,49,99,0.494949494949495,16,29,0.5517241379310345,55,45,100,25,32,11,15,77,114,2008_Ryan Bowen
2008,Sasha Pavlovic,SG,24,146,403,0.36228287841191065,34,114,0.2982456140350877,112,289,0.3875432525951557,53,77,0.6883116883116883,35,93,128,82,29,6,55,117,379,2008_Sasha Pavlovic
2009,Brad Miller,C,32,584,1228,0.4755700325732899,46,112,0.4107142857142857,538,1116,0.482078853046595,448,544,0.8235294117647058,300,790,1090,468,104,72,260,446,1662,2009_Brad Miller
2009,C.J. Watson,PG,24,257,562,0.45729537366548045,48,120,0.4,209,442,0.47285067873303166,168,193,0.8704663212435233,39,153,192,206,96,4,92,137,730,2009_C.J. Watson
2009,Carl Landry,PF,25,240,418,0.5741626794258373,1,3,0.3333333333333333,239,415,0.5759036144578313,157,193,0.8134715025906736,124,219,343,39,26,31,68,166,638,2009_Carl Landry
2009,Chris Bosh,C,24,615,1263,0.48693586698337293,12,49,0.24489795918367346,603,1214,0.49670510708401977,504,617,0.8168557536466775,215,556,771,191,67,77,174,189,1746,2009_Chris Bosh
2009,Chris Kaman,C,26,161,305,0.5278688524590164,0,0,NaN,161,305,0.5278688524590164,51,75,0.68,75,172,247,46,17,45,84,93,373,2009_Chris Kaman
2009,John Salmons,SF,29,1032,2186,0.47209515096065874,252,604,0.41721854304635764,780,1582,0.49304677623261695,576,694,0.829971181556196,118,548,666,498,166,48,330,364,2892,2009_John Salmons
2009,Luke Ridnour,PG,27,250,621,0.4025764895330113,55,157,0.3503184713375796,195,464,0.4202586206896552,133,153,0.869281045751634,33,185,218,365,92,16,128,200,688,2009_Luke Ridnour
2009,Malik Hairston,SG,21,24,49,0.4897959183673469,0,1,0.0,24,48,0.5,2,7,0.2857142857142857,11,17,28,13,6,7,12,19,50,2009_Malik Hairston
2009,Mario West,SG,24,14,34,0.4117647058823529,1,1,1.0,13,33,0.3939393939393939,14,30,0.4666666666666667,24,32,56,19,18,4,13,35,43,2009_Mario West
2009,Paul Davis,PF,24,40,98,0.40816326530612246,0,1,0.0,40,97,0.41237113402061853,27,34,0.7941176470588235,28,39,67,12,10,3,13,44,107,2009_Paul Davis
2009,Quentin Richardson,SG,28,262,667,0.39280359820089955,120,329,0.364741641337386,142,338,0.42011834319526625,89,117,0.7606837606837606,71,248,319,117,47,7,74,132,733,2009_Quentin Richardson
2010,Allen Iverson,SG-PG_SG_PG,34,272,632,0.43037974683544306,18,50,0.36,254,582,0.436426116838488,208,262,0.7938931297709924,32,126,158,226,38,4,128,96,770,2010_Allen Iverson
2010,Andre Miller,PG,33,404,908,0.44493392070484583,16,80,0.2,388,828,0.46859903381642515,322,392,0.8214285714285714,81,185,266,445,93,9,173,169,1146,2010_Andre Miller
2010,Didier Ilunga-Mbenga,C,29,48,103,0.46601941747572817,0,0,NaN,48,103,0.46601941747572817,9,19,0.47368421052631576,32,55,87,8,5,29,15,54,105,2010_Didier Ilunga-Mbenga
2010,Ersan Ilyasova,PF,22,323,729,0.4430727023319616,81,241,0.3360995850622407,242,488,0.4959016393442623,113,158,0.7151898734177216,157,360,517,84,53,23,71,251,840,2010_Ersan Ilyasova
2010,George Hill,PG,23,353,738,0.47831978319783197,75,188,0.39893617021276595,278,550,0.5054545454545455,183,237,0.7721518987341772,42,163,205,226,69,26,101,222,964,2010_George Hill
2010,Joe Johnson,SG,28,635,1386,0.45815295815295815,129,350,0.36857142857142855,506,1036,0.48841698841698844,220,269,0.8178438661710037,74,279,353,369,82,5,145,145,1619,2010_Joe Johnson
2010,Kosta Koufos,C,20,22,47,0.46808510638297873,0,0,NaN,22,47,0.46808510638297873,9,15,0.6,16,29,45,6,2,4,15,26,53,2010_Kosta Koufos
2010,Nate Robinson,PG,25,430,986,0.43610547667342797,174,446,0.3901345291479821,256,540,0.4740740740740741,100,134,0.746268656716418,56,164,220,326,98,10,146,232,1134,2010_Nate Robinson
2010,Paul Pierce,SF,32,409,867,0.4717416378316032,109,263,0.4144486692015209,300,604,0.4966887417218543,369,433,0.8521939953810623,39,271,310,218,84,31,166,196,1296,2010_Paul Pierce
2010,Ramon Sessions,PG,23,253,555,0.45585585585585586,1,15,0.06666666666666667,252,540,0.4666666666666667,167,233,0.7167381974248928,58,156,214,258,55,5,137,137,674,2010_Ramon Sessions
2010,Roy Hibbert,C,23,387,782,0.4948849104859335,3,6,0.5,384,776,0.4948453608247423,169,224,0.7544642857142857,177,287,464,158,30,131,145,285,946,2010_Roy Hibbert
2010,Sebastian Telfair,PG,24,166,402,0.4129353233830846,26,112,0.23214285714285715,140,290,0.4827586206896552,58,74,0.7837837837837838,10,80,90,252,48,10,100,142,416,2010_Sebastian Telfair
2010,Solomon Jones,C,25,78,176,0.4431818181818182,0,3,0.0,78,173,0.4508670520231214,51,71,0.7183098591549296,51,93,144,32,14,37,40,125,207,2010_Solomon Jones
2010,Tyler Hansbrough,PF,24,81,225,0.36,0,4,0.0,81,221,0.3665158371040724,84,113,0.7433628318584071,60,78,138,28,17,8,21,70,246,2010_Tyler Hansbrough
2011,Andy Rautins,SG,24,3,7,0.42857142857142855,1,4,0.25,2,3,0.6666666666666666,1,2,0.5,0,1,1,3,1,0,7,0,8,2011_Andy Rautins
2011,Beno Udrih,PG,28,412,824,0.5,65,182,0.35714285714285715,347,642,0.5404984423676013,197,228,0.8640350877192983,41,224,265,386,94,9,141,181,1086,2011_Beno Udrih
2011,Courtney Lee,SG,25,253,576,0.4392361111111111,71,174,0.40804597701149425,182,402,0.4527363184079602,95,120,0.7916666666666666,51,158,209,100,58,18,68,102,672,2011_Courtney Lee
2011,Garrett Temple,PG-SG_SG_PG,24,40,136,0.29411764705882354,20,74,0.2702702702702703,20,62,0.3225806451612903,14,34,0.4117647058823529,2,44,46,64,22,12,46,48,114,2011_Garrett Temple
2011,George Hill,PG,24,287,633,0.45339652448657186,77,204,0.37745098039215685,210,429,0.48951048951048953,233,270,0.8629629629629629,24,175,199,193,66,21,99,153,884,2011_George Hill
2011,Grant Hill,SF,38,399,825,0.48363636363636364,45,114,0.39473684210526316,354,711,0.4978902953586498,213,257,0.8287937743190662,77,261,338,200,64,35,134,184,1056,2011_Grant Hill
2011,J.R. Smith,SF,25,341,784,0.43494897959183676,124,318,0.389937106918239,217,466,0.4656652360515021,163,221,0.7375565610859729,45,277,322,175,92,16,100,173,969,2011_J.R. Smith
2011,Joe Johnson,SG,29,514,1161,0.4427217915590009,89,300,0.2966666666666667,425,861,0.49361207897793263,195,243,0.8024691358024691,59,232,291,338,47,7,146,131,1312,2011_Joe Johnson
2011,Kyle Lowry,PG,24,345,809,0.4264524103831891,129,343,0.3760932944606414,216,466,0.463519313304721,192,251,0.7649402390438247,89,220,309,500,102,23,158,207,1011,2011_Kyle Lowry
2011,Larry Owens,SF,28,30,64,0.46875,12,26,0.46153846153846156,18,38,0.47368421052631576,8,18,0.4444444444444444,2,28,30,16,18,10,10,36,80,2011_Larry Owens
2011,Luc Mbah,PF,24,198,428,0.46261682242990654,0,7,0.0,198,421,0.47030878859857483,133,188,0.7074468085106383,169,251,420,68,72,28,77,180,529,2011_Luc Mbah
2011,Nate Robinson,PG,26,300,752,0.39893617021276595,130,400,0.325,170,352,0.48295454545454547,72,88,0.8181818181818182,30,150,180,222,58,8,136,230,802,2011_Nate Robinson
2011,Pape Sy,SF,22,2,6,0.3333333333333333,0,1,0.0,2,5,0.4,3,3,1.0,2,1,3,2,1,0,3,1,7,2011_Pape Sy
2011,Paul Pierce,SF,33,507,1021,0.49657198824681686,111,297,0.37373737373737376,396,724,0.5469613259668509,386,449,0.8596881959910914,34,396,430,260,80,51,171,231,1511,2011_Paul Pierce
2011,Raymond Felton,PG-SG_SG_PG,26,854,2010,0.4248756218905473,232,658,0.3525835866261398,622,1352,0.46005917159763315,388,482,0.8049792531120332,96,442,538,1250,250,22,442,300,2328,2011_Raymond Felton
2011,Roy Hibbert,C,24,410,890,0.4606741573033708,0,4,0.0,410,886,0.46275395033860045,205,275,0.7454545454545455,182,428,610,166,33,142,185,256,1025,2011_Roy Hibbert
2011,Sebastian Telfair,PG,25,97,241,0.4024896265560166,28,78,0.358974358974359,69,163,0.4233128834355828,44,60,0.7333333333333333,17,37,54,111,25,3,64,64,266,2011_Sebastian Telfair
2011,Solomon Jones,C,26,49,121,0.4049586776859504,0,1,0.0,49,120,0.4083333333333333,41,62,0.6612903225806451,45,68,113,30,12,22,35,94,139,2011_Solomon Jones
2012,Anderson Varejao,C,29,114,222,0.5135135135135135,0,4,0.0,114,218,0.5229357798165137,43,64,0.671875,109,178,287,43,35,17,45,62,271,2012_Anderson Varejao
2012,Andrew Bogut,C,27,61,136,0.4485294117647059,0,1,0.0,61,135,0.45185185185185184,14,23,0.6086956521739131,22,78,100,31,12,24,24,36,136,2012_Andrew Bogut
2012,Anthony Randolph,PF,22,94,200,0.47,0,1,0.0,94,199,0.4723618090452261,64,84,0.7619047619047619,42,81,123,19,13,35,40,56,252,2012_Anthony Randolph
2012,Chris Andersen,C,33,59,108,0.5462962962962963,0,0,NaN,59,108,0.5462962962962963,50,82,0.6097560975609756,48,100,148,6,19,46,17,52,168,2012_Chris Andersen
2012,George Hill,PG,25,168,380,0.4421052631578947,54,147,0.3673469387755102,114,233,0.4892703862660944,91,117,0.7777777777777778,31,120,151,145,42,17,52,98,481,2012_George Hill
2012,Jamal Crawford,PG,31,283,737,0.383989145183175,80,260,0.3076923076923077,203,477,0.42557651991614254,191,206,0.9271844660194175,16,102,118,191,55,14,111,74,837,2012_Jamal Crawford
2012,Jeff Ayres,C,24,15,36,0.4166666666666667,0,0,NaN,15,36,0.4166666666666667,4,7,0.5714285714285714,12,21,33,4,3,2,2,16,34,2012_Jeff Ayres
2012,Jerry Smith,PG,24,3,14,0.21428571428571427,1,6,0.16666666666666666,2,8,0.25,0,0,NaN,2,5,7,4,5,0,0,5,7,2012_Jerry Smith
2012,Jimmer Fredette,PG,22,172,446,0.38565022421524664,78,216,0.3611111111111111,94,230,0.40869565217391307,40,48,0.8333333333333334,17,56,73,108,30,3,67,73,462,2012_Jimmer Fredette
2012,Kawhi Leonard,SF,20,199,404,0.49257425742574257,41,109,0.3761467889908257,158,295,0.535593220338983,68,88,0.7727272727272727,104,223,327,70,85,24,44,88,507,2012_Kawhi Leonard
2012,Larry Owens,SF,29,4,11,0.36363636363636365,2,5,0.4,2,6,0.3333333333333333,3,4,0.75,2,11,13,4,0,1,2,10,13,2012_Larry Owens
2012,Nate Robinson,PG,27,205,484,0.42355371900826444,66,181,0.36464088397790057,139,303,0.45874587458745875,94,113,0.831858407079646,15,85,100,231,59,2,75,118,570,2012_Nate Robinson
2012,Paul Pierce,SF,34,394,890,0.44269662921348313,100,273,0.3663003663003663,294,617,0.47649918962722854,293,344,0.8517441860465116,37,280,317,274,70,26,173,147,1181,2012_Paul Pierce
2012,Roy Hibbert,C,25,332,668,0.49700598802395207,0,1,0.0,332,667,0.49775112443778113,170,239,0.7112970711297071,213,359,572,108,32,128,128,195,834,2012_Roy Hibbert
2012,Sebastian Telfair,PG,26,141,342,0.41228070175438597,33,105,0.3142857142857143,108,237,0.45569620253164556,53,67,0.7910447761194029,20,71,91,138,41,12,68,120,368,2012_Sebastian Telfair
2012,Solomon Jones,C_PF_C-PF,27,48,122,0.39344262295081966,0,0,NaN,48,122,0.39344262295081966,38,46,0.8260869565217391,64,52,116,18,18,22,36,86,134,2012_Solomon Jones
2013,Chris Johnson,SF,22,11,25,0.44,6,18,0.3333333333333333,5,7,0.7142857142857143,1,2,0.5,5,6,11,2,4,0,3,5,29,2013_Chris Johnson
2013,Chris Kaman,C,30,313,617,0.5072933549432739,0,1,0.0,313,616,0.5081168831168831,67,85,0.788235294117647,97,275,372,51,29,52,103,141,693,2013_Chris Kaman
2013,Devin Harris,SG,29,194,443,0.43792325056433407,77,230,0.3347826086956522,117,213,0.5492957746478874,112,154,0.7272727272727273,6,110,116,197,64,13,88,103,577,2013_Devin Harris
2013,George Hill,PG,26,386,871,0.4431687715269805,130,353,0.36827195467422097,256,518,0.4942084942084942,174,213,0.8169014084507042,47,237,284,355,81,26,116,134,1076,2013_George Hill
2013,Jimmer Fredette,SG,23,172,409,0.42053789731051344,65,156,0.4166666666666667,107,253,0.42292490118577075,85,99,0.8585858585858586,19,52,71,92,31,3,68,64,494,2013_Jimmer Fredette
2013,John Jenkins,SG,21,131,294,0.445578231292517,53,138,0.38405797101449274,78,156,0.5,59,70,0.8428571428571429,17,77,94,56,12,10,40,37,374,2013_John Jenkins
2013,Josh Childress,SF,29,6,21,0.2857142857142857,1,3,0.3333333333333333,5,18,0.2777777777777778,1,2,0.5,6,9,15,5,2,2,0,3,14,2013_Josh Childress
2013,Kawhi Leonard,SF,21,260,526,0.49429657794676807,65,174,0.3735632183908046,195,352,0.5539772727272727,104,126,0.8253968253968254,63,283,346,93,97,32,62,99,689,2013_Kawhi Leonard
2013,Kent Bazemore,SG,23,43,116,0.3706896551724138,10,34,0.29411764705882354,33,82,0.4024390243902439,27,44,0.6136363636363636,5,17,22,22,17,4,18,27,123,2013_Kent Bazemore
2013,Khris Middleton,SG,21,62,141,0.4397163120567376,14,45,0.3111111111111111,48,96,0.5,27,32,0.84375,4,46,50,28,15,4,11,53,165,2013_Khris Middleton
2013,Meyers Leonard,C,20,151,277,0.5451263537906137,3,7,0.42857142857142855,148,270,0.5481481481481482,72,89,0.8089887640449438,80,175,255,33,11,38,49,168,377,2013_Meyers Leonard
2013,Nate Robinson,PG,28,399,921,0.43322475570032576,141,348,0.4051724137931034,258,573,0.450261780104712,135,169,0.7988165680473372,29,155,184,358,85,10,144,207,1074,2013_Nate Robinson
2013,Paul Pierce,SF,35,476,1092,0.4358974358974359,145,382,0.3795811518324607,331,710,0.46619718309859154,333,423,0.7872340425531915,45,442,487,370,84,30,214,210,1430,2013_Paul Pierce
2013,Reggie Jackson,PG,22,149,325,0.4584615384615385,24,104,0.23076923076923078,125,221,0.5656108597285068,52,62,0.8387096774193549,21,145,166,122,29,13,53,84,374,2013_Reggie Jackson
2013,Roy Hibbert,C,26,385,859,0.4481955762514552,1,4,0.25,384,855,0.44912280701754387,166,224,0.7410714285714286,296,360,656,113,39,206,162,279,937,2013_Roy Hibbert
2013,Sebastian Telfair,PG,27,224,618,0.36245954692556637,106,300,0.35333333333333333,118,318,0.3710691823899371,108,138,0.782608695652174,26,142,168,306,74,22,128,208,662,2013_Sebastian Telfair
2013,Solomon Jones,PF,28,0,1,0.0,0,0,NaN,0,1,0.0,0,0,NaN,1,2,3,0,0,1,3,3,0,2013_Solomon Jones
2013,Xavier Henry,SF,21,66,161,0.40993788819875776,4,11,0.36363636363636365,62,150,0.41333333333333333,58,92,0.6304347826086957,21,69,90,13,16,5,31,72,194,2013_Xavier Henry
2014,Andre Iguodala,SF,30,220,458,0.48034934497816595,62,175,0.35428571428571426,158,283,0.558303886925795,86,132,0.6515151515151515,53,240,293,263,95,18,100,103,588,2014_Andre Iguodala
2014,Anthony Bennett,PF,20,80,225,0.35555555555555557,13,53,0.24528301886792453,67,172,0.38953488372093026,44,69,0.6376811594202898,49,106,155,17,21,8,47,93,217,2014_Anthony Bennett
2014,Bradley Beal,SG,20,481,1149,0.4186248912097476,138,343,0.40233236151603496,343,806,0.42555831265508687,149,189,0.7883597883597884,54,219,273,243,71,18,128,153,1249,2014_Bradley Beal
2014,Carl Landry,PF,30,31,60,0.5166666666666667,0,0,NaN,31,60,0.5166666666666667,14,17,0.8235294117647058,15,42,57,5,3,1,9,34,76,2014_Carl Landry
2014,Chris Johnson,SF,23,85,214,0.397196261682243,43,127,0.33858267716535434,42,87,0.4827586206896552,37,43,0.8604651162790697,31,66,97,31,27,4,22,63,250,2014_Chris Johnson
2014,Chris Kaman,C,31,176,346,0.5086705202312138,0,3,0.0,176,343,0.5131195335276968,52,68,0.7647058823529411,54,175,229,58,11,40,74,93,404,2014_Chris Kaman
2014,Earl Clark,PF,26,194,522,0.3716475095785441,82,244,0.3360655737704918,112,278,0.4028776978417266,44,68,0.6470588235294118,44,242,286,36,34,50,62,134,514,2014_Earl Clark
2014,George Hill,PG,27,272,616,0.44155844155844154,95,260,0.36538461538461536,177,356,0.49719101123595505,142,176,0.8068181818181818,53,230,283,265,75,23,92,158,781,2014_George Hill
2014,Henry Sims,C,23,260,548,0.4744525547445255,0,2,0.0,260,546,0.47619047619047616,180,242,0.743801652892562,208,266,474,104,56,40,82,232,700,2014_Henry Sims
2014,Jimmer Fredette,SG,24,214,454,0.4713656387665198,80,168,0.47619047619047616,134,286,0.46853146853146854,38,42,0.9047619047619048,16,88,104,128,28,6,96,70,546,2014_Jimmer Fredette
2014,Kawhi Leonard,SF,22,337,645,0.5224806201550387,69,182,0.3791208791208791,268,463,0.5788336933045356,101,126,0.8015873015873016,76,336,412,133,114,50,80,127,844,2014_Kawhi Leonard
2014,Kemba Walker,PG,23,449,1143,0.39282589676290464,109,327,0.3333333333333333,340,816,0.4166666666666667,282,337,0.8367952522255193,39,267,306,447,86,32,169,128,1289,2014_Kemba Walker
2014,Kent Bazemore,SG,24,294,686,0.42857142857142855,86,256,0.3359375,208,430,0.48372093023255813,132,218,0.6055045871559633,20,214,234,182,86,26,158,204,806,2014_Kent Bazemore
2014,Khris Middleton,SF,22,376,854,0.44028103044496486,120,290,0.41379310344827586,256,564,0.45390070921985815,118,137,0.8613138686131386,60,250,310,169,83,20,123,243,990,2014_Khris Middleton
2014,Lou Amundson,PF,31,32,64,0.5,0,0,NaN,32,64,0.5,12,48,0.25,56,54,110,12,18,22,28,98,76,2014_Lou Amundson
2014,MarShon Brooks,SG,25,114,250,0.456,26,50,0.52,88,200,0.44,64,88,0.7272727272727273,20,88,108,50,28,8,48,42,318,2014_MarShon Brooks
2014,Nate Robinson,PG,29,164,383,0.4281984334203655,58,154,0.37662337662337664,106,229,0.462882096069869,71,85,0.8352941176470589,21,60,81,112,36,4,58,92,457,2014_Nate Robinson
2014,Paul Pierce,SF,36,321,712,0.4508426966292135,112,300,0.37333333333333335,209,412,0.5072815533980582,256,310,0.8258064516129032,26,322,348,178,86,31,153,190,1010,2014_Paul Pierce
2014,Ronny Turiaf,C,31,64,107,0.5981308411214953,0,0,NaN,64,107,0.5981308411214953,21,50,0.42,55,119,174,24,8,50,24,65,149,2014_Ronny Turiaf
2014,Roy Hibbert,C,27,331,754,0.4389920424403183,2,5,0.4,329,749,0.4392523364485981,207,269,0.7695167286245354,202,336,538,91,29,182,148,269,871,2014_Roy Hibbert
2014,Solomon Jones,PF,29,6,17,0.35294117647058826,0,0,NaN,6,17,0.35294117647058826,2,4,0.5,8,8,16,2,2,2,2,12,14,2014_Solomon Jones
2014,Will Bynum,PG,31,184,430,0.42790697674418604,20,62,0.3225806451612903,164,368,0.44565217391304346,97,121,0.8016528925619835,24,75,99,216,39,7,103,121,485,2014_Will Bynum
2015,Anthony Bennett,PF,21,125,297,0.4208754208754209,7,23,0.30434782608695654,118,274,0.4306569343065693,41,64,0.640625,52,164,216,48,27,16,36,87,298,2015_Anthony Bennett
2015,C.J. Watson,PG,30,181,417,0.434052757793765,70,175,0.4,111,242,0.45867768595041325,138,167,0.8263473053892215,18,145,163,208,57,9,100,107,570,2015_C.J. Watson
2015,Carl Landry,PF,31,190,369,0.5149051490514905,0,0,NaN,190,369,0.5149051490514905,123,150,0.82,99,169,268,26,15,17,54,132,503,2015_Carl Landry
2015,Caron Butler,SF,34,161,396,0.4065656565656566,83,219,0.3789954337899543,78,177,0.4406779661016949,55,61,0.9016393442622951,21,175,196,79,43,4,49,120,460,2015_Caron Butler
2015,Chris Johnson,SF,24,124,308,0.4025974025974026,56,190,0.29473684210526313,68,118,0.576271186440678,28,32,0.875,16,94,110,30,52,14,30,88,332,2015_Chris Johnson
2015,Chris Kaman,C,32,283,549,0.5154826958105647,0,0,NaN,283,549,0.5154826958105647,72,102,0.7058823529411765,149,335,484,65,18,54,108,140,638,2015_Chris Kaman
2015,Clint Capela,C,20,14,29,0.4827586206896552,0,0,NaN,14,29,0.4827586206896552,4,23,0.17391304347826086,10,26,36,2,1,9,5,14,32,2015_Clint Capela
2015,Derrick Favors,PF,23,482,918,0.5250544662309368,1,6,0.16666666666666666,481,912,0.5274122807017544,222,332,0.6686746987951807,196,411,607,112,60,123,121,210,1187,2015_Derrick Favors
2015,Eric Bledsoe,PG,25,468,1046,0.4474187380497132,88,272,0.3235294117647059,380,774,0.4909560723514212,353,441,0.800453514739229,72,351,423,493,127,45,274,189,1377,2015_Eric Bledsoe
2015,George Hill,PG,28,255,535,0.4766355140186916,69,193,0.35751295336787564,186,342,0.543859649122807,113,143,0.7902097902097902,25,154,179,220,44,14,69,111,692,2015_George Hill
2015,Jerami Grant,SF,20,124,352,0.3522727272727273,49,156,0.3141025641025641,75,196,0.3826530612244898,114,193,0.5906735751295337,49,149,198,79,40,68,85,144,411,2015_Jerami Grant
2015,Jimmer Fredette,PG,25,63,166,0.3795180722891566,9,48,0.1875,54,118,0.4576271186440678,43,45,0.9555555555555556,8,32,40,58,15,2,33,43,178,2015_Jimmer Fredette
2015,Kawhi Leonard,SF,23,394,822,0.4793187347931874,67,192,0.3489583333333333,327,630,0.5190476190476191,202,252,0.8015873015873016,85,376,461,161,148,48,97,128,1057,2015_Kawhi Leonard
2015,Kelly Olynyk,C,23,251,528,0.4753787878787879,61,175,0.3485714285714286,190,353,0.5382436260623229,93,136,0.6838235294117647,92,211,303,109,64,39,98,213,656,2015_Kelly Olynyk
2015,Kent Bazemore,SG,25,141,331,0.4259818731117825,48,132,0.36363636363636365,93,199,0.46733668341708545,60,100,0.6,21,201,222,78,52,33,73,127,390,2015_Kent Bazemore
2015,Khris Middleton,SF,23,406,869,0.4672036823935558,109,268,0.40671641791044777,297,601,0.49417637271214643,134,156,0.8589743589743589,48,299,347,182,122,11,113,183,1055,2015_Khris Middleton
2015,Nikola Pekovic,C,29,139,328,0.42378048780487804,0,0,NaN,139,328,0.42378048780487804,108,129,0.8372093023255814,89,145,234,27,19,12,42,59,386,2015_Nikola Pekovic
2015,Paul Pierce,SF,37,293,656,0.44664634146341464,118,303,0.38943894389438943,175,353,0.49575070821529743,164,210,0.780952380952381,45,249,294,144,46,24,92,160,868,2015_Paul Pierce
2015,Ronnie Price,PG,31,77,223,0.3452914798206278,31,109,0.28440366972477066,46,114,0.40350877192982454,36,45,0.8,19,50,69,165,67,4,52,118,221,2015_Ronnie Price
2015,Roy Hibbert,C,28,317,710,0.44647887323943664,0,2,0.0,317,708,0.4477401129943503,168,204,0.8235294117647058,156,384,540,84,18,125,107,216,802,2015_Roy Hibbert
2015,Sebastian Telfair,PG,29,46,125,0.368,18,60,0.3,28,65,0.4307692307692308,24,34,0.7058823529411765,2,28,30,45,10,0,18,29,134,2015_Sebastian Telfair
2015,Shawn Marion,SF,36,119,267,0.44569288389513106,12,46,0.2608695652173913,107,221,0.4841628959276018,26,34,0.7647058823529411,64,138,202,51,27,27,33,58,276,2015_Shawn Marion
2015,Tyreke Evans,SG,25,521,1165,0.4472103004291845,69,227,0.3039647577092511,452,938,0.48187633262260127,202,291,0.6941580756013745,82,334,416,521,100,37,246,198,1313,2015_Tyreke Evans
2016,Anthony Bennett,PF,22,8,27,0.2962962962962963,3,14,0.21428571428571427,5,13,0.38461538461538464,9,10,0.9,6,17,23,0,5,0,4,8,28,2016_Anthony Bennett
2016,Brandon Knight,SG,24,371,895,0.4145251396648045,120,351,0.3418803418803419,251,544,0.46139705882352944,156,183,0.8524590163934426,36,166,202,263,61,20,177,124,1018,2016_Brandon Knight
2016,C.J. Watson,PG,31,47,137,0.34306569343065696,14,48,0.2916666666666667,33,89,0.3707865168539326,34,39,0.8717948717948718,10,56,66,88,19,5,25,49,142,2016_C.J. Watson
2016,Cameron Payne,PG,21,114,278,0.41007194244604317,36,111,0.32432432432432434,78,167,0.46706586826347307,19,24,0.7916666666666666,9,76,85,108,36,6,44,80,283,2016_Cameron Payne
2016,Carl Landry,PF,32,139,250,0.556,6,13,0.46153846153846156,133,237,0.5611814345991561,67,91,0.7362637362637363,49,97,146,32,12,9,22,69,351,2016_Carl Landry
2016,Chris Johnson,SF,25,72,194,0.3711340206185567,27,99,0.2727272727272727,45,95,0.47368421052631576,34,42,0.8095238095238095,27,105,132,45,32,20,40,100,205,2016_Chris Johnson
2016,Chris Kaman,C,33,20,43,0.46511627906976744,1,4,0.25,19,39,0.48717948717948717,3,3,1.0,7,17,24,11,1,1,8,15,44,2016_Chris Kaman
2016,DeMarcus Cousins,C,25,601,1332,0.4512012012012012,70,210,0.3333333333333333,531,1122,0.4732620320855615,476,663,0.717948717948718,158,589,747,214,101,92,249,236,1748,2016_DeMarcus Cousins
2016,George Hill,PG,29,326,739,0.44113667117726657,128,314,0.40764331210191085,198,425,0.46588235294117647,114,150,0.76,58,240,298,259,83,17,101,149,894,2016_George Hill
2016,Jimmer Fredette,SG,26,4,10,0.4,2,4,0.5,2,6,0.3333333333333333,8,10,0.8,0,0,0,2,2,0,4,4,18,2016_Jimmer Fredette
2016,Joel Anthony,C,33,6,10,0.6,0,0,NaN,6,10,0.6,6,8,0.75,8,13,21,1,2,12,2,15,18,2016_Joel Anthony
2016,Jonathon Simmons,SG,26,122,242,0.5041322314049587,18,47,0.3829787234042553,104,195,0.5333333333333333,69,92,0.75,16,80,96,58,24,5,53,103,331,2016_Jonathon Simmons
2016,Justin Holiday,SG,26,176,456,0.38596491228070173,72,210,0.34285714285714286,104,246,0.42276422764227645,54,74,0.7297297297297297,24,156,180,112,64,38,78,122,478,2016_Justin Holiday
2016,K.J. McDaniels,SF,22,29,72,0.4027777777777778,7,25,0.28,22,47,0.46808510638297873,24,30,0.8,16,26,42,10,7,6,17,30,89,2016_K.J. McDaniels
2016,Kawhi Leonard,SF,24,551,1090,0.5055045871559632,129,291,0.44329896907216493,422,799,0.5281602002503129,292,334,0.874251497005988,95,398,493,186,128,71,105,133,1523,2016_Kawhi Leonard
2016,Kent Bazemore,SF,26,320,725,0.4413793103448276,109,305,0.35737704918032787,211,420,0.5023809523809524,123,151,0.8145695364238411,28,351,379,171,98,38,138,176,872,2016_Kent Bazemore
2016,Khris Middleton,SG,24,507,1142,0.44395796847635727,143,361,0.3961218836565097,364,781,0.4660691421254802,277,312,0.8878205128205128,44,258,302,331,131,19,180,204,1434,2016_Khris Middleton
2016,Lamar Patterson,SG,24,28,80,0.35,12,49,0.24489795918367346,16,31,0.5161290322580645,16,22,0.7272727272727273,4,46,50,39,9,2,23,45,84,2016_Lamar Patterson
2016,Luis Scola,PF,35,269,598,0.4498327759197324,65,161,0.40372670807453415,204,437,0.4668192219679634,61,84,0.7261904761904762,84,276,360,66,46,27,68,178,664,2016_Luis Scola
2016,Paul Pierce,SF,38,144,397,0.36272040302267,75,242,0.30991735537190085,69,155,0.44516129032258067,54,66,0.8181818181818182,12,174,186,71,33,17,58,129,417,2016_Paul Pierce
2016,Roy Hibbert,C,29,182,411,0.44282238442822386,0,2,0.0,182,409,0.4449877750611247,117,145,0.8068965517241379,132,266,398,95,32,110,76,252,481,2016_Roy Hibbert
2017,Anthony Bennett,PF,23,38,92,0.41304347826086957,13,48,0.2708333333333333,25,44,0.5681818181818182,26,36,0.7222222222222222,25,53,78,12,5,3,12,18,115,2017_Anthony Bennett
2017,C.J. Miles,SF,29,281,647,0.43431221020092736,169,409,0.4132029339853301,112,238,0.47058823529411764,84,93,0.9032258064516129,30,199,229,48,46,25,40,151,815,2017_C.J. Miles
2017,C.J. Watson,PG,32,96,248,0.3870967741935484,32,105,0.3047619047619048,64,143,0.44755244755244755,57,66,0.8636363636363636,16,73,89,114,43,2,47,84,281,2017_C.J. Watson
2017,Cameron Payne,PG,22,128,386,0.3316062176165803,54,172,0.313953488372093,74,214,0.34579439252336447,10,16,0.625,6,90,96,110,28,10,58,104,320,2017_Cameron Payne
2017,Georgios Papagiannis,C,19,56,102,0.5490196078431373,0,2,0.0,56,100,0.56,12,14,0.8571428571428571,24,62,86,20,3,17,24,44,124,2017_Georgios Papagiannis
2017,Kawhi Leonard,SF,25,636,1311,0.4851258581235698,147,386,0.38082901554404147,489,925,0.5286486486486487,469,533,0.8799249530956847,80,350,430,260,132,55,154,122,1888,2017_Kawhi Leonard
2017,Kent Bazemore,SF,27,295,721,0.4091539528432732,92,266,0.3458646616541353,203,455,0.4461538461538462,119,168,0.7083333333333334,45,186,231,177,91,52,125,165,801,2017_Kent Bazemore
2017,Khris Middleton,SF,25,150,333,0.45045045045045046,45,104,0.4326923076923077,105,229,0.4585152838427948,81,92,0.8804347826086957,11,112,123,99,41,7,65,79,426,2017_Khris Middleton
2017,Lamar Patterson,SG,25,3,15,0.2,1,6,0.16666666666666666,2,9,0.2222222222222222,2,3,0.6666666666666666,1,6,7,6,1,0,4,6,9,2017_Lamar Patterson
2017,Nikola Mirotic,PF,25,258,625,0.4128,129,377,0.3421750663129973,129,248,0.5201612903225806,99,128,0.7734375,61,323,384,75,53,56,79,128,744,2017_Nikola Mirotic
2017,Paul Pierce,SF,39,28,70,0.4,15,43,0.3488372093023256,13,27,0.48148148148148145,10,13,0.7692307692307693,1,47,48,10,4,5,16,40,81,2017_Paul Pierce
2017,Shaun Livingston,PG,31,173,316,0.5474683544303798,1,3,0.3333333333333333,172,313,0.549520766773163,42,60,0.7,28,123,151,139,38,20,61,120,389,2017_Shaun Livingston
